臺北縣,板橋市,留侯里,1,430,45.55084746,514,54.44915254,944,18,962,0,1180,81.52542373
臺北縣,板橋市,流芳里,2,461,48.68004224,486,51.31995776,947,24,971,0,1231,78.87896019
臺北縣,板橋市,赤松里,3,238,45.07575758,290,54.92424242,528,12,540,0,662,81.57099698
臺北縣,板橋市,黃石里,4,416,51.04294479,399,48.95705521,815,20,835,0,1017,82.10422812
臺北縣,板橋市,挹秀里,5,233,36.46322379,406,63.53677621,639,11,650,0,799,81.35168961
臺北縣,板橋市,挹秀里,6,196,38.81188119,309,61.18811881,505,10,515,0,643,80.0933126
臺北縣,板橋市,湳興里,7,410,55.63093623,327,44.36906377,737,22,759,0,942,80.57324841
臺北縣,板橋市,湳興里,8,374,50,374,50,748,22,770,0,941,81.82784272
臺北縣,板橋市,湳興里,9,272,44.51718494,339,55.48281506,611,25,636,0,780,81.53846154
臺北縣,板橋市,湳興里,10,446,49.39091916,457,50.60908084,903,30,933,0,1117,83.52730528
臺北縣,板橋市,新興里,11,502,54.27027027,423,45.72972973,925,31,956,0,1171,81.63962425
臺北縣,板橋市,新興里,12,500,46.55493482,574,53.44506518,1074,18,1092,0,1366,79.94143485
臺北縣,板橋市,社後里,13,470,48.35390947,502,51.64609053,972,22,994,0,1673,59.41422594
臺北縣,板橋市,社後里,14,584,50.0428449,583,49.9571551,1167,39,1206,1,1479,81.54158215
臺北縣,板橋市,社後里,15,454,53.47467609,395,46.52532391,849,23,872,0,1074,81.19180633
臺北縣,板橋市,社後里,16,439,49.54853273,447,50.45146727,886,18,904,0,1123,80.49866429
臺北縣,板橋市,香社里,17,479,59.72568579,323,40.27431421,802,16,818,0,1010,80.99009901
臺北縣,板橋市,香社里,18,431,47.88888889,469,52.11111111,900,20,920,0,1137,80.91468777
臺北縣,板橋市,香社里,19,637,54.63121784,529,45.36878216,1166,30,1196,0,1415,84.5229682
臺北縣,板橋市,中正里,22,454,49.34782609,466,50.65217391,920,23,943,0,1169,80.66723695
臺北縣,板橋市,中正里,23,506,52.81837161,452,47.18162839,958,18,976,0,1180,82.71186441
臺北縣,板橋市,中正里,24,491,51.03950104,471,48.96049896,962,23,985,0,1209,81.47229115
臺北縣,板橋市,自強里,25,339,35.91101695,605,64.08898305,944,14,958,0,1130,84.77876106
臺北縣,板橋市,自強里,26,352,36.28865979,618,63.71134021,970,15,985,0,1196,82.35785953
臺北縣,板橋市,自強里,27,314,34.6961326,591,65.3038674,905,17,922,0,1122,82.17468806
臺北縣,板橋市,自強里,28,363,41.91685912,503,58.08314088,866,30,896,0,1038,86.31984586
臺北縣,板橋市,自立里,29,548,51.21495327,522,48.78504673,1070,34,1104,0,1307,84.4682479
臺北縣,板橋市,自立里,30,465,52.84090909,415,47.15909091,880,28,908,0,1089,83.37924702
臺北縣,板橋市,光華里,31,485,51.10642782,464,48.89357218,949,27,976,0,1175,83.06382979
臺北縣,板橋市,光華里,32,349,38.64894795,554,61.35105205,903,14,917,0,1093,83.89752973
臺北縣,板橋市,國光里,35,174,16.492891,881,83.507109,1055,13,1068,0,1238,86.26817447
臺北縣,板橋市,國光里,36,100,11.26126126,788,88.73873874,888,9,897,0,1050,85.42857143
臺北縣,板橋市,國光里,37,356,41.6374269,499,58.3625731,855,28,883,0,1041,84.82228626
臺北縣,板橋市,港尾里,38,370,53.31412104,324,46.68587896,694,15,709,0,839,84.50536353
臺北縣,板橋市,港尾里,39,486,46.06635071,569,53.93364929,1055,21,1076,0,1240,86.77419355
臺北縣,板橋市,金華里,43,474,53.31833521,415,46.68166479,889,26,915,0,1124,81.40569395
臺北縣,板橋市,金華里,44,450,50.79006772,436,49.20993228,886,26,912,0,1119,81.50134048
臺北縣,板橋市,金華里,45,481,53.03197354,426,46.96802646,907,28,935,0,1136,82.30633803
臺北縣,板橋市,港德里,46,507,58.95348837,353,41.04651163,860,32,892,0,1107,80.57813911
臺北縣,板橋市,港德里,47,447,54.84662577,368,45.15337423,815,41,856,0,1058,80.9073724
臺北縣,板橋市,港德里,48,364,53.2942899,319,46.7057101,683,21,704,0,868,81.10599078
臺北縣,板橋市,港德里,49,494,52.44161359,448,47.55838641,942,11,953,1,1151,82.79756733
臺北縣,板橋市,民權里,50,438,46.25131996,509,53.74868004,947,24,971,0,1172,82.84982935
臺北縣,板橋市,民權里,51,469,43.58736059,607,56.41263941,1076,25,1101,0,1310,84.04580153
臺北縣,板橋市,建國里,54,449,54.42424242,376,45.57575758,825,23,848,0,1044,81.22605364
臺北縣,板橋市,建國里,55,500,55.3709856,403,44.6290144,903,17,920,0,1125,81.77777778
臺北縣,板橋市,建國里,56,425,50.65554231,414,49.34445769,839,18,857,0,1008,85.01984127
臺北縣,板橋市,漢生里,57,373,43.88235294,477,56.11764706,850,14,864,0,1047,82.52148997
臺北縣,板橋市,漢生里,58,540,47.0793374,607,52.9206626,1147,20,1167,0,1405,83.06049822
臺北縣,板橋市,漢生里,59,527,50.14272122,524,49.85727878,1051,17,1068,0,1273,83.89630793
臺北縣,板橋市,公館里,63,531,54.62962963,441,45.37037037,972,28,1000,0,1192,83.89261745
臺北縣,板橋市,公館里,64,409,49.87804878,411,50.12195122,820,24,844,0,1018,82.90766208
臺北縣,板橋市,公館里,65,413,54.19947507,349,45.80052493,762,18,780,0,968,80.5785124
臺北縣,板橋市,新民里,60,439,50.11415525,437,49.88584475,876,24,900,0,1149,78.32898172
臺北縣,板橋市,新民里,61,429,49.36708861,440,50.63291139,869,23,892,1,1084,82.28782288
臺北縣,板橋市,新民里,62,512,47.40740741,568,52.59259259,1080,30,1110,0,1351,82.16136195
臺北縣,板橋市,幸福里,66,492,52.45202559,446,47.54797441,938,20,958,0,1192,80.36912752
臺北縣,板橋市,幸福里,67,517,52.54065041,467,47.45934959,984,17,1001,0,1170,85.55555556
臺北縣,板橋市,幸福里,68,451,54.66666667,374,45.33333333,825,20,845,0,1027,82.27848101
臺北縣,板橋市,忠誠里,71,305,28.77358491,755,71.22641509,1060,13,1073,0,1270,84.48818898
臺北縣,板橋市,忠誠里,72,288,33.141542,581,66.858458,869,14,883,0,1062,83.14500942
臺北縣,板橋市,百壽里,75,468,51.09170306,448,48.90829694,916,24,940,0,1143,82.23972003
臺北縣,板橋市,百壽里,76,405,53.07994758,358,46.92005242,763,11,774,0,937,82.6040555
臺北縣,板橋市,介壽里,77,533,53.03482587,472,46.96517413,1005,22,1027,0,1266,81.12164297
臺北縣,板橋市,介壽里,78,496,48.202138,533,51.797862,1029,29,1058,0,1283,82.4629774
臺北縣,板橋市,新埔里,79,385,53.62116992,333,46.37883008,718,20,738,0,907,81.36714443
臺北縣,板橋市,新埔里,80,452,50.44642857,444,49.55357143,896,25,921,0,1106,83.27305606
臺北縣,板橋市,華江里,81,526,46.4664311,606,53.5335689,1132,21,1153,0,1402,82.23965763
臺北縣,板橋市,華江里,82,472,55.59481743,377,44.40518257,849,11,860,0,1024,83.984375
臺北縣,板橋市,華江里,83,713,51.25808771,678,48.74191229,1391,37,1428,0,1700,84
臺北縣,板橋市,江翠里,84,640,56.63716814,490,43.36283186,1130,27,1157,0,1416,81.70903955
臺北縣,板橋市,江翠里,85,561,55.27093596,454,44.72906404,1015,23,1038,0,1296,80.09259259
臺北縣,板橋市,江翠里,86,585,56.68604651,447,43.31395349,1032,30,1062,0,1284,82.71028037
臺北縣,板橋市,純翠里,87,459,53.87323944,393,46.12676056,852,16,868,0,1051,82.58801142
臺北縣,板橋市,純翠里,88,630,56.4516129,486,43.5483871,1116,20,1136,0,1366,83.1625183
臺北縣,板橋市,純翠里,89,774,52.7607362,693,47.2392638,1467,33,1500,0,1794,83.61204013
臺北縣,板橋市,溪頭里,90,518,54.58377239,431,45.41622761,949,28,977,0,1227,79.62510187
臺北縣,板橋市,溪頭里,91,575,52.60750229,518,47.39249771,1093,20,1113,0,1364,81.59824047
臺北縣,板橋市,溪頭里,92,498,57.37327189,370,42.62672811,868,23,891,0,1088,81.89338235
臺北縣,板橋市,溪頭里,93,599,60.56622851,390,39.43377149,989,24,1013,0,1201,84.34637802
臺北縣,板橋市,聯翠里,94,680,43.20203304,894,56.79796696,1574,23,1597,0,1944,82.15020576
臺北縣,板橋市,聯翠里,95,606,57.0084666,457,42.9915334,1063,9,1072,0,1295,82.77992278
臺北縣,板橋市,宏翠里,98,541,55.65843621,431,44.34156379,972,26,998,0,1222,81.66939444
臺北縣,板橋市,宏翠里,99,610,53.93457118,521,46.06542882,1131,34,1165,0,1420,82.04225352
臺北縣,板橋市,仁翠里,100,709,63.41681574,409,36.58318426,1118,37,1155,0,1445,79.93079585
臺北縣,板橋市,仁翠里,101,629,62.71186441,374,37.28813559,1003,37,1040,0,1286,80.87091757
臺北縣,板橋市,新翠里,102,913,59.90813648,611,40.09186352,1524,35,1559,0,1924,81.02910603
臺北縣,板橋市,新翠里,103,838,47.66780432,920,52.33219568,1758,23,1781,0,2150,82.8372093
臺北縣,板橋市,新翠里,104,821,49.0442055,853,50.9557945,1674,29,1703,0,2056,82.8307393
臺北縣,板橋市,吉翠里,108,522,60.20761246,345,39.79238754,867,25,892,0,1044,85.44061303
臺北縣,板橋市,吉翠里,109,411,52.8957529,366,47.1042471,777,11,788,0,939,83.91906283
臺北縣,板橋市,吉翠里,110,463,54.92289442,380,45.07710558,843,24,867,0,1047,82.80802292
臺北縣,板橋市,德翠里,111,657,52.43415802,596,47.56584198,1253,32,1285,0,1536,83.65885417
臺北縣,板橋市,德翠里,112,513,50.74183976,498,49.25816024,1011,20,1031,0,1203,85.70241064
臺北縣,板橋市,德翠里,113,771,46.44578313,889,53.55421687,1660,28,1688,0,2020,83.56435644
臺北縣,板橋市,滿翠里,117,381,59.06976744,264,40.93023256,645,16,661,0,811,81.50431566
臺北縣,板橋市,滿翠里,118,448,61.45404664,281,38.54595336,729,17,746,0,921,80.99891422
臺北縣,板橋市,滿翠里,119,496,58.90736342,346,41.09263658,842,13,855,0,1023,83.57771261
臺北縣,板橋市,明翠里,120,353,55.67823344,281,44.32176656,634,18,652,0,814,80.0982801
臺北縣,板橋市,明翠里,121,489,59.27272727,336,40.72727273,825,24,849,0,1027,82.66796495
臺北縣,板橋市,明翠里,122,468,51.14754098,447,48.85245902,915,7,922,0,1111,82.98829883
臺北縣,板橋市,明翠里,123,541,57.67590618,397,42.32409382,938,11,949,0,1135,83.6123348
臺北縣,板橋市,松翠里,124,418,50.97560976,402,49.02439024,820,22,842,0,1040,80.96153846
臺北縣,板橋市,松翠里,125,841,54.78827362,694,45.21172638,1535,33,1568,0,1988,78.87323944
臺北縣,板橋市,柏翠里,126,658,52.76663994,589,47.23336006,1247,29,1276,0,1540,82.85714286
臺北縣,板橋市,柏翠里,127,617,55.63570784,492,44.36429216,1109,37,1146,0,1393,82.26848528
臺北縣,板橋市,龍翠里,128,572,59.77011494,385,40.22988506,957,27,984,0,1189,82.75862069
臺北縣,板橋市,龍翠里,129,602,59.31034483,413,40.68965517,1015,32,1047,0,1264,82.83227848
臺北縣,板橋市,龍翠里,130,562,57.11382114,422,42.88617886,984,16,1000,0,1191,83.96305626
臺北縣,板橋市,華翠里,133,616,60.45142296,403,39.54857704,1019,22,1041,0,1263,82.42280285
臺北縣,板橋市,華翠里,134,621,52.3608769,565,47.6391231,1186,32,1218,0,1429,85.23442967
臺北縣,板橋市,忠翠里,137,727,52.98833819,645,47.01166181,1372,32,1404,0,1646,85.29769137
臺北縣,板橋市,忠翠里,138,643,51.89669088,596,48.10330912,1239,30,1269,0,1478,85.85926928
臺北縣,板橋市,忠翠里,139,559,40.95238095,806,59.04761905,1365,20,1385,0,1611,85.97144631
臺北縣,板橋市,忠翠里,140,787,47.21055789,880,52.78944211,1667,28,1695,0,2090,81.10047847
臺北縣,板橋市,嵐翠里,141,521,59.54285714,354,40.45714286,875,19,894,0,1096,81.56934307
臺北縣,板橋市,嵐翠里,142,475,53.85487528,407,46.14512472,882,30,912,0,1103,82.68359021
臺北縣,板橋市,文翠里,145,510,52.20061412,467,47.79938588,977,20,997,0,1214,82.12520593
臺北縣,板橋市,文翠里,146,434,50.99882491,417,49.00117509,851,21,872,0,1052,82.88973384
臺北縣,板橋市,文翠里,147,576,54.64895636,478,45.35104364,1054,19,1073,0,1272,84.35534591
臺北縣,板橋市,青翠里,148,564,57.31707317,420,42.68292683,984,26,1010,0,1255,80.47808765
臺北縣,板橋市,青翠里,149,582,57.79543198,425,42.20456802,1007,19,1026,0,1274,80.53375196
臺北縣,板橋市,懷翠里,150,866,57.54152824,639,42.45847176,1505,38,1543,0,1974,78.16616008
臺北縣,板橋市,懷翠里,151,588,56.16045845,459,43.83954155,1047,20,1067,0,1326,80.46757164
臺北縣,板橋市,懷翠里,152,617,53.79250218,530,46.20749782,1147,18,1165,0,1435,81.18466899
臺北縣,板橋市,福翠里,153,247,51.45833333,233,48.54166667,480,30,510,0,636,80.18867925
臺北縣,板橋市,福翠里,154,311,45.33527697,375,54.66472303,686,12,698,0,854,81.73302108
臺北縣,板橋市,港嘴里,155,515,48.31144465,551,51.68855535,1066,28,1094,0,1330,82.2556391
臺北縣,板橋市,港嘴里,156,569,54.24213537,480,45.75786463,1049,9,1058,0,1344,78.7202381
臺北縣,板橋市,港嘴里,157,420,55.55555556,336,44.44444444,756,16,772,0,943,81.86638388
臺北縣,板橋市,港嘴里,158,366,52.21112696,335,47.78887304,701,17,718,0,849,84.57008245
臺北縣,板橋市,振興里,159,509,48.94230769,531,51.05769231,1040,28,1068,0,1279,83.50273651
臺北縣,板橋市,振興里,160,642,59.77653631,432,40.22346369,1074,11,1085,0,1279,84.83189992
臺北縣,板橋市,振興里,161,423,57.16216216,317,42.83783784,740,23,763,0,901,84.68368479
臺北縣,板橋市,振義里,162,628,55.18453427,510,44.81546573,1138,41,1179,0,1424,82.79494382
臺北縣,板橋市,振義里,163,470,52.22222222,430,47.77777778,900,23,923,0,1126,81.97158082
臺北縣,板橋市,振義里,164,469,64.42307692,259,35.57692308,728,23,751,0,925,81.18918919
臺北縣,板橋市,光復里,165,608,55.93376265,479,44.06623735,1087,14,1101,0,1318,83.53566009
臺北縣,板橋市,光復里,166,531,55.02590674,434,44.97409326,965,34,999,0,1209,82.63027295
臺北縣,板橋市,埔墘里,167,550,47.78453519,601,52.21546481,1151,34,1185,0,1442,82.17753121
臺北縣,板橋市,埔墘里,168,560,52.141527,514,47.858473,1074,32,1106,0,1361,81.26377663
臺北縣,板橋市,埔墘里,169,622,58.29428304,445,41.70571696,1067,23,1090,0,1340,81.34328358
臺北縣,板橋市,長壽里,172,503,49.95034757,504,50.04965243,1007,24,1031,0,1239,83.21226796
臺北縣,板橋市,長壽里,173,490,51.85185185,455,48.14814815,945,31,976,0,1161,84.06546081
臺北縣,板橋市,福壽里,174,456,45.32803181,550,54.67196819,1006,22,1028,0,1240,82.90322581
臺北縣,板橋市,福壽里,175,581,53.10786106,513,46.89213894,1094,43,1137,0,1366,83.23572474
臺北縣,板橋市,海山里,178,676,54.16666667,572,45.83333333,1248,17,1265,0,1490,84.89932886
臺北縣,板橋市,海山里,179,364,51.92582026,337,48.07417974,701,21,722,0,864,83.56481481
臺北縣,板橋市,海山里,180,637,60.89866157,409,39.10133843,1046,22,1068,0,1289,82.8549263
臺北縣,板橋市,海山里,181,607,42.35868807,826,57.64131193,1433,19,1452,0,1747,83.11390956
臺北縣,板橋市,九如里,182,616,59.28777671,423,40.71222329,1039,12,1051,0,1286,81.72628305
臺北縣,板橋市,九如里,183,487,55.65714286,388,44.34285714,875,25,900,0,1064,84.58646617
臺北縣,板橋市,玉光里,186,592,45.85592564,699,54.14407436,1291,36,1327,0,1646,80.61968408
臺北縣,板橋市,玉光里,187,591,57.54625122,436,42.45374878,1027,22,1049,0,1279,82.01720094
臺北縣,板橋市,玉光里,188,515,56.78059537,392,43.21940463,907,25,932,0,1155,80.69264069
臺北縣,板橋市,光仁里,189,554,53.11601151,489,46.88398849,1043,33,1076,0,1274,84.45839874
臺北縣,板橋市,光仁里,190,502,55.53097345,402,44.46902655,904,29,933,0,1117,83.52730528
臺北縣,板橋市,埤墘里,191,704,50.10676157,701,49.89323843,1405,33,1438,0,1723,83.45908299
臺北縣,板橋市,埤墘里,192,569,55.94886922,448,44.05113078,1017,27,1044,0,1281,81.49882904
臺北縣,板橋市,永安里,195,636,58.08219178,459,41.91780822,1095,14,1109,0,1333,83.19579895
臺北縣,板橋市,永安里,196,555,50.91743119,535,49.08256881,1090,25,1115,1,1356,82.22713864
臺北縣,板橋市,雙玉里,197,729,55.99078341,573,44.00921659,1302,46,1348,0,1636,82.39608802
臺北縣,板橋市,雙玉里,198,581,53.5483871,504,46.4516129,1085,28,1113,0,1319,84.38210766
臺北縣,板橋市,廣新里,199,314,49.84126984,316,50.15873016,630,21,651,0,860,75.69767442
臺北縣,板橋市,廣新里,200,425,53.66161616,367,46.33838384,792,11,803,0,1001,80.21978022
臺北縣,板橋市,廣新里,201,463,52.73348519,415,47.26651481,878,23,901,0,1078,83.58070501
臺北縣,板橋市,深丘里,202,283,33.81123059,554,66.18876941,837,10,847,0,1055,80.28436019
臺北縣,板橋市,深丘里,203,456,40.46140195,671,59.53859805,1127,17,1144,0,1394,82.06599713
臺北縣,板橋市,深丘里,204,453,57.63358779,333,42.36641221,786,23,809,0,986,82.04868154
臺北縣,板橋市,深丘里,205,321,44.33701657,403,55.66298343,724,15,739,0,868,85.13824885
臺北縣,板橋市,香丘里,206,425,51.95599022,393,48.04400978,818,27,845,1,1007,83.91261172
臺北縣,板橋市,香丘里,207,385,55.07868383,314,44.92131617,699,20,719,0,872,82.45412844
臺北縣,板橋市,香丘里,208,415,46.16240267,484,53.83759733,899,25,924,0,1123,82.27960819
臺北縣,板橋市,西安里,209,484,53.30396476,424,46.69603524,908,24,932,0,1160,80.34482759
臺北縣,板橋市,西安里,210,435,51.35773318,412,48.64226682,847,26,873,0,1032,84.59302326
臺北縣,板橋市,東丘里,211,480,55.04587156,392,44.95412844,872,25,897,0,1108,80.9566787
臺北縣,板橋市,東丘里,212,561,57.53846154,414,42.46153846,975,23,998,0,1170,85.2991453
臺北縣,板橋市,東丘里,213,543,57.70456961,398,42.29543039,941,28,969,0,1135,85.37444934
臺北縣,板橋市,長安里,216,546,49.90859232,548,50.09140768,1094,22,1116,0,1320,84.54545455
臺北縣,板橋市,長安里,217,708,52.75707899,634,47.24292101,1342,32,1374,0,1643,83.62751065
臺北縣,板橋市,福丘里,220,387,45.79881657,458,54.20118343,845,21,866,0,1063,81.46754468
臺北縣,板橋市,福丘里,221,197,40.78674948,286,59.21325052,483,12,495,0,601,82.36272879
臺北縣,板橋市,福祿里,222,525,43.24546952,689,56.75453048,1214,30,1244,0,1587,78.38689351
臺北縣,板橋市,福祿里,223,432,39.02439024,675,60.97560976,1107,20,1127,0,1367,82.44330651
臺北縣,板橋市,民族里,224,435,48.49498328,462,51.50501672,897,19,916,0,1108,82.67148014
臺北縣,板橋市,民族里,225,455,54.29594272,383,45.70405728,838,18,856,0,1029,83.18756074
臺北縣,板橋市,民族里,226,388,51.05263158,372,48.94736842,760,10,770,0,903,85.27131783
臺北縣,板橋市,國泰里,227,390,41.75588865,544,58.24411135,934,18,952,0,1173,81.15942029
臺北縣,板橋市,國泰里,228,541,48.69486949,570,51.30513051,1111,22,1133,0,1400,80.92857143
臺北縣,板橋市,福德里,231,535,52.91790307,476,47.08209693,1011,22,1033,0,1219,84.74159147
臺北縣,板橋市,福德里,232,539,47.86856128,587,52.13143872,1126,19,1145,0,1358,84.31516937
臺北縣,板橋市,福德里,233,613,48.76690533,644,51.23309467,1257,37,1294,0,1563,82.78950736
臺北縣,板橋市,景星里,234,482,50.52410901,472,49.47589099,954,22,976,0,1183,82.50211327
臺北縣,板橋市,景星里,235,576,48.85496183,603,51.14503817,1179,29,1208,0,1503,80.37258816
臺北縣,板橋市,福星里,236,606,51.79487179,564,48.20512821,1170,31,1201,0,1442,83.28710125
臺北縣,板橋市,福星里,237,554,50.68618481,539,49.31381519,1093,17,1110,0,1307,84.92731446
臺北縣,板橋市,鄉雲里,238,614,44.75218659,758,55.24781341,1372,32,1404,0,1680,83.57142857
臺北縣,板橋市,鄉雲里,239,518,53.18275154,456,46.81724846,974,25,999,0,1201,83.18068276
臺北縣,板橋市,廣德里,240,584,44.92307692,716,55.07692308,1300,38,1338,0,1602,83.52059925
臺北縣,板橋市,廣德里,241,489,46.52711703,562,53.47288297,1051,21,1072,0,1360,78.82352941
臺北縣,板橋市,廣德里,242,484,46.94471387,547,53.05528613,1031,22,1053,0,1232,85.47077922
臺北縣,板橋市,廣德里,243,266,54.28571429,224,45.71428571,490,10,500,0,580,86.20689655
臺北縣,板橋市,大豐里,244,602,50.71609099,585,49.28390901,1187,21,1208,0,1495,80.80267559
臺北縣,板橋市,大豐里,245,429,47.77282851,469,52.22717149,898,19,917,0,1116,82.16845878
臺北縣,板橋市,大豐里,246,438,45.57752341,523,54.42247659,961,24,985,0,1218,80.87027915
臺北縣,板橋市,重慶里,247,710,49.8945889,713,50.1054111,1423,43,1466,0,1794,81.71683389
臺北縣,板橋市,重慶里,248,578,46.72594988,659,53.27405012,1237,34,1271,0,1580,80.44303797
臺北縣,板橋市,重慶里,249,594,44.1307578,752,55.8692422,1346,36,1382,0,1692,81.678487
臺北縣,板橋市,重慶里,250,454,40.24822695,674,59.75177305,1128,10,1138,0,1366,83.30893119
臺北縣,板橋市,仁愛里,251,152,19.94750656,610,80.05249344,762,24,786,0,924,85.06493506
臺北縣,板橋市,仁愛里,252,280,37.58389262,465,62.41610738,745,13,758,0,921,82.30184582
臺北縣,板橋市,仁愛里,253,309,42.09809264,425,57.90190736,734,14,748,0,909,82.28822882
臺北縣,板橋市,和平里,254,325,45.71026723,386,54.28973277,711,18,729,0,918,79.41176471
臺北縣,板橋市,廣福里,255,566,54.68599034,469,45.31400966,1035,40,1075,0,1307,82.24942617
臺北縣,板橋市,廣福里,256,545,49.14337241,564,50.85662759,1109,23,1132,0,1428,79.27170868
臺北縣,板橋市,華興里,260,624,50.48543689,612,49.51456311,1236,32,1268,0,1555,81.54340836
臺北縣,板橋市,華興里,261,611,44.79472141,753,55.20527859,1364,24,1388,0,1699,81.69511477
臺北縣,板橋市,華貴里,262,448,49.94425864,449,50.05574136,897,37,934,0,1147,81.42981691
臺北縣,板橋市,華貴里,263,492,49.05284148,511,50.94715852,1003,32,1035,0,1226,84.42088091
臺北縣,板橋市,華德里,266,653,46.37784091,755,53.62215909,1408,37,1445,0,1820,79.3956044
臺北縣,板橋市,華德里,267,625,48.29984544,669,51.70015456,1294,24,1318,0,1638,80.46398046
臺北縣,板橋市,華德里,268,608,41.53005464,856,58.46994536,1464,25,1489,0,1796,82.9064588
臺北縣,板橋市,華東里,269,446,39.329806,688,60.670194,1134,21,1155,0,1380,83.69565217
臺北縣,板橋市,華東里,270,507,38.23529412,819,61.76470588,1326,19,1345,0,1597,84.22041327
臺北縣,板橋市,華東里,271,566,48.37606838,604,51.62393162,1170,28,1198,0,1483,80.78219825
臺北縣,板橋市,信義里,272,407,47.60233918,448,52.39766082,855,17,872,0,1109,78.62939585
臺北縣,板橋市,信義里,273,397,45.11363636,483,54.88636364,880,20,900,0,1099,81.89262966
臺北縣,板橋市,信義里,274,525,56.5123789,404,43.4876211,929,29,958,0,1152,83.15972222
臺北縣,板橋市,浮洲里,275,588,60.24590164,388,39.75409836,976,26,1002,0,1275,78.58823529
臺北縣,板橋市,浮洲里,276,357,45.01891551,436,54.98108449,793,28,821,0,1080,76.01851852
臺北縣,板橋市,浮洲里,277,400,53.83580081,343,46.16419919,743,10,753,0,1240,60.72580645
臺北縣,板橋市,華中里,278,546,54.76429288,451,45.23570712,997,28,1025,0,1254,81.738437
臺北縣,板橋市,華中里,279,634,52.87739783,565,47.12260217,1199,24,1223,0,1515,80.72607261
臺北縣,板橋市,華中里,280,697,58.47315436,495,41.52684564,1192,25,1217,0,1527,79.69875573
臺北縣,板橋市,僑中里,281,540,51.62523901,506,48.37476099,1046,25,1071,0,1313,81.56892612
臺北縣,板橋市,僑中里,282,343,53.59375,297,46.40625,640,25,665,0,832,79.92788462
臺北縣,板橋市,僑中里,283,365,50.20632737,362,49.79367263,727,22,749,0,887,84.44193912
臺北縣,板橋市,中山里,287,442,52.61904762,398,47.38095238,840,23,863,0,1081,79.83348751
臺北縣,板橋市,中山里,288,328,48.02342606,355,51.97657394,683,15,698,0,910,76.7032967
臺北縣,板橋市,中山里,289,391,43.93258427,499,56.06741573,890,30,920,0,1146,80.27923211
臺北縣,板橋市,中山里,290,31,4.828660436,611,95.17133956,642,22,664,1,833,79.71188475
臺北縣,板橋市,復興里,291,83,25.85669782,238,74.14330218,321,38,359,0,541,66.35859519
臺北縣,板橋市,復興里,292,105,24.13793103,330,75.86206897,435,43,478,0,639,74.80438185
臺北縣,板橋市,復興里,293,116,25.60706402,337,74.39293598,453,45,498,0,676,73.66863905
臺北縣,板橋市,大安里,294,471,51.8722467,437,48.1277533,908,26,934,0,1175,79.4893617
臺北縣,板橋市,大安里,295,512,48.62298196,541,51.37701804,1053,25,1078,0,1314,82.03957382
臺北縣,板橋市,大安里,296,387,50.98814229,372,49.01185771,759,11,770,0,970,79.3814433
臺北縣,板橋市,福安里,297,304,31.43743537,663,68.56256463,967,14,981,0,1156,84.8615917
臺北縣,板橋市,福安里,298,480,57.55395683,354,42.44604317,834,34,868,0,1088,79.77941176
臺北縣,板橋市,聚安里,299,356,53.29341317,312,46.70658683,668,20,688,0,871,78.98966705
臺北縣,板橋市,聚安里,300,455,54.95169082,373,45.04830918,828,23,851,0,1008,84.42460317
臺北縣,板橋市,聚安里,301,379,50.46604527,372,49.53395473,751,19,770,0,964,79.87551867
臺北縣,板橋市,聚安里,302,519,55.03711559,424,44.96288441,943,34,977,0,1243,78.6001609
臺北縣,板橋市,龍安里,303,511,52.84384695,456,47.15615305,967,35,1002,0,1210,82.80991736
臺北縣,板橋市,龍安里,304,539,57.21868365,403,42.78131635,942,40,982,0,1217,80.69022186
臺北縣,板橋市,崑崙里,305,606,50.62656642,591,49.37343358,1197,29,1226,0,1542,79.50713359
臺北縣,板橋市,崑崙里,306,728,52.94545455,647,47.05454545,1375,37,1412,0,1753,80.54763263
臺北縣,板橋市,崑崙里,307,548,49.01610018,570,50.98389982,1118,30,1148,0,1468,78.20163488
臺北縣,板橋市,崑崙里,308,528,51.21241513,503,48.78758487,1031,24,1055,0,1271,83.00550747
臺北縣,板橋市,溪洲里,311,544,51.80952381,506,48.19047619,1050,28,1078,0,1301,82.85933897
臺北縣,板橋市,溪洲里,312,668,51.14854518,638,48.85145482,1306,30,1336,0,1676,79.71360382
臺北縣,板橋市,溪洲里,313,542,49.86200552,545,50.13799448,1087,31,1118,0,1428,78.29131653
臺北縣,板橋市,溪北里,319,543,53.49753695,472,46.50246305,1015,26,1041,0,1272,81.83962264
臺北縣,板橋市,溪北里,320,531,49.25788497,547,50.74211503,1078,19,1097,0,1377,79.66594045
臺北縣,板橋市,香雅里,20,428,50.89179548,413,49.10820452,841,16,857,0,1043,82.16682646
臺北縣,板橋市,香雅里,21,468,50.43103448,460,49.56896552,928,29,957,0,1146,83.5078534
臺北縣,板橋市,新生里,40,521,53.10907238,460,46.89092762,981,18,999,0,1245,80.24096386
臺北縣,板橋市,新生里,41,531,47.24199288,593,52.75800712,1124,18,1142,0,1341,85.16032811
臺北縣,板橋市,新生里,42,491,53.31161781,430,46.68838219,921,20,941,0,1117,84.2435094
臺北縣,板橋市,文德里,69,524,49.29444967,539,50.70555033,1063,31,1094,0,1335,81.94756554
臺北縣,板橋市,文德里,70,471,49.37106918,483,50.62893082,954,18,972,0,1185,82.02531646
臺北縣,板橋市,文化里,96,581,58.21643287,417,41.78356713,998,20,1018,0,1221,83.37428337
臺北縣,板橋市,文化里,97,597,52.46045694,541,47.53954306,1138,35,1173,0,1426,82.25806452
臺北縣,板橋市,新海里,114,409,52.50320924,370,47.49679076,779,13,792,0,999,79.27927928
臺北縣,板橋市,新海里,115,457,60.29023747,301,39.70976253,758,15,773,0,934,82.76231263
臺北縣,板橋市,新海里,116,396,51.3618677,375,48.6381323,771,11,782,0,955,81.88481675
臺北縣,板橋市,莒光里,135,626,55.44729849,503,44.55270151,1129,26,1155,0,1384,83.45375723
臺北縣,板橋市,莒光里,136,502,54.32900433,422,45.67099567,924,28,952,0,1152,82.63888889
臺北縣,板橋市,富貴里,170,402,56.22377622,313,43.77622378,715,27,742,0,899,82.53615128
臺北縣,板橋市,富貴里,171,335,41.46039604,473,58.53960396,808,15,823,0,992,82.96370968
臺北縣,板橋市,正泰里,184,604,55.36205316,487,44.63794684,1091,28,1119,0,1344,83.25892857
臺北縣,板橋市,正泰里,185,455,49.89035088,457,50.10964912,912,23,935,0,1085,86.17511521
臺北縣,板橋市,民生里,214,314,54.32525952,264,45.67474048,578,20,598,1,750,79.73333333
臺北縣,板橋市,民生里,215,356,54.10334347,302,45.89665653,658,17,675,0,834,80.9352518
臺北縣,板橋市,後埔里,229,483,42,667,58,1150,16,1166,0,1388,84.00576369
臺北縣,板橋市,後埔里,230,565,48.29059829,605,51.70940171,1170,35,1205,0,1489,80.92679651
臺北縣,板橋市,華福里,264,377,46.94894147,426,53.05105853,803,17,820,0,969,84.62332301
臺北縣,板橋市,華福里,265,300,47.02194357,338,52.97805643,638,6,644,0,791,81.4159292
臺北縣,板橋市,堂春里,321,568,51.40271493,537,48.59728507,1105,27,1132,0,1386,81.67388167
臺北縣,板橋市,堂春里,322,674,51.96607556,623,48.03392444,1297,17,1314,0,1607,81.7672682
臺北縣,板橋市,成和里,309,771,57.153447,578,42.846553,1349,34,1383,0,1726,80.12746234
臺北縣,板橋市,成和里,310,738,48.33005894,789,51.66994106,1527,27,1554,0,1972,78.80324544
臺北縣,板橋市,光榮里,33,346,42.09245742,476,57.90754258,822,24,846,0,1048,80.72519084
臺北縣,板橋市,光榮里,34,405,46.23287671,471,53.76712329,876,18,894,0,1106,80.8318264
臺北縣,板橋市,民安里,52,307,45.48148148,368,54.51851852,675,17,692,0,809,85.53770087
臺北縣,板橋市,民安里,53,334,43.09677419,441,56.90322581,775,17,792,0,963,82.24299065
臺北縣,板橋市,陽明里,73,500,48.87585533,523,51.12414467,1023,18,1041,0,1258,82.75039746
臺北縣,板橋市,陽明里,74,538,55.06653019,439,44.93346981,977,26,1003,0,1204,83.30564784
臺北縣,板橋市,朝陽里,105,376,56.62650602,288,43.37349398,664,7,671,0,800,83.875
臺北縣,板橋市,朝陽里,106,446,61.26373626,282,38.73626374,728,14,742,0,893,83.09070549
臺北縣,板橋市,朝陽里,107,540,54.7112462,447,45.2887538,987,26,1013,0,1210,83.71900826
臺北縣,板橋市,松柏里,131,449,54.82295482,370,45.17704518,819,22,841,0,1051,80.0190295
臺北縣,板橋市,松柏里,132,319,53.078203,282,46.921797,601,10,611,0,771,79.24773022
臺北縣,板橋市,文聖里,143,712,57.05128205,536,42.94871795,1248,32,1280,0,1539,83.17089019
臺北縣,板橋市,文聖里,144,606,52.15146299,556,47.84853701,1162,27,1189,0,1408,84.44602273
臺北縣,板橋市,居仁里,176,519,51.33531157,492,48.66468843,1011,19,1030,0,1251,82.33413269
臺北縣,板橋市,居仁里,177,538,53.16205534,474,46.83794466,1012,22,1034,0,1228,84.2019544
臺北縣,板橋市,莊敬里,193,659,50.34377387,650,49.65622613,1309,24,1333,0,1569,84.95857234
臺北縣,板橋市,莊敬里,194,546,53.11284047,482,46.88715953,1028,24,1052,0,1227,85.73757131
臺北縣,板橋市,東安里,218,442,55.31914894,357,44.68085106,799,15,814,0,976,83.40163934
臺北縣,板橋市,東安里,219,505,53.83795309,433,46.16204691,938,15,953,0,1662,57.34055355
臺北縣,板橋市,五權里,257,402,43.88646288,514,56.11353712,916,15,931,0,1121,83.05084746
臺北縣,板橋市,五權里,258,527,51.61606268,494,48.38393732,1021,20,1041,0,1239,84.01937046
臺北縣,板橋市,五權里,259,509,50.04916421,508,49.95083579,1017,18,1035,1,1272,81.36792453
臺北縣,板橋市,溪福里,314,628,49.33228594,645,50.66771406,1273,28,1301,0,1665,78.13813814
臺北縣,板橋市,溪福里,315,775,54.46240337,648,45.53759663,1423,25,1448,0,1808,80.08849558
臺北縣,板橋市,溪福里,316,630,47.65506808,692,52.34493192,1322,24,1346,0,1676,80.31026253
臺北縣,板橋市,溪福里,317,667,48.57975237,706,51.42024763,1373,23,1396,0,1735,80.4610951
臺北縣,板橋市,溪福里,318,521,44.15254237,659,55.84745763,1180,21,1201,0,1472,81.58967391
臺北縣,板橋市,大觀里,284,540,52.17391304,495,47.82608696,1035,22,1057,1,1300,81.30769231
臺北縣,板橋市,大觀里,285,672,56.18729097,524,43.81270903,1196,33,1229,0,1467,83.77641445
臺北縣,板橋市,歡園里,286,444,54.74722565,367,45.25277435,811,20,831,0,986,84.27991886
臺北縣,三重市,大有里,323,586,59.07258065,406,40.92741935,992,37,1029,0,1239,83.05084746
臺北縣,三重市,大有里,324,446,50.79726651,432,49.20273349,878,17,895,0,1057,84.67360454
臺北縣,三重市,大有里,325,573,57.5879397,422,42.4120603,995,19,1014,0,1248,81.25
臺北縣,三重市,二重里,329,450,62.93706294,265,37.06293706,715,19,734,0,916,80.13100437
臺北縣,三重市,二重里,330,367,57.79527559,268,42.20472441,635,25,660,0,830,79.51807229
臺北縣,三重市,頂崁里,331,413,62.6707132,246,37.3292868,659,20,679,0,840,80.83333333
臺北縣,三重市,頂崁里,332,468,60.62176166,304,39.37823834,772,12,784,0,927,84.57389428
臺北縣,三重市,谷王里,333,553,59.78378378,372,40.21621622,925,20,945,0,1117,84.60161146
臺北縣,三重市,中興里,336,770,56.28654971,598,43.71345029,1368,30,1398,0,1642,85.14007308
臺北縣,三重市,中興里,337,636,57.04035874,479,42.95964126,1115,34,1149,0,1434,80.12552301
臺北縣,三重市,德厚里,338,211,66.35220126,107,33.64779874,318,10,328,0,391,83.88746803
臺北縣,三重市,成功里,339,484,56.14849188,378,43.85150812,862,29,891,0,1057,84.29517502
臺北縣,三重市,成功里,340,564,50.26737968,558,49.73262032,1122,16,1138,0,1392,81.75287356
臺北縣,三重市,成功里,341,706,50.14204545,702,49.85795455,1408,28,1436,0,1730,83.00578035
臺北縣,三重市,福祉里,342,591,50.8605852,571,49.1394148,1162,29,1191,0,1459,81.63125428
臺北縣,三重市,福祉里,343,727,53.93175074,621,46.06824926,1348,25,1373,0,1693,81.09864146
臺北縣,三重市,福民里,346,566,53.95614871,483,46.04385129,1049,32,1081,0,1297,83.3461835
臺北縣,三重市,福民里,347,570,53.420806,497,46.579194,1067,21,1088,0,1333,81.6204051
臺北縣,三重市,過田里,348,474,41.54250657,667,58.45749343,1141,24,1165,0,1866,62.43301179
臺北縣,三重市,過田里,349,664,52.78219396,594,47.21780604,1258,34,1292,0,1535,84.16938111
臺北縣,三重市,過田里,350,546,48.19064431,587,51.80935569,1133,33,1166,0,1432,81.42458101
臺北縣,三重市,錦田里,351,348,54.20560748,294,45.79439252,642,18,660,0,805,81.98757764
臺北縣,三重市,錦田里,352,437,57.19895288,327,42.80104712,764,15,779,0,947,82.25976769
臺北縣,三重市,重明里,353,544,55.96707819,428,44.03292181,972,28,1000,0,1155,86.58008658
臺北縣,三重市,重明里,354,574,57.34265734,427,42.65734266,1001,33,1034,0,1235,83.72469636
臺北縣,三重市,光田里,355,442,51.63551402,414,48.36448598,856,17,873,0,1073,81.36067102
臺北縣,三重市,光田里,356,557,51.91053122,516,48.08946878,1073,19,1092,0,1288,84.7826087
臺北縣,三重市,光田里,357,494,50.92783505,476,49.07216495,970,24,994,0,1189,83.59966358
臺北縣,三重市,光陽里,358,692,52.86478228,617,47.13521772,1309,18,1327,0,1603,82.78228322
臺北縣,三重市,光陽里,359,780,55.83392985,617,44.16607015,1397,18,1415,0,1703,83.08866706
臺北縣,三重市,光陽里,360,765,56.62472243,586,43.37527757,1351,54,1405,0,1666,84.33373349
臺北縣,三重市,田心里,361,473,52.38095238,430,47.61904762,903,24,927,0,1107,83.7398374
臺北縣,三重市,田心里,362,469,51.53846154,441,48.46153846,910,13,923,0,1086,84.9907919
臺北縣,三重市,田心里,363,610,61.06106106,389,38.93893894,999,15,1014,0,1228,82.5732899
臺北縣,三重市,福田里,364,676,60.30330062,445,39.69669938,1121,15,1136,0,1361,83.46803821
臺北縣,三重市,福田里,365,681,57.17884131,510,42.82115869,1191,27,1218,0,1438,84.70097357
臺北縣,三重市,田中里,366,711,61.77237185,440,38.22762815,1151,32,1183,0,1415,83.60424028
臺北縣,三重市,田中里,367,704,63.1956912,410,36.8043088,1114,21,1135,0,1350,84.07407407
臺北縣,三重市,田中里,368,893,58.63427446,630,41.36572554,1523,27,1550,0,1839,84.28493747
臺北縣,三重市,田安里,369,730,55.89586524,576,44.10413476,1306,36,1342,0,1630,82.33128834
臺北縣,三重市,田安里,370,686,52.04855842,632,47.95144158,1318,35,1353,0,1665,81.26126126
臺北縣,三重市,田安里,371,692,53.23076923,608,46.76923077,1300,52,1352,0,1628,83.04668305
臺北縣,三重市,三民里,372,715,57.568438,527,42.431562,1242,22,1264,0,1533,82.45270711
臺北縣,三重市,三民里,373,439,53.01932367,389,46.98067633,828,20,848,0,1022,82.97455969
臺北縣,三重市,光明里,374,546,52.65188042,491,47.34811958,1037,20,1057,0,1305,80.99616858
臺北縣,三重市,光明里,375,406,47.48538012,449,52.51461988,855,29,884,1,1130,78.2300885
臺北縣,三重市,光明里,376,465,49.05063291,483,50.94936709,948,33,981,0,1218,80.54187192
臺北縣,三重市,光明里,377,643,57.25734639,480,42.74265361,1123,21,1144,0,1382,82.77858177
臺北縣,三重市,光正里,378,521,43.34442596,681,56.65557404,1202,32,1234,0,1559,79.1533034
臺北縣,三重市,同安里,379,479,42.05443371,660,57.94556629,1139,47,1186,1,1537,77.16330514
臺北縣,三重市,同慶里,380,578,49.87057808,581,50.12942192,1159,35,1194,0,1483,80.51247471
臺北縣,三重市,菜寮里,381,416,52.195734,381,47.804266,797,16,813,0,1004,80.97609562
臺北縣,三重市,菜寮里,382,317,52.65780731,285,47.34219269,602,16,618,0,728,84.89010989
臺北縣,三重市,永春里,383,577,48.98132428,601,51.01867572,1178,31,1209,0,1481,81.63403106
臺北縣,三重市,中正里,384,503,54.31965443,423,45.68034557,926,31,957,0,1183,80.89602705
臺北縣,三重市,吉利里,385,497,50.15136226,494,49.84863774,991,35,1026,0,1271,80.7238395
臺北縣,三重市,大同里,386,656,53.29000812,575,46.70999188,1231,16,1247,0,1568,79.52806122
臺北縣,三重市,中民里,387,444,48.41875682,473,51.58124318,917,36,953,0,1163,81.94325021
臺北縣,三重市,平和里,388,592,53.52622061,514,46.47377939,1106,48,1154,0,1463,78.87901572
臺北縣,三重市,大安里,389,557,49.73214286,563,50.26785714,1120,43,1163,0,1426,81.55680224
臺北縣,三重市,仁德里,390,364,55.74272588,289,44.25727412,653,16,669,0,817,81.88494492
臺北縣,三重市,仁德里,391,478,56.83709869,363,43.16290131,841,37,878,0,1082,81.14602588
臺北縣,三重市,忠孝里,392,732,58.28025478,524,41.71974522,1256,31,1287,0,1625,79.2
臺北縣,三重市,仁義里,393,443,49.44196429,453,50.55803571,896,25,921,0,1099,83.80345769
臺北縣,三重市,光榮里,394,480,55.55555556,384,44.44444444,864,35,899,0,1112,80.84532374
臺北縣,三重市,光輝里,395,582,46.00790514,683,53.99209486,1265,29,1294,0,1545,83.75404531
臺北縣,三重市,福星里,396,327,51.9872814,302,48.0127186,629,24,653,0,792,82.44949495
臺北縣,三重市,福利里,397,627,50.32102729,619,49.67897271,1246,20,1266,0,1580,80.12658228
臺北縣,三重市,清和里,398,780,49.84025559,785,50.15974441,1565,30,1595,0,1966,81.12919634
臺北縣,三重市,清和里,399,498,52.09205021,458,47.90794979,956,20,976,0,1160,84.13793103
臺北縣,三重市,永興里,400,477,50.52966102,467,49.47033898,944,23,967,0,1193,81.05616094
臺北縣,三重市,中山里,401,448,55.2404439,363,44.7595561,811,19,830,0,1001,82.91708292
臺北縣,三重市,中山里,402,485,52.7173913,435,47.2826087,920,21,941,0,1115,84.39461883
臺北縣,三重市,大園里,403,446,56.31313131,346,43.68686869,792,17,809,0,1005,80.49751244
臺北縣,三重市,大園里,404,537,59.2061742,370,40.7938258,907,16,923,0,1147,80.47079337
臺北縣,三重市,國隆里,405,455,53.09218203,402,46.90781797,857,24,881,0,1057,83.34910123
臺北縣,三重市,國隆里,406,481,51.49892934,453,48.50107066,934,24,958,0,1122,85.38324421
臺北縣,三重市,重陽里,407,684,56.48224608,527,43.51775392,1211,25,1236,0,1511,81.80013236
臺北縣,三重市,重陽里,408,574,51.47982063,541,48.52017937,1115,28,1143,0,1409,81.12136267
臺北縣,三重市,民生里,409,583,58.94843276,406,41.05156724,989,25,1014,0,1240,81.77419355
臺北縣,三重市,民生里,410,625,58.41121495,445,41.58878505,1070,29,1099,0,1313,83.70144707
臺北縣,三重市,民生里,411,544,55.68065507,433,44.31934493,977,20,997,0,1176,84.77891156
臺北縣,三重市,重新里,412,606,57.16981132,454,42.83018868,1060,32,1092,0,1323,82.53968254
臺北縣,三重市,正德里,413,474,58.37438424,338,41.62561576,812,26,838,0,1017,82.39921337
臺北縣,三重市,正義里,414,653,53.61247947,565,46.38752053,1218,30,1248,1,1521,82.05128205
臺北縣,三重市,正安里,415,723,54.85584219,595,45.14415781,1318,50,1368,0,1660,82.40963855
臺北縣,三重市,自強里,416,754,57.9109063,548,42.0890937,1302,44,1346,0,1624,82.8817734
臺北縣,三重市,文化里,417,506,57.239819,378,42.760181,884,19,903,0,1086,83.14917127
臺北縣,三重市,文化里,418,494,57.84543326,360,42.15456674,854,20,874,0,1040,84.03846154
臺北縣,三重市,中央里,419,709,56.72,541,43.28,1250,38,1288,0,1540,83.63636364
臺北縣,三重市,雙園里,420,338,53.06122449,299,46.93877551,637,27,664,0,833,79.71188475
臺北縣,三重市,錦通里,421,591,52.16240071,542,47.83759929,1133,43,1176,0,1475,79.72881356
臺北縣,三重市,錦安里,422,412,55.22788204,334,44.77211796,746,10,756,0,929,81.37782562
臺北縣,三重市,錦安里,423,346,52.26586103,316,47.73413897,662,16,678,0,825,82.18181818
臺北縣,三重市,長安里,424,372,51.81058496,346,48.18941504,718,37,755,0,978,77.19836401
臺北縣,三重市,長安里,425,391,49.12060302,405,50.87939698,796,19,815,0,980,83.16326531
臺北縣,三重市,光華里,426,700,53.35365854,612,46.64634146,1312,17,1329,0,1656,80.25362319
臺北縣,三重市,長生里,427,409,64.20722135,228,35.79277865,637,8,645,0,773,83.44113842
臺北縣,三重市,開元里,428,616,57.84037559,449,42.15962441,1065,13,1078,0,1311,82.2273074
臺北縣,三重市,大德里,429,289,54.42561205,242,45.57438795,531,17,548,0,649,84.4375963
臺北縣,三重市,長元里,430,456,58.23754789,327,41.76245211,783,20,803,0,982,81.77189409
臺北縣,三重市,長元里,431,496,52.87846482,442,47.12153518,938,31,969,0,1173,82.60869565
臺北縣,三重市,長江里,432,760,56.80119581,578,43.19880419,1338,43,1381,0,1720,80.29069767
臺北縣,三重市,長泰里,433,526,58.63991081,371,41.36008919,897,22,919,0,1148,80.05226481
臺北縣,三重市,長泰里,434,364,51.63120567,341,48.36879433,705,29,734,0,920,79.7826087
臺北縣,三重市,長福里,435,604,53.92857143,516,46.07142857,1120,31,1151,0,1434,80.26499303
臺北縣,三重市,介壽里,436,469,55.76694411,372,44.23305589,841,30,871,0,1084,80.35055351
臺北縣,三重市,萬壽里,437,391,55.77746077,310,44.22253923,701,33,734,0,909,80.74807481
臺北縣,三重市,萬壽里,438,338,50,338,50,676,11,687,0,815,84.29447853
臺北縣,三重市,錦江里,439,449,54.75609756,371,45.24390244,820,18,838,0,1048,79.96183206
臺北縣,三重市,錦江里,440,472,57.63125763,347,42.36874237,819,22,841,0,1040,80.86538462
臺北縣,三重市,龍濱里,441,569,57.18592965,426,42.81407035,995,14,1009,0,1213,83.18219291
臺北縣,三重市,龍濱里,442,672,58.48563969,477,41.51436031,1149,38,1187,0,1417,83.76852505
臺北縣,三重市,龍門里,443,742,56.38297872,574,43.61702128,1316,31,1347,0,1659,81.19349005
臺北縣,三重市,秀江里,444,530,56.38297872,410,43.61702128,940,26,966,0,1159,83.34771355
臺北縣,三重市,奕壽里,445,638,60.58879392,415,39.41120608,1053,36,1089,0,1334,81.63418291
臺北縣,三重市,三安里,446,445,52.60047281,401,47.39952719,846,18,864,0,1052,82.12927757
臺北縣,三重市,三安里,447,573,57.87878788,417,42.12121212,990,28,1018,0,1244,81.83279743
臺北縣,三重市,福安里,448,555,58.91719745,387,41.08280255,942,32,974,0,1198,81.30217028
臺北縣,三重市,福安里,449,619,57.90458372,450,42.09541628,1069,45,1114,0,1347,82.70230141
臺北縣,三重市,信安里,450,725,55.55555556,580,44.44444444,1305,27,1332,0,1607,82.88736777
臺北縣,三重市,安慶里,451,417,60.69868996,270,39.30131004,687,23,710,0,879,80.77360637
臺北縣,三重市,安慶里,452,455,59.47712418,310,40.52287582,765,24,789,0,981,80.42813456
臺北縣,三重市,幸福里,453,554,52.21489161,507,47.78510839,1061,33,1094,0,1354,80.79763663
臺北縣,三重市,幸福里,454,566,57.34549139,421,42.65450861,987,15,1002,0,1204,83.22259136
臺北縣,三重市,幸福里,455,570,57.57575758,420,42.42424242,990,25,1015,0,1252,81.07028754
臺北縣,三重市,六合里,456,771,55.03211991,630,44.96788009,1401,27,1428,1,1722,82.92682927
臺北縣,三重市,六合里,457,708,59.74683544,477,40.25316456,1185,36,1221,0,1468,83.17438692
臺北縣,三重市,六福里,458,760,61.78861789,470,38.21138211,1230,19,1249,0,1507,82.87989383
臺北縣,三重市,六福里,459,667,61.08058608,425,38.91941392,1092,26,1118,0,1315,85.01901141
臺北縣,三重市,六福里,460,681,56.9874477,514,43.0125523,1195,18,1213,0,1449,83.71290545
臺北縣,三重市,順德里,461,430,53.68289638,371,46.31710362,801,38,839,0,1014,82.74161736
臺北縣,三重市,順德里,462,372,53.60230548,322,46.39769452,694,10,704,0,862,81.67053364
臺北縣,三重市,承德里,463,686,52.24676314,627,47.75323686,1313,50,1363,0,1664,81.91105769
臺北縣,三重市,瑞德里,464,481,60.27568922,317,39.72431078,798,26,824,0,995,82.81407035
臺北縣,三重市,瑞德里,465,551,58.43054083,392,41.56945917,943,18,961,0,1146,83.85689354
臺北縣,三重市,崇德里,466,456,56.71641791,348,43.28358209,804,14,818,0,1001,81.71828172
臺北縣,三重市,崇德里,467,733,59.44849959,500,40.55150041,1233,26,1259,0,1530,82.2875817
臺北縣,三重市,崇德里,468,413,55.51075269,331,44.48924731,744,25,769,0,910,84.50549451
臺北縣,三重市,厚德里,469,640,59.70149254,432,40.29850746,1072,30,1102,0,1300,84.76923077
臺北縣,三重市,厚德里,470,715,56.8814638,542,43.1185362,1257,27,1284,0,1511,84.97683653
臺北縣,三重市,維德里,471,718,63.31569665,416,36.68430335,1134,34,1168,0,1400,83.42857143
臺北縣,三重市,維德里,472,466,53.74855825,401,46.25144175,867,20,887,0,1063,83.44308561
臺北縣,三重市,尚德里,473,699,54.39688716,586,45.60311284,1285,28,1313,0,1604,81.85785536
臺北縣,三重市,尚德里,474,421,46.9342252,476,53.0657748,897,24,921,0,1125,81.86666667
臺北縣,三重市,培德里,475,514,58.54214123,364,41.45785877,878,27,905,0,1083,83.56417359
臺北縣,三重市,培德里,476,805,56.2150838,627,43.7849162,1432,29,1461,0,1737,84.11053541
臺北縣,三重市,永德里,479,645,53.17394889,568,46.82605111,1213,38,1251,0,1548,80.81395349
臺北縣,三重市,永德里,480,573,60.31578947,377,39.68421053,950,13,963,0,1169,82.37810094
臺北縣,三重市,永德里,481,640,56.88888889,485,43.11111111,1125,35,1160,0,1393,83.27351041
臺北縣,三重市,永盛里,487,634,58.59519409,448,41.40480591,1082,27,1109,0,1373,80.77203205
臺北縣,三重市,永盛里,488,690,59.48275862,470,40.51724138,1160,31,1191,0,1485,80.2020202
臺北縣,三重市,永福里,496,656,62.95585413,386,37.04414587,1042,25,1067,0,1313,81.26428027
臺北縣,三重市,永福里,497,563,59.26315789,387,40.73684211,950,27,977,0,1197,81.62071846
臺北縣,三重市,永福里,498,657,52.06022187,605,47.93977813,1262,30,1292,0,1591,81.20678818
臺北縣,三重市,永清里,499,713,58.87696119,498,41.12303881,1211,31,1242,0,1515,81.98019802
臺北縣,三重市,永清里,500,726,57.84860558,529,42.15139442,1255,34,1289,0,1556,82.84061697
臺北縣,三重市,永清里,501,639,55.32467532,516,44.67532468,1155,31,1186,0,1407,84.29282161
臺北縣,三重市,永安里,491,621,52.76125743,556,47.23874257,1177,26,1203,0,1471,81.78110129
臺北縣,三重市,永安里,492,597,57.7928364,436,42.2071636,1033,24,1057,0,1293,81.74787316
臺北縣,三重市,永輝里,482,596,60.56910569,388,39.43089431,984,31,1015,0,1216,83.47039474
臺北縣,三重市,永輝里,483,520,67.09677419,255,32.90322581,775,19,794,0,973,81.6032888
臺北縣,三重市,溪美里,505,761,57.82674772,555,42.17325228,1316,25,1341,0,1594,84.12797992
臺北縣,三重市,溪美里,506,551,57.87815126,401,42.12184874,952,21,973,0,1418,68.61777151
臺北縣,三重市,溪美里,507,649,55,531,45,1180,46,1226,0,1445,84.84429066
臺北縣,三重市,溪美里,508,534,54.9382716,438,45.0617284,972,22,994,0,1197,83.04093567
臺北縣,三重市,福隆里,509,722,56.01241272,567,43.98758728,1289,24,1313,0,1610,81.55279503
臺北縣,三重市,福隆里,510,680,58.02047782,492,41.97952218,1172,27,1199,0,1502,79.82689747
臺北縣,三重市,五常里,511,456,52.53456221,412,47.46543779,868,34,902,0,1079,83.59592215
臺北縣,三重市,五常里,512,544,59.8459846,365,40.1540154,909,27,936,0,1124,83.27402135
臺北縣,三重市,五常里,513,518,56.42701525,400,43.57298475,918,23,941,0,1143,82.3272091
臺北縣,三重市,五福里,514,500,56.30630631,388,43.69369369,888,23,911,0,1111,81.99819982
臺北縣,三重市,五福里,515,506,56.66293393,387,43.33706607,893,37,930,0,1161,80.10335917
臺北縣,三重市,仁忠里,516,608,53.19335083,535,46.80664917,1143,34,1177,0,1492,78.88739946
臺北縣,三重市,仁忠里,517,551,56.9214876,417,43.0785124,968,28,996,0,1199,83.06922435
臺北縣,三重市,慈福里,518,450,61.89821183,277,38.10178817,727,11,738,0,908,81.27753304
臺北縣,三重市,慈福里,519,473,54.74537037,391,45.25462963,864,25,889,0,1084,82.01107011
臺北縣,三重市,慈生里,520,383,55.83090379,303,44.16909621,686,17,703,0,902,77.93791574
臺北縣,三重市,慈生里,521,514,54.68085106,426,45.31914894,940,9,949,0,1141,83.17265557
臺北縣,三重市,慈惠里,522,509,61.25150421,322,38.74849579,831,28,859,1,1055,81.42180095
臺北縣,三重市,慈惠里,523,483,63.38582677,279,36.61417323,762,19,781,1,946,82.55813953
臺北縣,三重市,慈愛里,524,792,60.68965517,513,39.31034483,1305,40,1345,0,1613,83.3849969
臺北縣,三重市,慈愛里,525,701,56.53225806,539,43.46774194,1240,37,1277,0,1561,81.80653427
臺北縣,三重市,慈化里,526,501,59.85663082,336,40.14336918,837,27,864,0,1044,82.75862069
臺北縣,三重市,慈化里,527,438,54.20792079,370,45.79207921,808,30,838,0,1040,80.57692308
臺北縣,三重市,慈祐里,528,536,57.82092772,391,42.17907228,927,33,960,0,1202,79.86688852
臺北縣,三重市,慈祐里,529,564,59.11949686,390,40.88050314,954,33,987,0,1238,79.72536349
臺北縣,三重市,慈祐里,530,566,56.15079365,442,43.84920635,1008,24,1032,0,1232,83.76623377
臺北縣,三重市,五華里,537,796,62.48037677,478,37.51962323,1274,39,1313,0,1577,83.2593532
臺北縣,三重市,五華里,538,651,59.88960442,436,40.11039558,1087,26,1113,0,1285,86.61478599
臺北縣,三重市,富貴里,533,684,61.18067979,434,38.81932021,1118,24,1142,0,1436,79.5264624
臺北縣,三重市,富貴里,534,544,54.94949495,446,45.05050505,990,23,1013,0,1212,83.58085809
臺北縣,三重市,富華里,531,444,53.23741007,390,46.76258993,834,28,862,0,1074,80.26070764
臺北縣,三重市,富華里,532,507,57.2234763,379,42.7765237,886,29,915,0,1139,80.33362599
臺北縣,三重市,富福里,535,321,53.94957983,274,46.05042017,595,16,611,0,752,81.25
臺北縣,三重市,富福里,536,491,61.76100629,304,38.23899371,795,27,822,0,1034,79.49709865
臺北縣,三重市,碧華里,539,474,59.697733,320,40.302267,794,24,818,0,1026,79.72709552
臺北縣,三重市,碧華里,540,445,48.36956522,475,51.63043478,920,23,943,0,1139,82.79192274
臺北縣,三重市,五谷里,334,536,56.77966102,408,43.22033898,944,30,974,0,1172,83.10580205
臺北縣,三重市,五谷里,335,312,56.52173913,240,43.47826087,552,19,571,0,691,82.63386397
臺北縣,三重市,博愛里,326,603,58.37366893,430,41.62633107,1033,24,1057,0,1285,82.25680934
臺北縣,三重市,博愛里,327,449,40.34141959,664,59.65858041,1113,31,1144,0,1372,83.3819242
臺北縣,三重市,博愛里,328,464,55.83634176,367,44.16365824,831,19,850,0,1021,83.25171401
臺北縣,三重市,福德里,344,657,56.83391003,499,43.16608997,1156,27,1183,0,1456,81.25
臺北縣,三重市,福德里,345,753,55.04385965,615,44.95614035,1368,28,1396,0,1719,81.21000582
臺北縣,三重市,永吉里,489,540,53.09734513,477,46.90265487,1017,12,1029,0,1251,82.25419664
臺北縣,三重市,永吉里,490,556,61.30099228,351,38.69900772,907,25,932,0,1148,81.18466899
臺北縣,三重市,永發里,484,542,59.82339956,364,40.17660044,906,9,915,0,1105,82.80542986
臺北縣,三重市,永發里,485,585,60.74766355,378,39.25233645,963,15,978,0,1174,83.30494037
臺北縣,三重市,永發里,486,771,66.92708333,381,33.07291667,1152,22,1174,0,1364,86.07038123
臺北縣,三重市,永順里,502,610,55.30371714,493,44.69628286,1103,37,1140,0,1378,82.72859216
臺北縣,三重市,永順里,503,649,59.92613112,434,40.07386888,1083,28,1111,0,1393,79.75592247
臺北縣,三重市,永順里,504,525,64.25948592,292,35.74051408,817,18,835,0,1022,81.70254403
臺北縣,三重市,永豐里,493,656,60.46082949,429,39.53917051,1085,7,1092,0,1334,81.85907046
臺北縣,三重市,永豐里,494,492,60.22031824,325,39.77968176,817,12,829,0,1051,78.87725975
臺北縣,三重市,永豐里,495,735,58.05687204,531,41.94312796,1266,36,1302,0,1580,82.40506329
臺北縣,三重市,立德里,477,631,55.30236635,510,44.69763365,1141,36,1177,0,1419,82.94573643
臺北縣,三重市,立德里,478,640,58.34092981,457,41.65907019,1097,13,1110,0,1331,83.3959429
臺北縣,三重市,福樂里,541,737,60.60855263,479,39.39144737,1216,35,1251,0,1491,83.90342052
臺北縣,三重市,福樂里,542,688,56.53245686,529,43.46754314,1217,17,1234,0,1498,82.376502
臺北縣,三重市,仁華里,543,780,59.58747135,529,40.41252865,1309,38,1347,0,1649,81.68587022
臺北縣,三重市,仁華里,544,660,55.74324324,524,44.25675676,1184,37,1221,0,1508,80.96816976
臺北縣,三重市,五順里,545,667,55.21523179,541,44.78476821,1208,46,1254,0,1563,80.2303263
臺北縣,三重市,五順里,546,708,57.32793522,527,42.67206478,1235,29,1264,0,1554,81.33848134
臺北縣,中和市,中原里,547,718,55.65891473,572,44.34108527,1290,45,1335,0,1648,81.00728155
臺北縣,中和市,中原里,548,353,58.05921053,255,41.94078947,608,11,619,0,753,82.20451527
臺北縣,中和市,中原里,549,472,38.97605285,739,61.02394715,1211,21,1232,0,1516,81.26649077
臺北縣,中和市,平河里,592,753,52.40083507,684,47.59916493,1437,47,1484,0,1855,80
臺北縣,中和市,平河里,593,872,44.94845361,1068,55.05154639,1940,40,1980,0,2433,81.3810111
臺北縣,中和市,平河里,594,401,33.05853256,812,66.94146744,1213,30,1243,0,1461,85.07871321
臺北縣,中和市,平河里,595,279,34.23312883,536,65.76687117,815,12,827,0,972,85.08230453
臺北縣,中和市,信和里,596,414,47.31428571,461,52.68571429,875,18,893,0,1085,82.30414747
臺北縣,中和市,信和里,597,436,44.08493428,553,55.91506572,989,44,1033,0,1279,80.76622361
臺北縣,中和市,信和里,598,470,46.30541872,545,53.69458128,1015,38,1053,0,1271,82.84815106
臺北縣,中和市,仁和里,599,402,37.39534884,673,62.60465116,1075,32,1107,0,1379,80.275562
臺北縣,中和市,仁和里,600,344,45.14435696,418,54.85564304,762,23,785,0,943,83.24496288
臺北縣,中和市,仁和里,601,462,46.4321608,533,53.5678392,995,36,1031,0,1235,83.48178138
臺北縣,中和市,中正里,602,563,42.426526,764,57.573474,1327,55,1382,0,1686,81.96915777
臺北縣,中和市,中正里,603,607,44.69808542,751,55.30191458,1358,38,1396,1,1729,80.74031232
臺北縣,中和市,建和里,606,157,13.40734415,1014,86.59265585,1171,21,1192,0,1381,86.31426503
臺北縣,中和市,建和里,607,685,45.6362425,816,54.3637575,1501,56,1557,0,1914,81.34796238
臺北縣,中和市,連和里,550,240,43.79562044,308,56.20437956,548,9,557,0,687,81.07714702
臺北縣,中和市,連和里,551,33,11.82795699,246,88.17204301,279,9,288,0,358,80.44692737
臺北縣,中和市,連城里,552,515,35.2739726,945,64.7260274,1460,28,1488,0,1800,82.66666667
臺北縣,中和市,連城里,553,365,30.8277027,819,69.1722973,1184,17,1201,0,1397,85.96993558
臺北縣,中和市,連城里,554,662,45.1568895,804,54.8431105,1466,32,1498,0,1819,82.35294118
臺北縣,中和市,力行里,555,706,37.55319149,1174,62.44680851,1880,54,1934,0,2323,83.2544124
臺北縣,中和市,力行里,556,683,40.29498525,1012,59.70501475,1695,22,1717,0,2021,84.95794161
臺北縣,中和市,枋寮里,561,529,45.25235244,640,54.74764756,1169,21,1190,0,1421,83.74384236
臺北縣,中和市,枋寮里,562,516,42.89276808,687,57.10723192,1203,34,1237,0,1565,79.04153355
臺北縣,中和市,漳和里,563,479,44.64119292,594,55.35880708,1073,31,1104,0,1314,84.01826484
臺北縣,中和市,漳和里,564,497,41.17647059,710,58.82352941,1207,18,1225,0,1454,84.25034388
臺北縣,中和市,廟美里,565,425,45.50321199,509,54.49678801,934,29,963,0,1165,82.66094421
臺北縣,中和市,廟美里,566,388,40.50104384,570,59.49895616,958,26,984,0,1213,81.12118714
臺北縣,中和市,廟美里,567,501,44.81216458,617,55.18783542,1118,29,1147,1,1448,79.21270718
臺北縣,中和市,福真里,568,568,42.99772899,753,57.00227101,1321,34,1355,0,1673,80.99222953
臺北縣,中和市,福真里,569,724,50.34770515,714,49.65229485,1438,53,1491,0,1776,83.9527027
臺北縣,中和市,福善里,570,572,43.79785605,734,56.20214395,1306,25,1331,0,1598,83.29161452
臺北縣,中和市,福善里,571,247,29.33491686,595,70.66508314,842,16,858,0,1056,81.25
臺北縣,中和市,福善里,572,311,43.07479224,411,56.92520776,722,12,734,0,894,82.10290828
臺北縣,中和市,福美里,573,402,32.05741627,852,67.94258373,1254,32,1286,0,1533,83.8878017
臺北縣,中和市,福美里,574,519,49.1943128,536,50.8056872,1055,21,1076,0,1298,82.89676425
臺北縣,中和市,福美里,575,409,45.85201794,483,54.14798206,892,25,917,0,1120,81.875
臺北縣,中和市,福祥里,576,576,42.10526316,792,57.89473684,1368,30,1398,0,1694,82.52656434
臺北縣,中和市,福祥里,577,826,46.61399549,946,53.38600451,1772,58,1830,0,2224,82.28417266
臺北縣,中和市,瓦窯里,578,363,47.20416125,406,52.79583875,769,30,799,0,962,83.05613306
臺北縣,中和市,瓦窯里,579,465,39.47368421,713,60.52631579,1178,39,1217,0,1479,82.28532792
臺北縣,中和市,瓦窯里,580,616,42.60027663,830,57.39972337,1446,34,1480,0,1769,83.66308649
臺北縣,中和市,福和里,581,529,45.29109589,639,54.70890411,1168,35,1203,0,1477,81.44888287
臺北縣,中和市,福和里,582,626,44.14668547,792,55.85331453,1418,40,1458,0,1768,82.46606335
臺北縣,中和市,佳和里,583,522,40.3712297,771,59.6287703,1293,33,1326,0,1604,82.66832918
臺北縣,中和市,佳和里,584,513,43.6967632,661,56.3032368,1174,14,1188,1,1427,83.25157673
臺北縣,中和市,佳和里,585,328,37.87528868,538,62.12471132,866,22,888,0,1069,83.06828812
臺北縣,中和市,安樂里,611,370,32.59911894,765,67.40088106,1135,27,1162,0,1374,84.5705968
臺北縣,中和市,安樂里,612,423,30.47550432,965,69.52449568,1388,22,1410,0,1677,84.07871199
臺北縣,中和市,安和里,613,418,38.45446182,669,61.54553818,1087,21,1108,0,1324,83.6858006
臺北縣,中和市,安和里,614,296,31.12513144,655,68.87486856,951,19,970,0,1186,81.78752108
臺北縣,中和市,安平里,618,265,29.21719956,642,70.78280044,907,23,930,0,1116,83.33333333
臺北縣,中和市,安平里,619,298,29.7108674,705,70.2891326,1003,27,1030,0,1260,81.74603175
臺北縣,中和市,安平里,620,420,31.43712575,916,68.56287425,1336,30,1366,0,1621,84.26896977
臺北縣,中和市,中安里,621,445,30.88133241,996,69.11866759,1441,21,1462,0,1682,86.92033294
臺北縣,中和市,中安里,622,442,29.98643148,1032,70.01356852,1474,27,1501,0,1816,82.65418502
臺北縣,中和市,泰安里,623,361,38.94282632,566,61.05717368,927,28,955,0,1140,83.77192982
臺北縣,中和市,泰安里,624,289,37.67926988,478,62.32073012,767,13,780,0,938,83.15565032
臺北縣,中和市,泰安里,625,372,37.9979571,607,62.0020429,979,25,1004,0,1235,81.29554656
臺北縣,中和市,新南里,586,548,38.6187456,871,61.3812544,1419,22,1441,0,1695,85.01474926
臺北縣,中和市,新南里,587,264,40.55299539,387,59.44700461,651,26,677,0,822,82.36009732
臺北縣,中和市,新南里,588,474,37.58921491,787,62.41078509,1261,34,1295,0,1594,81.24215809
臺北縣,中和市,新南里,589,592,31.07611549,1313,68.92388451,1905,26,1931,0,2298,84.02959095
臺北縣,中和市,南山里,590,689,38.9926429,1078,61.0073571,1767,34,1801,0,2170,82.99539171
臺北縣,中和市,南山里,591,619,38.80877743,976,61.19122257,1595,26,1621,0,1923,84.29537181
臺北縣,中和市,秀山里,626,596,39.0052356,932,60.9947644,1528,48,1576,0,1908,82.59958071
臺北縣,中和市,秀山里,627,515,34.70350404,969,65.29649596,1484,35,1519,0,1809,83.96904367
臺北縣,中和市,秀成里,628,410,37.00361011,698,62.99638989,1108,28,1136,0,1384,82.08092486
臺北縣,中和市,秀成里,629,478,36.60030628,828,63.39969372,1306,17,1323,0,1574,84.05336722
臺北縣,中和市,秀福里,632,521,35.51465576,946,64.48534424,1467,24,1491,0,1802,82.74139845
臺北縣,中和市,秀福里,633,299,36.02409639,531,63.97590361,830,13,843,0,993,84.89425982
臺北縣,中和市,秀福里,634,387,35.96654275,689,64.03345725,1076,27,1103,0,1309,84.26279603
臺北縣,中和市,秀景里,635,451,33.25958702,905,66.74041298,1356,24,1380,0,1706,80.89097304
臺北縣,中和市,秀景里,636,399,30.52792655,908,69.47207345,1307,25,1332,0,1640,81.2195122
臺北縣,中和市,秀景里,637,251,35.20336606,462,64.79663394,713,9,722,0,846,85.3427896
臺北縣,中和市,秀景里,638,271,28.1120332,693,71.8879668,964,15,979,0,1141,85.80192813
臺北縣,中和市,秀明里,639,313,27.72364925,816,72.27635075,1129,29,1158,0,1386,83.54978355
臺北縣,中和市,秀明里,640,534,24.67652495,1630,75.32347505,2164,42,2206,0,2723,81.01358795
臺北縣,中和市,秀峰里,641,341,30.52820054,776,69.47179946,1117,27,1144,0,1352,84.61538462
臺北縣,中和市,秀峰里,642,244,29.15173238,593,70.84826762,837,21,858,0,1034,82.9787234
臺北縣,中和市,秀峰里,643,184,21.74940898,662,78.25059102,846,16,862,0,1035,83.28502415
臺北縣,中和市,秀仁里,649,354,37.5,590,62.5,944,32,976,0,1207,80.86164043
臺北縣,中和市,秀仁里,650,326,34.71778488,613,65.28221512,939,31,970,0,1160,83.62068966
臺北縣,中和市,頂南里,654,257,26.82672234,701,73.17327766,958,27,985,0,1181,83.403895
臺北縣,中和市,頂南里,655,373,32.04467354,791,67.95532646,1164,26,1190,0,1417,83.98023994
臺北縣,中和市,華新里,656,364,25.81560284,1046,74.18439716,1410,28,1438,0,1771,81.19706381
臺北縣,中和市,華新里,657,441,29.6769852,1045,70.3230148,1486,47,1533,0,1927,79.55371043
臺北縣,中和市,華新里,658,508,33.70935634,999,66.29064366,1507,34,1541,0,1921,80.21863613
臺北縣,中和市,東南里,659,71,8.236658933,791,91.76334107,862,16,878,0,1047,83.85864374
臺北縣,中和市,東南里,660,286,25.13181019,852,74.86818981,1138,31,1169,0,1404,83.26210826
臺北縣,中和市,東南里,661,192,15.815486,1022,84.184514,1214,24,1238,0,1472,84.10326087
臺北縣,中和市,華南里,662,414,27.6,1086,72.4,1500,39,1539,0,1828,84.19037199
臺北縣,中和市,華南里,663,381,30.40702314,872,69.59297686,1253,42,1295,0,1571,82.43157225
臺北縣,中和市,忠孝里,664,210,30,490,70,700,29,729,0,910,80.10989011
臺北縣,中和市,忠孝里,665,236,33.42776204,470,66.57223796,706,21,727,0,879,82.7076223
臺北縣,中和市,忠孝里,666,262,25.5859375,762,74.4140625,1024,26,1050,1,1281,81.96721311
臺北縣,中和市,忠孝里,667,274,26.04562738,778,73.95437262,1052,38,1090,0,1352,80.62130178
臺北縣,中和市,崇南里,668,363,29.15662651,882,70.84337349,1245,15,1260,0,1516,83.11345646
臺北縣,中和市,崇南里,669,388,29.3494705,934,70.6505295,1322,32,1354,1,1600,84.625
臺北縣,中和市,景南里,672,285,30.54662379,648,69.45337621,933,23,956,0,1138,84.00702988
臺北縣,中和市,景南里,673,440,33.74233129,864,66.25766871,1304,31,1335,0,1625,82.15384615
臺北縣,中和市,橫路里,676,125,50.60728745,122,49.39271255,247,15,262,0,322,81.36645963
臺北縣,中和市,內南里,677,370,33.91384051,721,66.08615949,1091,28,1119,1,1363,82.09831255
臺北縣,中和市,內南里,678,349,31.78506375,749,68.21493625,1098,24,1122,0,1370,81.89781022
臺北縣,中和市,內南里,679,407,34.55008489,771,65.44991511,1178,37,1215,0,1501,80.94603598
臺北縣,中和市,壽南里,680,397,35.3202847,727,64.6797153,1124,20,1144,0,1399,81.77269478
臺北縣,中和市,壽南里,681,277,42.29007634,378,57.70992366,655,9,664,0,817,81.27294982
臺北縣,中和市,外南里,684,481,35.10948905,889,64.89051095,1370,31,1401,0,1734,80.79584775
臺北縣,中和市,外南里,685,530,37.83012134,871,62.16987866,1401,24,1425,0,2173,65.57754257
臺北縣,中和市,復興里,691,355,26.08376194,1006,73.91623806,1361,28,1389,0,1661,83.6243227
臺北縣,中和市,復興里,692,459,37.84006595,754,62.15993405,1213,38,1251,0,1564,79.98721228
臺北縣,中和市,復興里,693,456,40.46140195,671,59.53859805,1127,26,1153,0,1400,82.35714286
臺北縣,中和市,和興里,694,518,31.97530864,1102,68.02469136,1620,25,1645,0,1989,82.70487682
臺北縣,中和市,和興里,695,554,40.29090909,821,59.70909091,1375,46,1421,0,1740,81.66666667
臺北縣,中和市,景平里,696,444,33.28335832,890,66.71664168,1334,27,1361,0,1729,78.71602082
臺北縣,中和市,景平里,697,591,33.9070568,1152,66.0929432,1743,40,1783,0,2197,81.15612198
臺北縣,中和市,景新里,698,459,37.53066231,764,62.46933769,1223,45,1268,0,1584,80.05050505
臺北縣,中和市,景新里,699,447,35.4480571,814,64.5519429,1261,33,1294,0,1563,82.78950736
臺北縣,中和市,景福里,700,433,34.09448819,837,65.90551181,1270,21,1291,0,1590,81.19496855
臺北縣,中和市,景福里,701,304,31.40495868,664,68.59504132,968,22,990,0,1212,81.68316832
臺北縣,中和市,景福里,702,436,36.4548495,760,63.5451505,1196,16,1212,0,1488,81.4516129
臺北縣,中和市,景安里,703,241,38.74598071,381,61.25401929,622,22,644,0,780,82.56410256
臺北縣,中和市,景安里,704,244,25.0513347,730,74.9486653,974,19,993,1,1201,82.68109908
臺北縣,中和市,景安里,705,394,38.28960155,635,61.71039845,1029,42,1071,0,1288,83.15217391
臺北縣,中和市,景安里,706,284,36.88311688,486,63.11688312,770,17,787,0,960,81.97916667
臺北縣,中和市,景文里,707,446,34.92560689,831,65.07439311,1277,22,1299,0,1522,85.34822602
臺北縣,中和市,景文里,708,356,40.2259887,529,59.7740113,885,23,908,0,1078,84.23005566
臺北縣,中和市,錦和里,709,738,42.46260069,1000,57.53739931,1738,34,1772,0,2129,83.23156411
臺北縣,中和市,錦和里,710,609,42.43902439,826,57.56097561,1435,25,1460,0,1752,83.33333333
臺北縣,中和市,錦昌里,713,379,32.8707719,774,67.1292281,1153,27,1180,0,1418,83.2157969
臺北縣,中和市,灰窯里,716,211,52.61845387,190,47.38154613,401,14,415,0,516,80.42635659
臺北縣,中和市,積穗里,717,810,52.63157895,729,47.36842105,1539,45,1584,0,1990,79.59798995
臺北縣,中和市,積穗里,718,703,43.36829118,918,56.63170882,1621,44,1665,0,1997,83.37506259
臺北縣,中和市,積穗里,719,203,41.59836066,285,58.40163934,488,5,493,0,590,83.55932203
臺北縣,中和市,民享里,720,417,48.37587007,445,51.62412993,862,34,896,0,1044,85.82375479
臺北縣,中和市,民享里,721,490,50.10224949,488,49.89775051,978,22,1000,0,1160,86.20689655
臺北縣,中和市,員山里,724,510,48.99135447,531,51.00864553,1041,37,1078,0,1284,83.95638629
臺北縣,中和市,員山里,725,616,49.87854251,619,50.12145749,1235,32,1267,0,1563,81.06206014
臺北縣,中和市,員山里,726,282,44.69096672,349,55.30903328,631,11,642,0,772,83.16062176
臺北縣,中和市,嘉穗里,729,445,43.7992126,571,56.2007874,1016,17,1033,0,1221,84.6027846
臺北縣,中和市,嘉穗里,730,370,46.5408805,425,53.4591195,795,17,812,0,993,81.77240685
臺北縣,中和市,文元里,733,514,50.54080629,503,49.45919371,1017,32,1049,0,1258,83.3863275
臺北縣,中和市,文元里,734,674,51.96607556,623,48.03392444,1297,36,1333,0,1644,81.08272506
臺北縣,中和市,文元里,735,642,44.55239417,799,55.44760583,1441,37,1478,0,1775,83.26760563
臺北縣,中和市,嘉新里,736,523,45.91747147,616,54.08252853,1139,34,1173,0,1450,80.89655172
臺北縣,中和市,嘉新里,737,578,44.02132521,735,55.97867479,1313,22,1335,0,1621,82.35657002
臺北縣,中和市,民安里,738,560,49.95539697,561,50.04460303,1121,28,1149,0,1386,82.9004329
臺北縣,中和市,民安里,739,434,47.07158351,488,52.92841649,922,28,950,0,1141,83.26029798
臺北縣,中和市,民安里,740,461,46.28514056,535,53.71485944,996,21,1017,0,1239,82.08232446
臺北縣,中和市,安穗里,741,595,53.07760928,526,46.92239072,1121,33,1154,0,1395,82.72401434
臺北縣,中和市,安穗里,742,687,51.77091183,640,48.22908817,1327,51,1378,0,1675,82.26865672
臺北縣,中和市,瑞穗里,743,324,45.63380282,386,54.36619718,710,21,731,0,893,81.85890258
臺北縣,中和市,瑞穗里,744,251,32.72490222,516,67.27509778,767,17,784,0,940,83.40425532
臺北縣,中和市,明穗里,747,659,48.59882006,697,51.40117994,1356,25,1381,0,1645,83.95136778
臺北縣,中和市,明穗里,748,652,46.87275341,739,53.12724659,1391,20,1411,0,1723,81.89204875
臺北縣,中和市,清穗里,749,562,50.08912656,560,49.91087344,1122,33,1155,0,1404,82.26495726
臺北縣,中和市,清穗里,750,520,46.76258993,592,53.23741007,1112,31,1143,0,1389,82.28941685
臺北縣,中和市,自強里,751,447,50.2247191,443,49.7752809,890,18,908,1,1125,80.71111111
臺北縣,中和市,自強里,752,688,53.4992224,598,46.5007776,1286,27,1313,0,1580,83.10126582
臺北縣,中和市,自強里,753,474,43.13011829,625,56.86988171,1099,28,1127,0,1358,82.98969072
臺北縣,中和市,德穗里,754,419,36.75438596,721,63.24561404,1140,10,1150,1,1383,83.15256688
臺北縣,中和市,德穗里,755,438,46.64536741,501,53.35463259,939,35,974,0,1198,81.30217028
臺北縣,中和市,德穗里,756,450,49.77876106,454,50.22123894,904,20,924,0,1113,83.01886792
臺北縣,中和市,民生里,757,530,47.27921499,591,52.72078501,1121,32,1153,1,1366,84.40702782
臺北縣,中和市,民生里,758,801,45.38243626,964,54.61756374,1765,40,1805,2,2160,83.56481481
臺北縣,中和市,國光里,759,707,50,707,50,1414,42,1456,0,1781,81.75182482
臺北縣,中和市,國光里,760,455,41.97416974,629,58.02583026,1084,17,1101,0,1315,83.72623574
臺北縣,中和市,壽德里,763,306,41.86046512,425,58.13953488,731,20,751,0,892,84.19282511
臺北縣,中和市,壽德里,764,343,17.28830645,1641,82.71169355,1984,53,2037,0,2381,85.55228895
臺北縣,中和市,明德里,765,704,46.16393443,821,53.83606557,1525,39,1564,0,1871,83.59166221
臺北縣,中和市,明德里,766,587,50.38626609,578,49.61373391,1165,31,1196,0,1461,81.86173854
臺北縣,中和市,秀水里,646,283,31.54960981,614,68.45039019,897,25,922,0,1128,81.73758865
臺北縣,中和市,秀水里,647,294,32.34323432,615,67.65676568,909,34,943,0,1138,82.86467487
臺北縣,中和市,秀水里,648,220,23.4791889,717,76.5208111,937,30,967,0,1184,81.6722973
臺北縣,中和市,德行里,559,535,32.96364757,1088,67.03635243,1623,15,1638,0,1992,82.22891566
臺北縣,中和市,德行里,560,603,42.73564848,808,57.26435152,1411,29,1440,0,1745,82.52148997
臺北縣,中和市,宜安里,610,405,32.32242618,848,67.67757382,1253,35,1288,0,1596,80.70175439
臺北縣,中和市,安順里,615,451,35.51181102,819,64.48818898,1270,30,1300,0,1566,83.01404853
臺北縣,中和市,安順里,616,245,32.62316911,506,67.37683089,751,11,762,0,900,84.66666667
臺北縣,中和市,安順里,617,266,31.70441001,573,68.29558999,839,24,863,0,1062,81.26177024
臺北縣,中和市,秀義里,630,413,41.46586345,583,58.53413655,996,31,1027,0,1236,83.09061489
臺北縣,中和市,秀義里,631,312,35.25423729,573,64.74576271,885,18,903,0,1083,83.37950139
臺北縣,中和市,秀士里,644,242,25.58139535,704,74.41860465,946,52,998,0,1255,79.52191235
臺北縣,中和市,秀士里,645,249,31.47914033,542,68.52085967,791,24,815,0,977,83.41862845
臺北縣,中和市,興南里,670,429,37.07865169,728,62.92134831,1157,42,1199,0,1451,82.63266713
臺北縣,中和市,興南里,671,313,27.26480836,835,72.73519164,1148,27,1175,0,1463,80.31442242
臺北縣,中和市,景本里,674,306,43.281471,401,56.718529,707,18,725,0,876,82.76255708
臺北縣,中和市,景本里,675,308,36.57957245,534,63.42042755,842,38,880,0,1075,81.86046512
臺北縣,中和市,福南里,682,356,27.63975155,932,72.36024845,1288,40,1328,0,1633,81.32271892
臺北縣,中和市,福南里,683,359,29.37806874,863,70.62193126,1222,50,1272,0,1570,81.01910828
臺北縣,中和市,中興里,686,380,32.59005146,786,67.40994854,1166,26,1192,0,1422,83.82559775
臺北縣,中和市,中興里,687,384,37.64705882,636,62.35294118,1020,18,1038,0,1302,79.7235023
臺北縣,中和市,中興里,688,400,42.87245445,533,57.12754555,933,24,957,0,1152,83.07291667
臺北縣,中和市,吉興里,689,300,34.32494279,574,65.67505721,874,20,894,0,1059,84.41926346
臺北縣,中和市,吉興里,690,300,37.64115433,497,62.35884567,797,16,813,0,979,83.04392237
臺北縣,中和市,中山里,604,387,46.62650602,443,53.37349398,830,24,854,0,1008,84.72222222
臺北縣,中和市,中山里,605,382,43.16384181,503,56.83615819,885,26,911,0,1103,82.59292838
臺北縣,中和市,碧河里,608,455,42.0906568,626,57.9093432,1081,24,1105,0,1347,82.03414996
臺北縣,中和市,碧河里,609,603,54.08071749,512,45.91928251,1115,27,1142,0,1343,85.03350707
臺北縣,中和市,錦中里,711,611,43.64285714,789,56.35714286,1400,36,1436,0,1742,82.43398393
臺北縣,中和市,錦中里,712,512,46.92942255,579,53.07057745,1091,26,1117,0,1338,83.48281016
臺北縣,中和市,錦盛里,714,687,46.38757596,794,53.61242404,1481,42,1523,0,1848,82.41341991
臺北縣,中和市,錦盛里,715,450,41.24656279,641,58.75343721,1091,28,1119,0,1340,83.50746269
臺北縣,中和市,民有里,722,452,40.72072072,658,59.27927928,1110,30,1140,0,1394,81.77905308
臺北縣,中和市,民有里,723,505,50.44955045,496,49.55044955,1001,30,1031,0,1222,84.36988543
臺北縣,中和市,員富里,727,260,45.77464789,308,54.22535211,568,16,584,0,996,58.63453815
臺北縣,中和市,員富里,728,642,57.94223827,466,42.05776173,1108,37,1145,0,1462,78.31737346
臺北縣,中和市,嘉慶里,731,563,44.82484076,693,55.17515924,1256,27,1283,0,1595,80.43887147
臺北縣,中和市,嘉慶里,732,649,46.22507123,755,53.77492877,1404,43,1447,0,1779,81.33783024
臺北縣,中和市,冠穗里,745,622,48.32944833,665,51.67055167,1287,35,1322,0,1636,80.80684597
臺北縣,中和市,冠穗里,746,492,43.81121995,631,56.18878005,1123,16,1139,0,1339,85.06348021
臺北縣,中和市,國華里,761,464,53.6416185,401,46.3583815,865,37,902,0,1096,82.29927007
臺北縣,中和市,國華里,762,584,48.50498339,620,51.49501661,1204,34,1238,0,1528,81.02094241
臺北縣,中和市,正南里,651,260,29.11534155,633,70.88465845,893,39,932,0,1168,79.79452055
臺北縣,中和市,正南里,652,252,33.96226415,490,66.03773585,742,23,765,0,930,82.25806452
臺北縣,中和市,正南里,653,249,28.13559322,636,71.86440678,885,20,905,0,1124,80.51601423
臺北縣,中和市,正行里,557,297,41.71348315,415,58.28651685,712,20,732,0,939,77.95527157
臺北縣,中和市,正行里,558,347,33.17399618,699,66.82600382,1046,14,1060,0,1294,81.91653787
臺北縣,永和市,福林里,777,452,36.62884927,782,63.37115073,1234,20,1254,0,1536,81.640625
臺北縣,永和市,福林里,778,435,34.93975904,810,65.06024096,1245,16,1261,0,1525,82.68852459
臺北縣,永和市,文化里,879,264,30.55555556,600,69.44444444,864,23,887,0,1061,83.600377
臺北縣,永和市,文化里,880,339,31.89087488,724,68.10912512,1063,38,1101,0,1353,81.37472284
臺北縣,永和市,豫溪里,786,429,33,871,67,1300,28,1328,0,1640,80.97560976
臺北縣,永和市,豫溪里,787,372,30.21933387,859,69.78066613,1231,16,1247,0,2112,59.04356061
臺北縣,永和市,光明里,788,328,30.76923077,738,69.23076923,1066,28,1094,0,1303,83.9600921
臺北縣,永和市,光明里,789,373,34.12625801,720,65.87374199,1093,17,1110,0,1418,78.27926657
臺北縣,永和市,仁愛里,881,296,36.49815043,515,63.50184957,811,13,824,0,1018,80.94302554
臺北縣,永和市,仁愛里,882,366,37.84901758,601,62.15098242,967,21,988,0,1214,81.38385502
臺北縣,永和市,永貞里,796,435,33.35889571,869,66.64110429,1304,20,1324,0,1620,81.72839506
臺北縣,永和市,永貞里,797,454,37.48967795,757,62.51032205,1211,27,1238,0,1471,84.16043508
臺北縣,永和市,永福里,798,349,32.70852858,718,67.29147142,1067,21,1088,0,1317,82.61199696
臺北縣,永和市,永福里,799,333,32.36151603,696,67.63848397,1029,15,1044,0,1261,82.79143537
臺北縣,永和市,民治里,833,312,30.43902439,713,69.56097561,1025,30,1055,0,1290,81.78294574
臺北縣,永和市,民治里,834,325,30.83491461,729,69.16508539,1054,30,1084,0,1326,81.74962293
臺北縣,永和市,永成里,877,77,10.78431373,637,89.21568627,714,34,748,0,956,78.24267782
臺北縣,永和市,忠義里,878,87,14.92281304,496,85.07718696,583,18,601,0,714,84.17366947
臺北縣,永和市,永元里,805,375,34.21532847,721,65.78467153,1096,23,1119,0,1342,83.38301043
臺北縣,永和市,永元里,806,352,34.95531281,655,65.04468719,1007,22,1029,0,1231,83.59057677
臺北縣,永和市,永元里,807,452,37.8559464,742,62.1440536,1194,27,1221,0,1476,82.72357724
臺北縣,永和市,秀林里,818,548,40.41297935,808,59.58702065,1356,30,1386,0,1648,84.10194175
臺北縣,永和市,秀林里,819,429,41.40926641,607,58.59073359,1036,31,1067,0,1285,83.03501946
臺北縣,永和市,保安里,867,643,44.40607735,805,55.59392265,1448,34,1482,1,1800,82.33333333
臺北縣,永和市,保安里,868,345,31.05310531,766,68.94689469,1111,14,1125,0,1314,85.61643836
臺北縣,永和市,保安里,869,621,32.66701736,1280,67.33298264,1901,29,1930,0,2241,86.12226685
臺北縣,永和市,中溪里,864,425,36.23188406,748,63.76811594,1173,16,1189,0,1429,83.20503849
臺北縣,永和市,中溪里,865,375,37.20238095,633,62.79761905,1008,25,1033,0,1249,82.70616493
臺北縣,永和市,中溪里,866,564,45.66801619,671,54.33198381,1235,38,1273,0,1500,84.86666667
臺北縣,永和市,永安里,847,471,36.25866051,828,63.74133949,1299,28,1327,0,1627,81.5611555
臺北縣,永和市,永安里,848,519,32.11633663,1097,67.88366337,1616,15,1631,0,1938,84.15892673
臺北縣,永和市,民族里,811,297,31.495228,646,68.504772,943,19,962,0,1174,81.94207836
臺北縣,永和市,民族里,812,380,32.34042553,795,67.65957447,1175,18,1193,0,1420,84.01408451
臺北縣,永和市,民族里,813,280,29.56705385,667,70.43294615,947,17,964,0,1181,81.6257409
臺北縣,永和市,民權里,808,358,33.42670401,713,66.57329599,1071,25,1096,0,1327,82.59231349
臺北縣,永和市,民權里,809,353,30.35253654,810,69.64746346,1163,18,1181,0,1374,85.95342067
臺北縣,永和市,民權里,810,329,36.43410853,574,63.56589147,903,23,926,0,1120,82.67857143
臺北縣,永和市,中興里,780,327,36.78290214,562,63.21709786,889,19,908,0,1123,80.85485307
臺北縣,永和市,中興里,781,373,31.45025295,813,68.54974705,1186,28,1214,0,1521,79.81591059
臺北縣,永和市,勵行里,779,363,42.11136891,499,57.88863109,862,16,878,0,1081,81.22109158
臺北縣,永和市,秀朗里,814,456,34.25995492,875,65.74004508,1331,43,1374,0,1707,80.49209139
臺北縣,永和市,秀朗里,815,571,42.93233083,759,57.06766917,1330,32,1362,0,1654,82.3458283
臺北縣,永和市,秀成里,816,319,39.18918919,495,60.81081081,814,16,830,0,1043,79.57813998
臺北縣,永和市,秀成里,817,459,37.40831296,768,62.59168704,1227,22,1249,0,1476,84.62059621
臺北縣,永和市,上溪里,886,182,33.09090909,368,66.90909091,550,16,566,1,708,79.94350282
臺北縣,永和市,上溪里,887,307,36.98795181,523,63.01204819,830,21,851,0,1053,80.81671415
臺北縣,永和市,竹林里,771,474,34.98154982,881,65.01845018,1355,37,1392,0,1687,82.51333729
臺北縣,永和市,竹林里,772,409,30.86792453,916,69.13207547,1325,35,1360,0,1709,79.57870099
臺北縣,永和市,雙和里,855,437,29.48717949,1045,70.51282051,1482,41,1523,0,1836,82.95206972
臺北縣,永和市,雙和里,856,454,38.18334735,735,61.81665265,1189,29,1218,1,1439,84.64211258
臺北縣,永和市,安和里,857,438,34.2455043,841,65.7544957,1279,20,1299,0,1592,81.59547739
臺北縣,永和市,安和里,858,338,27.04,912,72.96,1250,24,1274,1,1532,83.15926893
臺北縣,永和市,水源里,851,391,27.17164698,1048,72.82835302,1439,23,1462,0,1803,81.08707709
臺北縣,永和市,水源里,852,512,37.45427944,855,62.54572056,1367,21,1388,0,1676,82.81622912
臺北縣,永和市,協和里,853,398,38.0861244,647,61.9138756,1045,23,1068,0,1289,82.8549263
臺北縣,永和市,協和里,854,396,36.03275705,703,63.96724295,1099,20,1119,0,1359,82.33995585
臺北縣,永和市,河堤里,890,275,34.81012658,515,65.18987342,790,16,806,0,968,83.26446281
臺北縣,永和市,河堤里,891,289,35.8560794,517,64.1439206,806,17,823,0,1035,79.51690821
臺北縣,永和市,頂溪里,888,355,36.59793814,615,63.40206186,970,11,981,0,1213,80.87386645
臺北縣,永和市,頂溪里,889,318,37.19298246,537,62.80701754,855,7,862,0,1028,83.85214008
臺北縣,永和市,潭墘里,840,204,27.7173913,532,72.2826087,736,15,751,0,925,81.18918919
臺北縣,永和市,潭墘里,841,323,31.88548865,690,68.11451135,1013,14,1027,0,1254,81.89792663
臺北縣,永和市,潭墘里,842,317,27.88038698,820,72.11961302,1137,34,1171,0,1443,81.15038115
臺北縣,永和市,潭安里,837,485,34.0829234,938,65.9170766,1423,24,1447,0,1742,83.06544202
臺北縣,永和市,潭安里,838,278,29.66915688,659,70.33084312,937,14,951,0,1169,81.35158255
臺北縣,永和市,潭安里,839,269,31.06235566,597,68.93764434,866,11,877,0,1095,80.0913242
臺北縣,永和市,大新里,845,305,34.07821229,590,65.92178771,895,9,904,0,1076,84.01486989
臺北縣,永和市,大新里,846,266,30.3652968,610,69.6347032,876,29,905,0,1098,82.42258652
臺北縣,永和市,保平里,862,665,37.67705382,1100,62.32294618,1765,29,1794,0,2160,83.05555556
臺北縣,永和市,保平里,863,592,42.96081277,786,57.03918723,1378,42,1420,0,1706,83.23563892
臺北縣,永和市,民本里,827,366,37.77089783,603,62.22910217,969,22,991,0,1206,82.17247098
臺北縣,永和市,民本里,828,361,33.80149813,707,66.19850187,1068,30,1098,0,1334,82.30884558
臺北縣,永和市,民樂里,831,364,28.88888889,896,71.11111111,1260,22,1282,0,1564,81.96930946
臺北縣,永和市,民樂里,832,561,31.34078212,1229,68.65921788,1790,43,1833,0,2191,83.66042903
臺北縣,永和市,光復里,767,392,33.33333333,784,66.66666667,1176,25,1201,0,1484,80.92991914
臺北縣,永和市,復興里,769,231,32.21757322,486,67.78242678,717,24,741,0,928,79.84913793
臺北縣,永和市,復興里,770,296,29.45273632,709,70.54726368,1005,20,1025,0,1266,80.96366509
臺北縣,永和市,福和里,790,290,28.97102897,711,71.02897103,1001,13,1014,1,1273,79.65435978
臺北縣,永和市,福和里,791,448,33.30855019,897,66.69144981,1345,17,1362,0,1661,81.99879591
臺北縣,永和市,福和里,792,269,29.33478735,648,70.66521265,917,9,926,0,1144,80.94405594
臺北縣,永和市,得和里,793,360,32.14285714,760,67.85714286,1120,21,1141,0,1373,83.10269483
臺北縣,永和市,得和里,794,289,28.03103783,742,71.96896217,1031,11,1042,0,1232,84.57792208
臺北縣,永和市,得和里,795,307,32.7991453,629,67.2008547,936,22,958,0,1128,84.92907801
臺北縣,永和市,智光里,835,327,28.65907099,814,71.34092901,1141,38,1179,0,1459,80.80877313
臺北縣,永和市,智光里,836,393,32.47933884,817,67.52066116,1210,15,1225,0,1493,82.04956463
臺北縣,永和市,新生里,876,156,26.39593909,435,73.60406091,591,32,623,0,789,78.96070976
臺北縣,永和市,大同里,875,163,22.54495159,560,77.45504841,723,39,762,0,903,84.38538206
臺北縣,永和市,前溪里,859,465,33.40517241,927,66.59482759,1392,12,1404,0,1761,79.7274276
臺北縣,永和市,和平里,860,577,38.72483221,913,61.27516779,1490,34,1524,1,1820,83.73626374
臺北縣,永和市,和平里,861,574,37.41851369,960,62.58148631,1534,34,1568,0,1894,82.78775079
臺北縣,永和市,新部里,892,246,33.28822733,493,66.71177267,739,22,761,0,947,80.35902851
臺北縣,永和市,新部里,893,314,32.67429761,647,67.32570239,961,17,978,0,1183,82.67117498
臺北縣,永和市,下溪里,873,504,41.27764128,717,58.72235872,1221,51,1272,0,1546,82.27684347
臺北縣,永和市,下溪里,874,554,39.34659091,854,60.65340909,1408,31,1439,0,1752,82.1347032
臺北縣,永和市,秀和里,802,628,39.323732,969,60.676268,1597,34,1631,0,1909,85.43740178
臺北縣,永和市,秀和里,803,259,35.23809524,476,64.76190476,735,11,746,0,900,82.88888889
臺北縣,永和市,秀和里,804,336,36.20689655,592,63.79310345,928,15,943,0,1141,82.64680105
臺北縣,永和市,河濱里,800,380,36.82170543,652,63.17829457,1032,28,1060,0,1283,82.61886204
臺北縣,永和市,河濱里,801,330,35.06907545,611,64.93092455,941,19,960,0,1192,80.53691275
臺北縣,永和市,民生里,824,314,35.64131669,567,64.35868331,881,15,896,1,1090,82.20183486
臺北縣,永和市,民生里,825,424,38.37104072,681,61.62895928,1105,22,1127,0,1323,85.18518519
臺北縣,永和市,民生里,826,325,37.18535469,549,62.81464531,874,19,893,0,1055,84.64454976
臺北縣,永和市,秀得里,820,312,33.62068966,616,66.37931034,928,14,942,0,1134,83.06878307
臺北縣,永和市,秀得里,821,385,40.65469905,562,59.34530095,947,19,966,0,1156,83.56401384
臺北縣,永和市,上林里,775,377,30.2811245,868,69.7188755,1245,29,1274,0,1592,80.02512563
臺北縣,永和市,上林里,776,341,27.02060222,921,72.97939778,1262,26,1288,0,1584,81.31313131
臺北縣,永和市,網溪里,768,265,31.66069295,572,68.33930705,837,23,860,0,1068,80.52434457
臺北縣,永和市,正興里,784,309,35.6812933,557,64.3187067,866,19,885,0,1086,81.49171271
臺北縣,永和市,正興里,785,229,30.45212766,523,69.54787234,752,14,766,1,953,80.37775446
臺北縣,永和市,永興里,782,373,31.47679325,812,68.52320675,1185,43,1228,0,1482,82.86099865
臺北縣,永和市,永興里,783,369,32.53968254,765,67.46031746,1134,37,1171,0,1454,80.53645117
臺北縣,永和市,桂林里,773,397,30.03025719,925,69.96974281,1322,28,1350,0,1656,81.52173913
臺北縣,永和市,桂林里,774,349,28.46655791,877,71.53344209,1226,33,1259,0,1548,81.33074935
臺北縣,永和市,店街里,843,443,35.21462639,815,64.78537361,1258,22,1280,0,1561,81.99871877
臺北縣,永和市,店街里,844,414,30.66666667,936,69.33333333,1350,24,1374,1,1717,80.02329645
臺北縣,永和市,信義里,883,343,37.60964912,569,62.39035088,912,8,920,0,1168,78.76712329
臺北縣,永和市,信義里,884,332,40.29126214,492,59.70873786,824,15,839,0,1031,81.37730359
臺北縣,永和市,後溪里,885,520,42.3797881,707,57.6202119,1227,32,1259,0,1585,79.43217666
臺北縣,永和市,民富里,829,449,39.42054434,690,60.57945566,1139,16,1155,0,1361,84.86407054
臺北縣,永和市,民富里,830,327,32.86432161,668,67.13567839,995,17,1012,0,1181,85.69009314
臺北縣,永和市,秀元里,822,436,37.84722222,716,62.15277778,1152,20,1172,0,1401,83.65453248
臺北縣,永和市,秀元里,823,389,35.2674524,714,64.7325476,1103,11,1114,0,1342,83.01043219
臺北縣,永和市,永樂里,849,291,34.76702509,546,65.23297491,837,20,857,0,1057,81.07852412
臺北縣,永和市,永樂里,850,326,38.2629108,526,61.7370892,852,21,873,0,1071,81.51260504
臺北縣,永和市,保順里,870,557,42.94525829,740,57.05474171,1297,27,1324,0,1587,83.42785129
臺北縣,永和市,保順里,871,429,31.08695652,951,68.91304348,1380,14,1394,0,1656,84.17874396
臺北縣,永和市,保順里,872,445,28.95250488,1092,71.04749512,1537,21,1558,0,1887,82.56491786
臺北縣,新莊市,海山里,894,481,49.08163265,499,50.91836735,980,23,1003,0,1215,82.55144033
臺北縣,新莊市,海山里,895,666,56.34517766,516,43.65482234,1182,30,1212,0,1517,79.89452868
臺北縣,新莊市,海山里,896,736,50.96952909,708,49.03047091,1444,42,1486,0,1754,84.72063854
臺北縣,新莊市,頭前里,918,805,63.88888889,455,36.11111111,1260,20,1280,0,1545,82.84789644
臺北縣,新莊市,頭前里,919,856,63.64312268,489,36.35687732,1345,21,1366,0,1708,79.9765808
臺北縣,新莊市,國泰里,1010,589,51.30662021,559,48.69337979,1148,36,1184,0,1421,83.3216045
臺北縣,新莊市,全安里,897,527,54.27394439,444,45.72605561,971,29,1000,0,1163,85.98452279
臺北縣,新莊市,全安里,898,565,51.73992674,527,48.26007326,1092,19,1111,0,1345,82.60223048
臺北縣,新莊市,全安里,899,396,53.08310992,350,46.91689008,746,18,764,0,905,84.4198895
臺北縣,新莊市,福基里,920,519,55.68669528,413,44.31330472,932,24,956,0,1164,82.13058419
臺北縣,新莊市,福基里,921,376,50.74224022,365,49.25775978,741,18,759,0,900,84.33333333
臺北縣,新莊市,豐年里,1008,670,51.89775368,621,48.10224632,1291,23,1314,0,1604,81.9201995
臺北縣,新莊市,豐年里,1009,670,56.82782019,509,43.17217981,1179,17,1196,0,1450,82.48275862
臺北縣,新莊市,忠孝里,903,453,49.18566775,468,50.81433225,921,23,944,0,1155,81.73160173
臺北縣,新莊市,忠孝里,904,544,53.80811078,467,46.19188922,1011,24,1035,0,1241,83.40048348
臺北縣,新莊市,忠孝里,905,590,53.20108206,519,46.79891794,1109,27,1136,0,1361,83.46803821
臺北縣,新莊市,恆安里,961,528,50,528,50,1056,26,1082,0,1279,84.59734167
臺北縣,新莊市,恆安里,962,500,48.73294347,526,51.26705653,1026,22,1048,0,1287,81.42968143
臺北縣,新莊市,恆安里,963,453,48.2428115,486,51.7571885,939,18,957,0,1157,82.7139153
臺北縣,新莊市,後港里,1050,542,54.74747475,448,45.25252525,990,26,1016,1,1259,80.69896743
臺北縣,新莊市,後港里,1051,544,53.4906588,473,46.5093412,1017,23,1040,0,1265,82.21343874
臺北縣,新莊市,後港里,1052,509,49.27395934,524,50.72604066,1033,19,1052,0,1283,81.99532346
臺北縣,新莊市,後港里,1053,471,47.62386249,518,52.37613751,989,15,1004,0,1181,85.0127011
臺北縣,新莊市,文衡里,906,762,52.08475735,701,47.91524265,1463,43,1506,0,1757,85.71428571
臺北縣,新莊市,中美里,958,678,52.4361949,615,47.5638051,1293,33,1326,0,1587,83.55387524
臺北縣,新莊市,中美里,959,616,49.04458599,640,50.95541401,1256,30,1286,0,1547,83.12863607
臺北縣,新莊市,中美里,960,709,57.08534622,533,42.91465378,1242,33,1275,0,1577,80.84971465
臺北縣,新莊市,八德里,1067,540,51.67464115,505,48.32535885,1045,22,1067,0,1322,80.71104387
臺北縣,新莊市,八德里,1068,482,50.15608741,479,49.84391259,961,16,977,0,1201,81.34887594
臺北縣,新莊市,興漢里,909,322,57.60286225,237,42.39713775,559,9,568,0,691,82.19971056
臺北縣,新莊市,興漢里,910,402,40.85365854,582,59.14634146,984,29,1013,0,1196,84.69899666
臺北縣,新莊市,興漢里,911,499,47.70554493,547,52.29445507,1046,17,1063,0,1272,83.56918239
臺北縣,新莊市,中和里,967,476,51.68295331,445,48.31704669,921,23,944,0,1171,80.61485909
臺北縣,新莊市,中和里,968,647,57.97491039,469,42.02508961,1116,15,1131,0,1348,83.90207715
臺北縣,新莊市,中和里,969,572,56.74603175,436,43.25396825,1008,24,1032,0,1242,83.09178744
臺北縣,新莊市,西盛里,1087,604,58.984375,420,41.015625,1024,29,1053,0,1255,83.90438247
臺北縣,新莊市,西盛里,1088,701,53.84024578,601,46.15975422,1302,39,1341,0,1697,79.02180318
臺北縣,新莊市,西盛里,1089,600,55.81395349,475,44.18604651,1075,24,1099,1,1332,82.50750751
臺北縣,新莊市,榮和里,912,431,48.59075536,456,51.40924464,887,15,902,0,1120,80.53571429
臺北縣,新莊市,榮和里,913,553,44.99593165,676,55.00406835,1229,30,1259,0,2250,55.95555556
臺北縣,新莊市,中泰里,970,629,59.17215428,434,40.82784572,1063,25,1088,0,1299,83.75673595
臺北縣,新莊市,中泰里,971,618,59.25215724,425,40.74784276,1043,25,1068,0,1276,83.69905956
臺北縣,新莊市,中泰里,972,575,53.78858746,494,46.21141254,1069,19,1088,0,1307,83.24407039
臺北縣,新莊市,瓊林里,1013,787,58.8631264,550,41.1368736,1337,34,1371,0,1686,81.31672598
臺北縣,新莊市,瓊林里,1014,621,54.42594216,520,45.57405784,1141,40,1181,0,1469,80.39482641
臺北縣,新莊市,瓊林里,1015,659,57.9086116,479,42.0913884,1138,29,1167,0,1467,79.55010225
臺北縣,新莊市,文德里,914,573,49.01625321,596,50.98374679,1169,31,1200,0,1449,82.81573499
臺北縣,新莊市,中誠里,984,828,59.91316932,554,40.08683068,1382,34,1416,0,1769,80.04522329
臺北縣,新莊市,裕民里,1034,539,53.57852883,467,46.42147117,1006,29,1035,0,1274,81.24018838
臺北縣,新莊市,裕民里,1035,631,57.31153497,470,42.68846503,1101,31,1132,0,1381,81.96958726
臺北縣,新莊市,裕民里,1036,564,53.05738476,499,46.94261524,1063,27,1090,0,1348,80.86053412
臺北縣,新莊市,裕民里,1037,430,50.88757396,415,49.11242604,845,12,857,0,1064,80.54511278
臺北縣,新莊市,文明里,915,651,51.13904163,622,48.86095837,1273,36,1309,0,1588,82.43073048
臺北縣,新莊市,中港里,985,691,54.97215593,566,45.02784407,1257,21,1278,0,1546,82.66494179
臺北縣,新莊市,中港里,986,671,53.29626688,588,46.70373312,1259,19,1278,0,1544,82.77202073
臺北縣,新莊市,中港里,987,588,45.44049459,706,54.55950541,1294,20,1314,0,1560,84.23076923
臺北縣,新莊市,富國里,1040,475,59.82367758,319,40.17632242,794,11,805,0,998,80.66132265
臺北縣,新莊市,富國里,1041,467,54.17633411,395,45.82366589,862,21,883,0,1065,82.91079812
臺北縣,新莊市,思源里,952,656,56.30901288,509,43.69098712,1165,21,1186,0,1462,81.12175103
臺北縣,新莊市,思源里,953,715,57.2,535,42.8,1250,13,1263,0,1538,82.11963589
臺北縣,新莊市,思源里,954,627,58.59813084,443,41.40186916,1070,21,1091,0,1331,81.96844478
臺北縣,新莊市,立人里,964,538,37.41307371,900,62.58692629,1438,36,1474,0,1729,85.25159051
臺北縣,新莊市,南港里,1057,519,51.53922542,488,48.46077458,1007,25,1032,0,1278,80.75117371
臺北縣,新莊市,南港里,1058,718,51.91612437,665,48.08387563,1383,23,1406,0,1760,79.88636364
臺北縣,新莊市,南港里,1059,346,50.29069767,342,49.70930233,688,7,695,0,834,83.33333333
臺北縣,新莊市,仁愛里,943,516,55.48387097,414,44.51612903,930,34,964,0,1204,80.06644518
臺北縣,新莊市,仁愛里,944,560,56.85279188,425,43.14720812,985,13,998,0,1161,85.96037898
臺北縣,新莊市,立德里,965,419,45.54347826,501,54.45652174,920,14,934,0,1105,84.52488688
臺北縣,新莊市,立德里,966,477,52.13114754,438,47.86885246,915,21,936,0,1124,83.27402135
臺北縣,新莊市,信義里,934,591,53.14748201,521,46.85251799,1112,30,1142,0,1418,80.53596615
臺北縣,新莊市,信義里,935,586,53.46715328,510,46.53284672,1096,26,1122,0,1369,81.95763331
臺北縣,新莊市,信義里,936,653,54.10107705,554,45.89892295,1207,34,1241,0,1552,79.96134021
臺北縣,新莊市,立言里,1005,565,53.50378788,491,46.49621212,1056,18,1074,0,1310,81.98473282
臺北縣,新莊市,立言里,1006,480,47.80876494,524,52.19123506,1004,8,1012,0,1202,84.19301165
臺北縣,新莊市,立言里,1007,573,49.31153184,589,50.68846816,1162,17,1179,0,1451,81.25430737
臺北縣,新莊市,民安里,1069,605,56.33147114,469,43.66852886,1074,27,1101,0,1364,80.71847507
臺北縣,新莊市,民安里,1070,428,45.29100529,517,54.70899471,945,28,973,0,1223,79.5584628
臺北縣,新莊市,民安里,1071,475,50.21141649,471,49.78858351,946,23,969,0,1158,83.67875648
臺北縣,新莊市,和平里,926,588,55.73459716,467,44.26540284,1055,11,1066,0,1304,81.74846626
臺北縣,新莊市,和平里,927,617,59.3840231,422,40.6159769,1039,18,1057,0,1281,82.5136612
臺北縣,新莊市,和平里,928,609,53.65638767,526,46.34361233,1135,20,1155,0,1336,86.45209581
臺北縣,新莊市,立功里,1000,663,53.68421053,572,46.31578947,1235,41,1276,0,1560,81.79487179
臺北縣,新莊市,立功里,1001,704,55.30243519,569,44.69756481,1273,25,1298,0,1582,82.04804046
臺北縣,新莊市,民本里,1065,594,59.75855131,400,40.24144869,994,23,1017,0,1252,81.23003195
臺北縣,新莊市,民本里,1066,533,55.87002096,421,44.12997904,954,26,980,0,1236,79.28802589
臺北縣,新莊市,化成里,916,611,62.8600823,361,37.1399177,972,20,992,1,1194,83.08207705
臺北縣,新莊市,化成里,917,453,56.20347395,353,43.79652605,806,31,837,0,1006,83.20079523
臺北縣,新莊市,立志里,977,690,58.57385399,488,41.42614601,1178,33,1211,0,1478,81.93504736
臺北縣,新莊市,立志里,978,745,55.51415797,597,44.48584203,1342,20,1362,0,1625,83.81538462
臺北縣,新莊市,光華里,1076,552,48.76325088,580,51.23674912,1132,25,1157,0,1470,78.70748299
臺北縣,新莊市,光華里,1077,554,51.48698885,522,48.51301115,1076,26,1102,0,1446,76.21023513
臺北縣,新莊市,光華里,1078,623,52.88624788,555,47.11375212,1178,39,1217,0,1560,78.01282051
臺北縣,新莊市,思賢里,955,767,54.35861091,644,45.64138909,1411,34,1445,0,1758,82.19567691
臺北縣,新莊市,思賢里,956,637,54.58440446,530,45.41559554,1167,42,1209,0,1443,83.78378378
臺北縣,新莊市,營盤里,1018,400,53.33333333,350,46.66666667,750,27,777,0,939,82.74760383
臺北縣,新莊市,營盤里,1019,448,53.97590361,382,46.02409639,830,15,845,0,1009,83.74628345
臺北縣,新莊市,光榮里,1079,556,47.23874257,621,52.76125743,1177,26,1203,0,1463,82.22829802
臺北縣,新莊市,光榮里,1080,625,54.01901469,532,45.98098531,1157,19,1176,1,1444,81.44044321
臺北縣,新莊市,自強里,950,578,57.74225774,423,42.25774226,1001,21,1022,0,1281,79.78142077
臺北縣,新莊市,自強里,951,502,56.08938547,393,43.91061453,895,29,924,0,1158,79.79274611
臺北縣,新莊市,丹鳳里,1020,583,47.32142857,649,52.67857143,1232,45,1277,0,1585,80.56782334
臺北縣,新莊市,丹鳳里,1021,790,53.30634278,692,46.69365722,1482,32,1514,0,1883,80.40361126
臺北縣,新莊市,丹鳳里,1022,663,45.31784005,800,54.68215995,1463,42,1505,0,1939,77.61732852
臺北縣,新莊市,光明里,1074,667,55.62969141,532,44.37030859,1199,30,1229,0,1526,80.53735256
臺北縣,新莊市,光明里,1075,607,53.33919156,531,46.66080844,1138,27,1165,0,1460,79.79452055
臺北縣,新莊市,自立里,947,653,56.00343053,513,43.99656947,1166,13,1179,0,1425,82.73684211
臺北縣,新莊市,自立里,948,560,57.02647658,422,42.97352342,982,24,1006,0,1260,79.84126984
臺北縣,新莊市,自立里,949,547,52.04567079,504,47.95432921,1051,31,1082,0,1331,81.29226146
臺北縣,新莊市,合鳳里,1023,451,52.44186047,409,47.55813953,860,24,884,0,1131,78.16091954
臺北縣,新莊市,合鳳里,1024,475,50.63965885,463,49.36034115,938,8,946,0,1217,77.73212818
臺北縣,新莊市,合鳳里,1025,549,52.83926853,490,47.16073147,1039,24,1063,0,1301,81.70637971
臺北縣,新莊市,幸福里,929,516,55.90465872,407,44.09534128,923,25,948,0,1159,81.79465056
臺北縣,新莊市,幸福里,930,530,55.03634476,433,44.96365524,963,28,991,0,1225,80.89795918
臺北縣,新莊市,幸福里,931,625,61.45526057,392,38.54473943,1017,36,1053,0,1300,81
臺北縣,新莊市,雙鳳里,1027,734,55.85996956,580,44.14003044,1314,25,1339,0,1688,79.32464455
臺北縣,新莊市,雙鳳里,1028,819,49.63636364,831,50.36363636,1650,34,1684,0,2120,79.43396226
臺北縣,新莊市,雙鳳里,1029,206,48.81516588,216,51.18483412,422,3,425,0,516,82.36434109
臺北縣,新莊市,自信里,945,325,57.62411348,239,42.37588652,564,20,584,0,747,78.1793842
臺北縣,新莊市,自信里,946,601,57.95564127,436,42.04435873,1037,27,1064,0,1285,82.80155642
臺北縣,新莊市,龍鳳里,1031,660,55.55555556,528,44.44444444,1188,28,1216,0,1498,81.17489987
臺北縣,新莊市,龍鳳里,1032,564,53.35856197,493,46.64143803,1057,22,1079,0,1321,81.68054504
臺北縣,新莊市,龍鳳里,1033,597,48.65525672,630,51.34474328,1227,21,1248,0,1511,82.59430841
臺北縣,新莊市,中華里,957,733,58.03642122,530,41.96357878,1263,19,1282,0,1590,80.62893082
臺北縣,新莊市,中隆里,998,594,49.87405542,597,50.12594458,1191,10,1201,0,1443,83.22938323
臺北縣,新莊市,中隆里,999,552,56.67351129,422,43.32648871,974,21,995,0,1295,76.83397683
臺北縣,新莊市,中原里,995,834,52.38693467,758,47.61306533,1592,35,1627,0,1990,81.75879397
臺北縣,新莊市,中原里,996,768,51.13182423,734,48.86817577,1502,15,1517,0,1843,82.31144872
臺北縣,新莊市,中原里,997,850,53.35844319,743,46.64155681,1593,24,1617,0,1918,84.30656934
臺北縣,新莊市,中信里,988,609,58.95450145,424,41.04549855,1033,22,1055,0,1301,81.0914681
臺北縣,新莊市,中信里,989,677,55.62859491,540,44.37140509,1217,22,1239,0,1495,82.87625418
臺北縣,新莊市,中信里,990,720,53.2938564,631,46.7061436,1351,24,1375,0,1686,81.5539739
臺北縣,新莊市,中信里,991,508,49.56097561,517,50.43902439,1025,21,1046,0,1251,83.61310951
臺北縣,新莊市,四維里,1054,495,52.77185501,443,47.22814499,938,12,950,0,1218,77.99671593
臺北縣,新莊市,四維里,1055,603,59.58498024,409,40.41501976,1012,22,1034,0,1326,77.97888386
臺北縣,新莊市,四維里,1056,590,57.89990186,429,42.10009814,1019,19,1038,0,1300,79.84615385
臺北縣,新莊市,建福里,1048,383,51.06666667,367,48.93333333,750,17,767,0,932,82.29613734
臺北縣,新莊市,建福里,1049,442,52.55648038,399,47.44351962,841,17,858,0,1052,81.55893536
臺北縣,新莊市,中宏里,973,554,55.28942116,448,44.71057884,1002,17,1019,0,1272,80.11006289
臺北縣,新莊市,中宏里,974,632,52.79866332,565,47.20133668,1197,19,1216,0,1448,83.97790055
臺北縣,新莊市,中全里,975,673,56.84121622,511,43.15878378,1184,25,1209,0,1455,83.09278351
臺北縣,新莊市,中全里,976,706,62.64418811,421,37.35581189,1127,14,1141,0,1412,80.80736544
臺北縣,新莊市,立泰里,1002,559,51.05022831,536,48.94977169,1095,28,1123,0,1342,83.68107303
臺北縣,新莊市,立泰里,1003,450,48.54368932,477,51.45631068,927,19,946,0,1150,82.26086957
臺北縣,新莊市,立泰里,1004,545,53.48380765,474,46.51619235,1019,30,1049,0,1288,81.44409938
臺北縣,新莊市,全泰里,900,517,42.41181296,702,57.58818704,1219,26,1245,0,1486,83.78196501
臺北縣,新莊市,全泰里,901,581,46.1477363,678,53.8522637,1259,19,1278,0,1521,84.02366864
臺北縣,新莊市,全泰里,902,510,48.24976348,547,51.75023652,1057,10,1067,0,1262,84.54833597
臺北縣,新莊市,仁義里,941,674,60.72072072,436,39.27927928,1110,24,1134,0,1421,79.80295567
臺北縣,新莊市,仁義里,942,650,57.52212389,480,42.47787611,1130,32,1162,0,1454,79.91746905
臺北縣,新莊市,立基里,981,734,50.13661202,730,49.86338798,1464,27,1491,0,1789,83.34264952
臺北縣,新莊市,立基里,982,550,49.77375566,555,50.22624434,1105,15,1120,0,1375,81.45454545
臺北縣,新莊市,立基里,983,547,47.40034662,607,52.59965338,1154,17,1171,0,1423,82.29093465
臺北縣,新莊市,昌明里,939,644,59.5194085,438,40.4805915,1082,27,1109,0,1345,82.4535316
臺北縣,新莊市,昌明里,940,568,50.04405286,567,49.95594714,1135,6,1141,0,1332,85.66066066
臺北縣,新莊市,昌平里,924,560,47.05882353,630,52.94117647,1190,22,1212,0,1494,81.12449799
臺北縣,新莊市,昌平里,925,468,44.19263456,591,55.80736544,1059,17,1076,0,1325,81.20754717
臺北縣,新莊市,文聖里,907,610,46.17713853,711,53.82286147,1321,32,1353,0,1607,84.19415059
臺北縣,新莊市,文聖里,908,532,45.70446735,632,54.29553265,1164,27,1191,0,1438,82.82336579
臺北縣,新莊市,萬安里,1046,552,52.12464589,507,47.87535411,1059,26,1085,0,1345,80.66914498
臺北縣,新莊市,萬安里,1047,562,54.40464666,471,45.59535334,1033,27,1060,0,1307,81.10175976
臺北縣,新莊市,龍安里,1038,383,52.97372061,340,47.02627939,723,17,740,0,932,79.39914163
臺北縣,新莊市,龍安里,1039,403,50.375,397,49.625,800,21,821,0,1016,80.80708661
臺北縣,新莊市,福營里,1016,444,52.92014303,395,47.07985697,839,20,859,0,1054,81.49905123
臺北縣,新莊市,福營里,1017,463,57.875,337,42.125,800,23,823,0,962,85.55093555
臺北縣,新莊市,後德里,1044,451,51.95852535,417,48.04147465,868,11,879,0,1063,82.69049859
臺北縣,新莊市,後德里,1045,446,46.55532359,512,53.44467641,958,15,973,0,1181,82.38780694
臺北縣,新莊市,建安里,1060,594,49.13151365,615,50.86848635,1209,17,1226,0,1500,81.73333333
臺北縣,新莊市,建安里,1061,633,50.76182839,614,49.23817161,1247,16,1263,1,1524,82.87401575
臺北縣,新莊市,建安里,1062,588,50.08517888,586,49.91482112,1174,15,1189,0,1454,81.77441541
臺北縣,新莊市,成德里,1072,717,58.43520782,510,41.56479218,1227,34,1261,0,1584,79.60858586
臺北縣,新莊市,成德里,1073,806,49.35701164,827,50.64298836,1633,20,1653,0,2046,80.79178886
臺北縣,新莊市,福興里,922,700,52.19985086,641,47.80014914,1341,20,1361,0,1645,82.73556231
臺北縣,新莊市,福興里,923,626,52.29741019,571,47.70258981,1197,22,1219,0,1460,83.49315068
臺北縣,新莊市,昌信里,937,468,49.0052356,487,50.9947644,955,15,970,0,1188,81.64983165
臺北縣,新莊市,昌信里,938,451,47.62407603,496,52.37592397,947,8,955,0,1146,83.33333333
臺北縣,新莊市,昌隆里,932,599,49.95829858,600,50.04170142,1199,15,1214,0,1423,85.31271961
臺北縣,新莊市,昌隆里,933,521,49.52471483,531,50.47528517,1052,19,1071,0,1287,83.21678322
臺北縣,新莊市,中平里,992,652,44.26340801,821,55.73659199,1473,23,1496,0,1815,82.42424242
臺北縣,新莊市,中平里,993,616,42.13406293,846,57.86593707,1462,25,1487,0,1836,80.9912854
臺北縣,新莊市,中平里,994,741,46.92843572,838,53.07156428,1579,14,1593,0,1946,81.8602261
臺北縣,新莊市,立廷里,979,479,54.24688562,404,45.75311438,883,18,901,0,1073,83.97017707
臺北縣,新莊市,立廷里,980,583,54.84477893,480,45.15522107,1063,16,1079,0,1319,81.80439727
臺北縣,新莊市,泰豐里,1011,439,48.45474614,467,51.54525386,906,24,930,0,1149,80.93994778
臺北縣,新莊市,泰豐里,1012,320,44.26002766,403,55.73997234,723,13,736,0,884,83.25791855
臺北縣,新莊市,富民里,1042,590,53.78304467,507,46.21695533,1097,24,1121,0,1379,81.29079043
臺北縣,新莊市,富民里,1043,497,48.11229429,536,51.88770571,1033,33,1066,0,1313,81.18811881
臺北縣,新莊市,龍福里,1030,574,47.28171334,640,52.71828666,1214,27,1241,1,1552,79.96134021
臺北縣,新莊市,祥鳳里,1026,727,50.38115038,716,49.61884962,1443,35,1478,0,1784,82.84753363
臺北縣,新莊市,民全里,1063,497,52.70413574,446,47.29586426,943,10,953,0,1171,81.38343296
臺北縣,新莊市,民全里,1064,513,51.66163142,480,48.33836858,993,23,1016,0,1232,82.46753247
臺北縣,新莊市,民有里,1085,499,47.25378788,557,52.74621212,1056,21,1077,0,1336,80.61377246
臺北縣,新莊市,民有里,1086,618,53.50649351,537,46.49350649,1155,19,1174,0,1461,80.3559206
臺北縣,新莊市,光正里,1081,654,54.4093178,548,45.5906822,1202,25,1227,0,1477,83.07379824
臺北縣,新莊市,光正里,1082,556,54.9950544,455,45.0049456,1011,34,1045,0,1252,83.46645367
臺北縣,新莊市,光和里,1083,434,54.7979798,358,45.2020202,792,14,806,0,976,82.58196721
臺北縣,新莊市,光和里,1084,434,56,341,44,775,16,791,0,977,80.96212897
臺北縣,新店市,國豐里,1148,225,26.65876777,619,73.34123223,844,10,854,0,1042,81.95777351
臺北縣,新店市,國豐里,1149,174,23.2,576,76.8,750,22,772,0,953,81.00734523
臺北縣,新店市,國豐里,1150,202,24.84624846,611,75.15375154,813,16,829,0,1015,81.67487685
臺北縣,新店市,明德里,1151,342,34.47580645,650,65.52419355,992,20,1012,0,1228,82.41042345
臺北縣,新店市,明德里,1152,317,35.98183882,564,64.01816118,881,19,900,0,1082,83.1792976
臺北縣,新店市,明德里,1153,364,34.24270931,699,65.75729069,1063,21,1084,0,1308,82.87461774
臺北縣,新店市,大豐里,1154,433,33.12930375,874,66.87069625,1307,27,1334,0,1624,82.14285714
臺北縣,新店市,大豐里,1155,414,32.67561168,853,67.32438832,1267,15,1282,1,1542,83.1387808
臺北縣,新店市,大同里,1156,555,39.00210822,868,60.99789178,1423,11,1434,1,1709,83.90871855
臺北縣,新店市,大同里,1157,459,34.35628743,877,65.64371257,1336,30,1366,0,1609,84.89745183
臺北縣,新店市,江陵里,1158,325,32.63052209,671,67.36947791,996,20,1016,0,1224,83.00653595
臺北縣,新店市,江陵里,1159,282,27.75590551,734,72.24409449,1016,14,1030,0,1234,83.46839546
臺北縣,新店市,江陵里,1160,386,33.47788378,767,66.52211622,1153,17,1170,0,1400,83.57142857
臺北縣,新店市,寶興里,1163,260,27.68903088,679,72.31096912,939,20,959,0,1156,82.95847751
臺北縣,新店市,寶興里,1164,417,37.23214286,703,62.76785714,1120,22,1142,0,1392,82.04022989
臺北縣,新店市,寶興里,1165,362,36.16383616,639,63.83616384,1001,31,1032,1,1253,82.36233041
臺北縣,新店市,寶安里,1169,279,31.10367893,618,68.89632107,897,23,920,0,1168,78.76712329
臺北縣,新店市,寶安里,1170,378,27.31213873,1006,72.68786127,1384,24,1408,0,1702,82.72620447
臺北縣,新店市,寶安里,1171,436,30.87818697,976,69.12181303,1412,31,1443,0,1731,83.36221837
臺北縣,新店市,信義里,1172,319,29.89690722,748,70.10309278,1067,11,1078,0,1300,82.92307692
臺北縣,新店市,信義里,1173,356,37.23849372,600,62.76150628,956,28,984,0,1169,84.17450813
臺北縣,新店市,信義里,1174,466,35.81860108,835,64.18139892,1301,29,1330,0,1620,82.09876543
臺北縣,新店市,信義里,1175,472,40.68965517,688,59.31034483,1160,19,1179,0,1452,81.19834711
臺北縣,新店市,忠孝里,1176,349,24.71671388,1063,75.28328612,1412,34,1446,0,1731,83.5355286
臺北縣,新店市,忠孝里,1177,243,32.48663102,505,67.51336898,748,20,768,0,943,81.44220573
臺北縣,新店市,大鵬里,1178,121,8.5572843,1293,91.4427157,1414,16,1430,0,1657,86.30054315
臺北縣,新店市,太平里,1179,422,37.37821081,707,62.62178919,1129,35,1164,1,1440,80.83333333
臺北縣,新店市,太平里,1180,224,24.94432071,674,75.05567929,898,25,923,0,1128,81.82624113
臺北縣,新店市,頂城里,1183,414,40.19417476,616,59.80582524,1030,50,1080,0,1381,78.20419986
臺北縣,新店市,下城里,1184,621,43.70161858,800,56.29838142,1421,48,1469,0,1789,82.11291224
臺北縣,新店市,柴埕里,1185,331,31.05065666,735,68.94934334,1066,28,1094,0,1328,82.37951807
臺北縣,新店市,柴埕里,1186,402,34.21276596,773,65.78723404,1175,33,1208,0,1452,83.19559229
臺北縣,新店市,柴埕里,1187,610,46.14220877,712,53.85779123,1322,53,1375,0,1673,82.18768679
臺北縣,新店市,柴埕里,1188,497,38.79781421,784,61.20218579,1281,19,1300,0,1583,82.12255212
臺北縣,新店市,永安里,1192,440,37.57472246,731,62.42527754,1171,35,1206,0,1448,83.28729282
臺北縣,新店市,永安里,1193,448,40.69028156,653,59.30971844,1101,21,1122,0,1390,80.71942446
臺北縣,新店市,永安里,1194,419,41.32149901,595,58.67850099,1014,12,1026,0,1247,82.27746592
臺北縣,新店市,公崙里,1200,536,39.06705539,836,60.93294461,1372,29,1401,0,1755,79.82905983
臺北縣,新店市,公崙里,1201,579,43.08035714,765,56.91964286,1344,29,1373,0,1645,83.46504559
臺北縣,新店市,公崙里,1202,527,39.35772965,812,60.64227035,1339,27,1366,0,1727,79.09669948
臺北縣,新店市,公崙里,1203,355,27.99684543,913,72.00315457,1268,20,1288,0,1610,80
臺北縣,新店市,德安里,1206,472,40.30742955,699,59.69257045,1171,34,1205,0,1440,83.68055556
臺北縣,新店市,德安里,1207,485,37.56777692,806,62.43222308,1291,31,1322,0,1601,82.57339163
臺北縣,新店市,德安里,1208,146,49.15824916,151,50.84175084,297,17,314,0,366,85.79234973
臺北縣,新店市,德安里,1209,451,44.38976378,565,55.61023622,1016,30,1046,0,1321,79.18243755
臺北縣,新店市,雙城里,1216,367,46.27994956,426,53.72005044,793,21,814,0,1025,79.41463415
臺北縣,新店市,雙城里,1217,325,46.36233951,376,53.63766049,701,16,717,0,851,84.25381904
臺北縣,新店市,雙城里,1218,466,38.10302535,757,61.89697465,1223,32,1255,0,1559,80.50032072
臺北縣,新店市,雙城里,1219,393,41.49947202,554,58.50052798,947,20,967,0,1203,80.38237739
臺北縣,新店市,日興里,1223,651,48.72754491,685,51.27245509,1336,16,1352,0,1686,80.18979834
臺北縣,新店市,日興里,1224,369,35.61776062,667,64.38223938,1036,40,1076,0,1348,79.82195846
臺北縣,新店市,日興里,1225,413,38.96226415,647,61.03773585,1060,36,1096,0,1364,80.35190616
臺北縣,新店市,玫瑰里,1226,367,27.61474793,962,72.38525207,1329,17,1346,0,1634,82.374541
臺北縣,新店市,玫瑰里,1227,371,30.18714402,858,69.81285598,1229,23,1252,0,1515,82.64026403
臺北縣,新店市,玫瑰里,1228,303,27.54545455,797,72.45454545,1100,11,1111,0,1378,80.62409289
臺北縣,新店市,塗潭里,1232,414,74.19354839,144,25.80645161,558,27,585,0,732,79.91803279
臺北縣,新店市,美潭里,1236,370,32.34265734,774,67.65734266,1144,23,1167,0,1403,83.17890235
臺北縣,新店市,美潭里,1237,476,36.95652174,812,63.04347826,1288,38,1326,0,1618,81.95302843
臺北縣,新店市,美潭里,1238,238,28.74396135,590,71.25603865,828,16,844,0,1020,82.74509804
臺北縣,新店市,員潭里,1239,452,35.81616482,810,64.18383518,1262,44,1306,0,1595,81.88087774
臺北縣,新店市,員潭里,1240,455,41.74311927,635,58.25688073,1090,34,1124,0,1447,77.67795439
臺北縣,新店市,雙坑里,1241,340,61.93078324,209,38.06921676,549,24,573,0,780,73.46153846
臺北縣,新店市,粗坑里,1242,181,57.0977918,136,42.9022082,317,8,325,0,392,82.90816327
臺北縣,新店市,粗坑里,1243,489,36.85003768,838,63.14996232,1327,38,1365,0,1750,78
臺北縣,新店市,屈尺里,1244,464,57.49690211,343,42.50309789,807,34,841,0,1015,82.85714286
臺北縣,新店市,屈尺里,1245,353,39.75225225,535,60.24774775,888,18,906,0,1218,74.38423645
臺北縣,新店市,龜山里,1246,559,53.18744053,492,46.81255947,1051,20,1071,1,1374,77.94759825
臺北縣,新店市,廣興里,1247,555,67.84841076,263,32.15158924,818,53,871,0,1103,78.96645512
臺北縣,新店市,直潭里,1248,210,68.18181818,98,31.81818182,308,17,325,0,418,77.75119617
臺北縣,新店市,直潭里,1249,197,72.96296296,73,27.03703704,270,9,279,0,328,85.06097561
臺北縣,新店市,青潭里,1234,628,40.56847545,920,59.43152455,1548,35,1583,0,1916,82.62004175
臺北縣,新店市,青潭里,1235,554,34.26097712,1063,65.73902288,1617,41,1658,0,2015,82.28287841
臺北縣,新店市,新店里,1090,581,50.0862069,579,49.9137931,1160,42,1202,0,1461,82.27241615
臺北縣,新店市,張南里,1091,408,46.52223489,469,53.47776511,877,26,903,0,1113,81.13207547
臺北縣,新店市,國校里,1092,422,41.29158513,600,58.70841487,1022,48,1070,0,1333,80.27006752
臺北縣,新店市,國校里,1093,220,31.70028818,474,68.29971182,694,4,698,0,907,76.9570011
臺北縣,新店市,文中里,1094,348,32.10332103,736,67.89667897,1084,33,1117,0,1414,78.99575672
臺北縣,新店市,廣明里,1095,322,55.70934256,256,44.29065744,578,24,602,0,704,85.51136364
臺北縣,新店市,文明里,1096,408,46.62857143,467,53.37142857,875,27,902,0,1045,86.31578947
臺北縣,新店市,文明里,1097,324,35.80110497,581,64.19889503,905,11,916,0,1073,85.36812675
臺北縣,新店市,中興里,1098,360,25.78796562,1036,74.21203438,1396,36,1432,0,1741,82.25157955
臺北縣,新店市,中興里,1099,303,28.45070423,762,71.54929577,1065,13,1078,0,1987,54.25264217
臺北縣,新店市,中興里,1100,425,32.22137983,894,67.77862017,1319,21,1340,0,1660,80.72289157
臺北縣,新店市,新生里,1101,373,24.57180501,1145,75.42819499,1518,27,1545,0,1843,83.8307108
臺北縣,新店市,新生里,1102,468,38.45521775,749,61.54478225,1217,26,1243,0,1514,82.1003963
臺北縣,新店市,新生里,1103,388,32.79797126,795,67.20202874,1183,21,1204,0,1480,81.35135135
臺北縣,新店市,新德里,1104,387,42.85714286,516,57.14285714,903,25,928,0,1149,80.76588338
臺北縣,新店市,新德里,1105,329,35.56756757,596,64.43243243,925,17,942,0,1138,82.77680141
臺北縣,新店市,張北里,1106,380,34.7985348,712,65.2014652,1092,35,1127,0,1422,79.25457103
臺北縣,新店市,張北里,1107,412,35.64013841,744,64.35986159,1156,15,1171,0,1444,81.09418283
臺北縣,新店市,張北里,1108,338,30.86757991,757,69.13242009,1095,32,1127,0,1413,79.75937721
臺北縣,新店市,張北里,1109,245,24.35387674,761,75.64612326,1006,11,1017,0,1247,81.55573376
臺北縣,新店市,五峰里,1110,295,26.4573991,820,73.5426009,1115,20,1135,0,1399,81.12937813
臺北縣,新店市,五峰里,1111,414,32.26812159,869,67.73187841,1283,25,1308,0,1568,83.41836735
臺北縣,新店市,五峰里,1112,312,25.28363047,922,74.71636953,1234,19,1253,0,1504,83.31117021
臺北縣,新店市,五峰里,1113,417,37.00088731,710,62.99911269,1127,29,1156,0,1402,82.45363766
臺北縣,新店市,新安里,1116,366,31.28205128,804,68.71794872,1170,23,1193,0,1421,83.95496129
臺北縣,新店市,新安里,1117,338,27.19227675,905,72.80772325,1243,28,1271,0,1583,80.29058749
臺北縣,新店市,忠誠里,1118,297,31.66311301,641,68.33688699,938,19,957,0,1147,83.43504795
臺北縣,新店市,忠誠里,1119,275,30.52164262,626,69.47835738,901,15,916,0,1086,84.34622468
臺北縣,新店市,中正里,1120,354,35.0148368,657,64.9851632,1011,21,1032,0,1224,84.31372549
臺北縣,新店市,中正里,1121,443,35.41167066,808,64.58832934,1251,21,1272,0,1553,81.90598841
臺北縣,新店市,中正里,1122,430,33.25599381,863,66.74400619,1293,28,1321,0,1666,79.29171669
臺北縣,新店市,中正里,1123,198,19.03846154,842,80.96153846,1040,17,1057,0,1334,79.23538231
臺北縣,新店市,中華里,1124,185,22.75522755,628,77.24477245,813,17,830,0,1040,79.80769231
臺北縣,新店市,中華里,1125,239,26.1487965,675,73.8512035,914,16,930,0,1123,82.81389136
臺北縣,新店市,中華里,1126,231,29.0201005,565,70.9798995,796,25,821,0,1009,81.36769078
臺北縣,新店市,仁愛里,1127,302,32.68398268,622,67.31601732,924,10,934,0,1126,82.94849023
臺北縣,新店市,仁愛里,1128,164,21.2160414,609,78.7839586,773,23,796,0,977,81.47389969
臺北縣,新店市,百忍里,1131,246,31.45780051,536,68.54219949,782,20,802,0,962,83.36798337
臺北縣,新店市,百忍里,1132,257,27.81385281,667,72.18614719,924,14,938,0,1124,83.4519573
臺北縣,新店市,百忍里,1133,306,28.51817335,767,71.48182665,1073,31,1104,0,1316,83.89057751
臺北縣,新店市,百和里,1134,334,32.0845341,707,67.9154659,1041,22,1063,0,1262,84.23137876
臺北縣,新店市,百和里,1135,406,31.96850394,864,68.03149606,1270,22,1292,1,1551,83.30109607
臺北縣,新店市,福德里,1136,360,31.94321207,767,68.05678793,1127,18,1145,0,1402,81.66904422
臺北縣,新店市,福德里,1137,241,31.54450262,523,68.45549738,764,7,771,0,921,83.71335505
臺北縣,新店市,福德里,1138,210,24.97027348,631,75.02972652,841,12,853,0,1040,82.01923077
臺北縣,新店市,百福里,1139,333,33.84146341,651,66.15853659,984,15,999,0,1187,84.16175232
臺北縣,新店市,百福里,1140,305,28.2146161,776,71.7853839,1081,29,1110,0,1352,82.10059172
臺北縣,新店市,福民里,1141,266,20.54054054,1029,79.45945946,1295,27,1322,0,1622,81.50431566
臺北縣,新店市,福民里,1142,343,23.42896175,1121,76.57103825,1464,38,1502,0,1839,81.67482327
臺北縣,新店市,中山里,1143,295,67.81609195,140,32.18390805,435,17,452,0,533,84.80300188
臺北縣,新店市,中山里,1144,319,22.38596491,1106,77.61403509,1425,38,1463,1,1851,79.03835764
臺北縣,新店市,和平里,1145,183,27.7693475,476,72.2306525,659,35,694,0,833,83.31332533
臺北縣,新店市,中央里,1146,444,29.44297082,1064,70.55702918,1508,20,1528,0,1831,83.45166576
臺北縣,新店市,中央里,1147,372,25.97765363,1060,74.02234637,1432,13,1445,0,1754,82.38312429
臺北縣,新店市,明城里,1212,279,24.4951712,860,75.5048288,1139,11,1150,0,1399,82.20157255
臺北縣,新店市,明城里,1213,231,24.91909385,696,75.08090615,927,14,941,0,1187,79.27548441
臺北縣,新店市,安和里,1189,369,35.31100478,676,64.68899522,1045,23,1068,0,1302,82.02764977
臺北縣,新店市,安和里,1190,480,37.79527559,790,62.20472441,1270,29,1299,0,1550,83.80645161
臺北縣,新店市,安和里,1191,442,43.9800995,563,56.0199005,1005,34,1039,0,1303,79.7390637
臺北縣,新店市,吉祥里,1229,182,22.83563363,615,77.16436637,797,10,807,0,1007,80.13902681
臺北縣,新店市,吉祥里,1230,224,24.29501085,698,75.70498915,922,24,946,0,1136,83.27464789
臺北縣,新店市,吉祥里,1231,245,23.35557674,804,76.64442326,1049,28,1077,0,1339,80.43315907
臺北縣,新店市,寶福里,1166,370,37.60162602,614,62.39837398,984,19,1003,0,1234,81.28038898
臺北縣,新店市,寶福里,1167,488,33.06233062,988,66.93766938,1476,35,1511,0,1825,82.79452055
臺北縣,新店市,寶福里,1168,292,25.19413287,867,74.80586713,1159,22,1181,1,1421,83.11048557
臺北縣,新店市,小城里,1214,271,27.73797339,706,72.26202661,977,16,993,0,1168,85.01712329
臺北縣,新店市,小城里,1215,301,22.31282431,1048,77.68717569,1349,17,1366,0,1617,84.47742733
臺北縣,新店市,香坡里,1220,441,29.41961308,1058,70.58038692,1499,26,1525,0,1871,81.50721539
臺北縣,新店市,香坡里,1221,267,25.21246459,792,74.78753541,1059,23,1082,0,1408,76.84659091
臺北縣,新店市,香坡里,1222,276,25.41436464,810,74.58563536,1086,19,1105,0,1415,78.09187279
臺北縣,新店市,建國里,1129,238,27.70663562,621,72.29336438,859,13,872,0,1041,83.76560999
臺北縣,新店市,建國里,1130,283,23.58333333,917,76.41666667,1200,17,1217,0,1487,81.84263618
臺北縣,新店市,復興里,1161,516,44.32989691,648,55.67010309,1164,24,1188,0,1498,79.30574099
臺北縣,新店市,復興里,1162,455,35.546875,825,64.453125,1280,28,1308,0,1610,81.24223602
臺北縣,新店市,美城里,1181,277,31.65714286,598,68.34285714,875,18,893,0,1059,84.32483475
臺北縣,新店市,美城里,1182,257,29.71098266,608,70.28901734,865,21,886,0,1078,82.18923933
臺北縣,新店市,安昌里,1204,451,35.65217391,814,64.34782609,1265,23,1288,0,1568,82.14285714
臺北縣,新店市,安昌里,1205,398,30.312262,915,69.687738,1313,5,1318,0,1630,80.85889571
臺北縣,新店市,長春里,1114,225,25.62642369,653,74.37357631,878,11,889,0,1047,84.90926457
臺北縣,新店市,長春里,1115,192,25.46419098,562,74.53580902,754,8,762,0,935,81.4973262
臺北縣,新店市,新和里,1195,353,27.17474981,946,72.82525019,1299,20,1319,1,1596,82.64411028
臺北縣,新店市,新和里,1196,412,32.59493671,852,67.40506329,1264,23,1287,0,1546,83.24708926
臺北縣,新店市,永平里,1197,321,37.45624271,536,62.54375729,857,12,869,0,1070,81.21495327
臺北縣,新店市,永平里,1198,315,29.7731569,743,70.2268431,1058,22,1080,0,1299,83.1408776
臺北縣,新店市,永平里,1199,550,41.26031508,783,58.73968492,1333,40,1373,0,1659,82.76069922
臺北縣,新店市,達觀里,1210,278,26.37571157,776,73.62428843,1054,16,1070,0,1324,80.81570997
臺北縣,新店市,達觀里,1211,290,27.07749767,781,72.92250233,1071,8,1079,0,1337,80.70306657
臺北縣,新店市,華城里,1233,421,35.4079058,768,64.5920942,1189,12,1201,0,1456,82.48626374
臺北縣,土城市,埤塘里,1270,519,51.7447657,484,48.2552343,1003,29,1032,0,1874,55.06937033
臺北縣,土城市,埤塘里,1271,469,47.46963563,519,52.53036437,988,36,1024,0,1229,83.31977217
臺北縣,土城市,土城里,1272,297,43.93491124,379,56.06508876,676,15,691,0,856,80.72429907
臺北縣,土城市,土城里,1273,327,48.66071429,345,51.33928571,672,13,685,0,846,80.96926714
臺北縣,土城市,員林里,1277,458,44.85798237,563,55.14201763,1021,22,1043,0,1288,80.97826087
臺北縣,土城市,員林里,1278,554,43.04584305,733,56.95415695,1287,38,1325,0,1616,81.99257426
臺北縣,土城市,員林里,1279,536,47.05882353,603,52.94117647,1139,23,1162,0,1403,82.82252316
臺北縣,土城市,員仁里,1267,589,50.86355786,569,49.13644214,1158,29,1187,0,1493,79.50435365
臺北縣,土城市,員仁里,1268,407,43.3901919,531,56.6098081,938,23,961,0,1213,79.22506183
臺北縣,土城市,員仁里,1269,529,46.77276746,602,53.22723254,1131,35,1166,0,1519,76.76102699
臺北縣,土城市,長風里,1274,181,13.47728965,1162,86.52271035,1343,12,1355,0,1583,85.59696778
臺北縣,土城市,日新里,1286,579,52.63636364,521,47.36363636,1100,24,1124,0,1404,80.05698006
臺北縣,土城市,日新里,1287,491,52.62593783,442,47.37406217,933,22,955,0,1185,80.5907173
臺北縣,土城市,日新里,1288,500,53.13496281,441,46.86503719,941,23,964,0,1179,81.76420696
臺北縣,土城市,日和里,1283,602,58.7890625,422,41.2109375,1024,18,1042,0,1288,80.90062112
臺北縣,土城市,日和里,1284,645,51.39442231,610,48.60557769,1255,19,1274,0,1589,80.17621145
臺北縣,土城市,日和里,1285,579,54.77767266,478,45.22232734,1057,21,1078,0,1313,82.10205636
臺北縣,土城市,貨饒里,1292,684,56.38911789,529,43.61088211,1213,29,1242,0,1510,82.25165563
臺北縣,土城市,貨饒里,1293,659,51.72684458,615,48.27315542,1274,20,1294,0,1610,80.37267081
臺北縣,土城市,柑林里,1320,685,48.13773717,738,51.86226283,1423,29,1452,0,1832,79.25764192
臺北縣,土城市,柑林里,1321,254,64.30379747,141,35.69620253,395,14,409,0,545,75.04587156
臺北縣,土城市,埤林里,1303,605,53.1167691,534,46.8832309,1139,22,1161,0,1436,80.84958217
臺北縣,土城市,埤林里,1304,483,52.27272727,441,47.72727273,924,12,936,0,1148,81.53310105
臺北縣,土城市,埤林里,1305,434,45.92592593,511,54.07407407,945,21,966,0,1134,85.18518519
臺北縣,土城市,埤林里,1306,351,34.51327434,666,65.48672566,1017,23,1040,1,1257,82.73667462
臺北縣,土城市,埤林里,1307,287,34.95736906,534,65.04263094,821,5,826,0,963,85.77362409
臺北縣,土城市,瑞興里,1294,591,53.58114234,512,46.41885766,1103,25,1128,0,1349,83.61749444
臺北縣,土城市,瑞興里,1295,586,56.61835749,449,43.38164251,1035,37,1072,0,1282,83.61934477
臺北縣,土城市,清水里,1336,513,46.4673913,591,53.5326087,1104,18,1122,0,1385,81.01083032
臺北縣,土城市,清水里,1337,536,45.7337884,636,54.2662116,1172,17,1189,0,1440,82.56944444
臺北縣,土城市,清水里,1338,535,48.85844749,560,51.14155251,1095,29,1124,0,1380,81.44927536
臺北縣,土城市,清水里,1339,544,47.01815039,613,52.98184961,1157,27,1184,0,1423,83.20449754
臺北縣,土城市,清和里,1326,680,58.67126833,479,41.32873167,1159,28,1187,0,1472,80.63858696
臺北縣,土城市,清和里,1327,755,56.8096313,574,43.1903687,1329,34,1363,0,1771,76.96216827
臺北縣,土城市,清和里,1328,567,47.21065779,634,52.78934221,1201,23,1224,0,1577,77.61572606
臺北縣,土城市,永豐里,1340,439,45.49222798,526,54.50777202,965,22,987,0,1236,79.85436893
臺北縣,土城市,永豐里,1341,429,47.87946429,467,52.12053571,896,28,924,0,1157,79.86171132
臺北縣,土城市,清化里,1329,536,51.04761905,514,48.95238095,1050,33,1083,0,1323,81.85941043
臺北縣,土城市,清溪里,1330,392,41.30663857,557,58.69336143,949,17,966,0,1170,82.56410256
臺北縣,土城市,清溪里,1331,315,38.60294118,501,61.39705882,816,14,830,0,983,84.43540183
臺北縣,土城市,清溪里,1332,551,44.72402597,681,55.27597403,1232,24,1256,0,1549,81.08457069
臺北縣,土城市,清溪里,1333,478,38.67313916,758,61.32686084,1236,38,1274,0,1567,81.30185067
臺北縣,土城市,峰廷里,1351,437,46.93877551,494,53.06122449,931,28,959,0,1172,81.82593857
臺北縣,土城市,峰廷里,1352,542,48.6535009,572,51.3464991,1114,20,1134,0,1419,79.9154334
臺北縣,土城市,峰廷里,1353,580,51.78571429,540,48.21428571,1120,27,1147,0,1393,82.34027279
臺北縣,土城市,峰廷里,1354,620,47.69230769,680,52.30769231,1300,19,1319,0,1626,81.11931119
臺北縣,土城市,平和里,1364,541,50.70290534,526,49.29709466,1067,30,1097,0,1312,83.61280488
臺北縣,土城市,平和里,1365,588,49.32885906,604,50.67114094,1192,24,1216,0,1477,82.32904536
臺北縣,土城市,平和里,1366,436,50.46296296,428,49.53703704,864,16,880,0,1080,81.48148148
臺北縣,土城市,平和里,1367,543,50.65298507,529,49.34701493,1072,19,1091,0,1311,83.21891686
臺北縣,土城市,廷寮里,1345,549,56.36550308,425,43.63449692,974,17,991,0,1204,82.3089701
臺北縣,土城市,廷寮里,1346,453,54.18660287,383,45.81339713,836,11,847,0,1016,83.36614173
臺北縣,土城市,廷寮里,1347,403,41.54639175,567,58.45360825,970,20,990,0,1209,81.88585608
臺北縣,土城市,大安里,1264,342,64.16510319,191,35.83489681,533,12,545,0,663,82.20211161
臺北縣,土城市,大安里,1265,650,53.10457516,574,46.89542484,1224,29,1253,0,1562,80.21766965
臺北縣,土城市,大安里,1266,460,42.3572744,626,57.6427256,1086,29,1115,0,1404,79.41595442
臺北縣,土城市,永寧里,1260,523,48.51576994,555,51.48423006,1078,35,1113,0,1386,80.3030303
臺北縣,土城市,永寧里,1261,439,46.50423729,505,53.49576271,944,28,972,0,1257,77.32696897
臺北縣,土城市,永寧里,1262,498,47.65550239,547,52.34449761,1045,27,1072,0,1407,76.19047619
臺北縣,土城市,永寧里,1263,642,45.72649573,762,54.27350427,1404,25,1429,0,1811,78.90668139
臺北縣,土城市,沛陂里,1258,645,60.11183597,428,39.88816403,1073,38,1111,0,1354,82.05317578
臺北縣,土城市,沛陂里,1259,480,50.47318612,471,49.52681388,951,28,979,0,1270,77.08661417
臺北縣,土城市,頂埔里,1255,455,51.06621773,436,48.93378227,891,26,917,0,1162,78.91566265
臺北縣,土城市,頂埔里,1256,473,45.26315789,572,54.73684211,1045,30,1075,0,1352,79.51183432
臺北縣,土城市,頂埔里,1257,315,32.30769231,660,67.69230769,975,26,1001,0,1217,82.25143796
臺北縣,土城市,頂福里,1252,416,43.9281943,531,56.0718057,947,36,983,0,1269,77.46256895
臺北縣,土城市,頂福里,1253,415,51.10837438,397,48.89162562,812,28,840,0,1034,81.23791103
臺北縣,土城市,頂福里,1254,527,48.75115634,554,51.24884366,1081,38,1119,0,1341,83.44519016
臺北縣,土城市,頂新里,1251,115,18.69918699,500,81.30081301,615,17,632,0,766,82.50652742
臺北縣,土城市,祖田里,1250,546,54.87437186,449,45.12562814,995,33,1028,0,1250,82.24
臺北縣,土城市,樂利里,1310,514,47.1559633,576,52.8440367,1090,21,1111,0,1367,81.27286028
臺北縣,土城市,樂利里,1311,611,51.43097643,577,48.56902357,1188,18,1206,0,1465,82.32081911
臺北縣,土城市,樂利里,1312,441,41.52542373,621,58.47457627,1062,17,1079,0,1340,80.52238806
臺北縣,土城市,廣福里,1298,436,38.21209465,705,61.78790535,1141,14,1155,0,1370,84.30656934
臺北縣,土城市,廣福里,1299,442,43.07992203,584,56.92007797,1026,19,1045,0,1268,82.41324921
臺北縣,土城市,廣福里,1300,526,45.69939183,625,54.30060817,1151,14,1165,0,1392,83.69252874
臺北縣,土城市,學府里,1313,564,46.2295082,656,53.7704918,1220,25,1245,0,1552,80.21907216
臺北縣,土城市,學府里,1314,431,45.60846561,514,54.39153439,945,20,965,0,1169,82.54918734
臺北縣,土城市,延壽里,1358,355,49.03314917,369,50.96685083,724,6,730,0,953,76.60020986
臺北縣,土城市,延壽里,1359,598,48.26472962,641,51.73527038,1239,27,1266,0,1513,83.67481824
臺北縣,土城市,延壽里,1360,426,51.38721351,403,48.61278649,829,6,835,0,1011,82.59149357
臺北縣,土城市,安和里,1368,511,52.57201646,461,47.42798354,972,23,995,1,1218,81.69129721
臺北縣,土城市,安和里,1369,450,43.73177843,579,56.26822157,1029,17,1046,0,1253,83.47964884
臺北縣,土城市,安和里,1370,565,53.96370583,482,46.03629417,1047,24,1071,0,1301,82.32129131
臺北縣,土城市,青雲里,1324,600,55.55555556,480,44.44444444,1080,30,1110,0,1318,84.2185129
臺北縣,土城市,青雲里,1325,365,47.03608247,411,52.96391753,776,14,790,0,936,84.4017094
臺北縣,土城市,員福里,1280,440,51.10336818,421,48.89663182,861,24,885,0,1081,81.86864015
臺北縣,土城市,員福里,1281,602,47.10485133,676,52.89514867,1278,22,1300,0,1553,83.70895042
臺北縣,土城市,員福里,1282,609,48.72,641,51.28,1250,29,1279,1,1566,81.67305236
臺北縣,土城市,延吉里,1355,577,53.13075506,509,46.86924494,1086,38,1124,0,1381,81.39029689
臺北縣,土城市,延吉里,1356,453,52.43055556,411,47.56944444,864,15,879,0,1084,81.08856089
臺北縣,土城市,延吉里,1357,386,48.37092732,412,51.62907268,798,14,812,0,999,81.28128128
臺北縣,土城市,復興里,1296,663,52.8708134,591,47.1291866,1254,29,1283,0,1619,79.24644842
臺北縣,土城市,復興里,1297,763,48.50603942,810,51.49396058,1573,22,1595,0,1929,82.68532919
臺北縣,土城市,裕生里,1289,603,52.29835212,550,47.70164788,1153,27,1180,0,1450,81.37931034
臺北縣,土城市,裕生里,1290,551,48.58906526,583,51.41093474,1134,28,1162,0,1480,78.51351351
臺北縣,土城市,裕生里,1291,600,48.23151125,644,51.76848875,1244,26,1270,0,1554,81.72458172
臺北縣,土城市,員信里,1275,571,41.40681653,808,58.59318347,1379,24,1403,0,1752,80.07990868
臺北縣,土城市,員信里,1276,542,46.40410959,626,53.59589041,1168,28,1196,0,1486,80.48452221
臺北縣,土城市,永富里,1342,410,45.45454545,492,54.54545455,902,18,920,0,1188,77.44107744
臺北縣,土城市,永富里,1343,551,50.09090909,549,49.90909091,1100,20,1120,0,1404,79.77207977
臺北縣,土城市,永富里,1344,486,43.27693678,637,56.72306322,1123,28,1151,0,1455,79.10652921
臺北縣,土城市,學成里,1301,625,55.60498221,499,44.39501779,1124,17,1141,0,1370,83.28467153
臺北縣,土城市,學成里,1302,475,51.24056095,452,48.75943905,927,29,956,0,1157,82.62748487
臺北縣,土城市,延和里,1371,554,51.15420129,529,48.84579871,1083,22,1105,0,1379,80.13052937
臺北縣,土城市,延和里,1372,587,49.61961116,596,50.38038884,1183,23,1206,0,1508,79.9734748
臺北縣,土城市,延和里,1373,547,41.81957187,761,58.18042813,1308,20,1328,0,1696,78.30188679
臺北縣,土城市,中正里,1322,357,40.75342466,519,59.24657534,876,22,898,0,1115,80.53811659
臺北縣,土城市,中正里,1323,429,47.03947368,483,52.96052632,912,25,937,0,1142,82.04903678
臺北縣,土城市,學士里,1318,624,43.03448276,826,56.96551724,1450,12,1462,0,1772,82.50564334
臺北縣,土城市,學士里,1319,640,48.55842185,678,51.44157815,1318,19,1337,0,1609,83.09509012
臺北縣,土城市,明德里,1315,377,43.68482039,486,56.31517961,863,9,872,0,1037,84.08871745
臺北縣,土城市,明德里,1316,371,41.26807564,528,58.73192436,899,13,912,0,1094,83.36380256
臺北縣,土城市,明德里,1317,383,41.58523344,538,58.41476656,921,13,934,0,1148,81.35888502
臺北縣,土城市,廣興里,1308,370,43.17386231,487,56.82613769,857,20,877,0,1074,81.65735568
臺北縣,土城市,廣興里,1309,575,48.72881356,605,51.27118644,1180,19,1199,0,1446,82.91839557
臺北縣,土城市,青山里,1334,406,45.11111111,494,54.88888889,900,23,923,0,1157,79.7752809
臺北縣,土城市,青山里,1335,420,43.03278689,556,56.96721311,976,21,997,0,1211,82.328654
臺北縣,土城市,金城里,1348,465,39.24050633,720,60.75949367,1185,21,1206,0,1485,81.21212121
臺北縣,土城市,金城里,1349,382,40.55201699,560,59.44798301,942,7,949,0,1147,82.73757629
臺北縣,土城市,金城里,1350,538,43.04,712,56.96,1250,19,1269,0,1544,82.18911917
臺北縣,土城市,延祿里,1361,302,42.41573034,410,57.58426966,712,14,726,0,895,81.11731844
臺北縣,土城市,延祿里,1362,497,56.8,378,43.2,875,13,888,0,1115,79.64125561
臺北縣,土城市,延祿里,1363,490,48.95104895,511,51.04895105,1001,21,1022,0,1240,82.41935484
臺北縣,蘆洲市,正義里,1395,284,54.82625483,234,45.17374517,518,8,526,0,645,81.5503876
臺北縣,蘆洲市,中原里,1390,595,52.42290749,540,47.57709251,1135,24,1159,0,1422,81.50492264
臺北縣,蘆洲市,中原里,1391,805,60.11949216,534,39.88050784,1339,26,1365,0,1693,80.6261075
臺北縣,蘆洲市,中路里,1379,586,55.65052232,467,44.34947768,1053,22,1075,0,1300,82.69230769
臺北縣,蘆洲市,中路里,1380,677,57.91274594,492,42.08725406,1169,37,1206,0,1415,85.22968198
臺北縣,蘆洲市,光華里,1374,536,47.30803177,597,52.69196823,1133,34,1167,0,1379,84.62654097
臺北縣,蘆洲市,光華里,1375,568,51.40271493,537,48.59728507,1105,37,1142,0,1383,82.57411424
臺北縣,蘆洲市,光華里,1376,501,49.75173784,506,50.24826216,1007,24,1031,0,1230,83.82113821
臺北縣,蘆洲市,保佑里,1458,711,53.09932786,628,46.90067214,1339,32,1371,0,1672,81.99760766
臺北縣,蘆洲市,保佑里,1459,575,57.32801595,428,42.67198405,1003,28,1031,0,1304,79.06441718
臺北縣,蘆洲市,水湳里,1445,685,56.33223684,531,43.66776316,1216,14,1230,0,1521,80.8678501
臺北縣,蘆洲市,水湳里,1446,584,59.04954499,405,40.95045501,989,25,1014,0,1319,76.87642153
臺北縣,蘆洲市,水湳里,1447,803,53.17880795,707,46.82119205,1510,30,1540,0,1884,81.74097665
臺北縣,蘆洲市,水湳里,1448,640,53.78151261,550,46.21848739,1190,28,1218,0,1460,83.42465753
臺北縣,蘆洲市,樓厝里,1410,723,53.27929256,634,46.72070744,1357,17,1374,0,1687,81.44635448
臺北縣,蘆洲市,樓厝里,1411,568,52.11009174,522,47.88990826,1090,28,1118,0,1383,80.83875633
臺北縣,蘆洲市,樓厝里,1412,486,53.40659341,424,46.59340659,910,23,933,0,1113,83.82749326
臺北縣,蘆洲市,鷺江里,1421,729,54.04002965,620,45.95997035,1349,26,1375,0,1714,80.22170362
臺北縣,蘆洲市,鷺江里,1422,490,51.68776371,458,48.31223629,948,25,973,0,1201,81.01582015
臺北縣,蘆洲市,鷺江里,1423,562,57.99793602,407,42.00206398,969,15,984,0,1201,81.93172356
臺北縣,蘆洲市,恆德里,1424,705,51.76211454,657,48.23788546,1362,29,1391,0,1725,80.63768116
臺北縣,蘆洲市,恆德里,1425,616,52.55972696,556,47.44027304,1172,29,1201,0,1497,80.22712091
臺北縣,蘆洲市,恆德里,1426,640,54.98281787,524,45.01718213,1164,35,1199,1,1508,79.50928382
臺北縣,蘆洲市,溪墘里,1427,624,65.47743966,329,34.52256034,953,18,971,0,1184,82.01013514
臺北縣,蘆洲市,溪墘里,1428,601,53.18584071,529,46.81415929,1130,19,1149,0,1427,80.51857043
臺北縣,蘆洲市,樹德里,1441,596,54.18181818,504,45.81818182,1100,28,1128,0,1365,82.63736264
臺北縣,蘆洲市,樹德里,1442,508,52.5336091,459,47.4663909,967,27,994,0,1243,79.96781979
臺北縣,蘆洲市,保和里,1439,423,53.27455919,371,46.72544081,794,23,817,0,1004,81.37450199
臺北縣,蘆洲市,保和里,1440,456,53.71024735,393,46.28975265,849,15,864,0,1086,79.55801105
臺北縣,蘆洲市,仁復里,1429,693,54.7826087,572,45.2173913,1265,32,1297,0,1573,82.45390973
臺北縣,蘆洲市,得勝里,1435,560,55.55555556,448,44.44444444,1008,25,1033,0,1245,82.97188755
臺北縣,蘆洲市,得勝里,1436,738,58.99280576,513,41.00719424,1251,16,1267,0,1530,82.81045752
臺北縣,蘆洲市,南港里,1396,651,54.70588235,539,45.29411765,1190,29,1219,0,1535,79.41368078
臺北縣,蘆洲市,南港里,1397,559,56.75126904,426,43.24873096,985,17,1002,0,1196,83.77926421
臺北縣,蘆洲市,南港里,1398,627,59.65746908,424,40.34253092,1051,10,1061,0,1301,81.55265181
臺北縣,蘆洲市,永樂里,1399,610,53.1358885,538,46.8641115,1148,21,1169,0,1435,81.46341463
臺北縣,蘆洲市,永樂里,1400,637,58.0674567,460,41.9325433,1097,15,1112,0,1347,82.55382331
臺北縣,蘆洲市,永樂里,1401,630,53.75426621,542,46.24573379,1172,30,1202,0,1482,81.10661269
臺北縣,蘆洲市,永康里,1405,577,57.81563126,421,42.18436874,998,21,1019,0,1259,80.93725179
臺北縣,蘆洲市,永康里,1406,624,61.47783251,391,38.52216749,1015,13,1028,0,1224,83.9869281
臺北縣,蘆洲市,永康里,1407,794,55.36959554,640,44.63040446,1434,45,1479,0,1790,82.62569832
臺北縣,蘆洲市,信義里,1413,715,57.70782889,524,42.29217111,1239,41,1280,0,1540,83.11688312
臺北縣,蘆洲市,信義里,1414,715,57.2,535,42.8,1250,26,1276,0,1573,81.11888112
臺北縣,蘆洲市,玉清里,1415,882,53.91198044,754,46.08801956,1636,41,1677,0,2080,80.625
臺北縣,蘆洲市,玉清里,1416,742,56.59801678,569,43.40198322,1311,27,1338,0,1629,82.13627993
臺北縣,蘆洲市,復興里,1417,649,64.13043478,363,35.86956522,1012,21,1033,0,1281,80.6401249
臺北縣,蘆洲市,復興里,1418,698,60.43290043,457,39.56709957,1155,27,1182,0,1435,82.36933798
臺北縣,蘆洲市,水河里,1449,709,55.73899371,563,44.26100629,1272,25,1297,0,1562,83.03457106
臺北縣,蘆洲市,水河里,1450,725,54.84114977,597,45.15885023,1322,32,1354,0,1685,80.35608309
臺北縣,蘆洲市,水河里,1451,594,58.12133072,428,41.87866928,1022,16,1038,0,1311,79.17620137
臺北縣,蘆洲市,水河里,1452,694,51.52190052,653,48.47809948,1347,25,1372,0,1646,83.35358445
臺北縣,蘆洲市,仁愛里,1453,640,57.65765766,470,42.34234234,1110,29,1139,0,1420,80.21126761
臺北縣,蘆洲市,仁愛里,1454,534,53.45345345,465,46.54654655,999,24,1023,0,1256,81.44904459
臺北縣,蘆洲市,仁愛里,1455,530,56.26326964,412,43.73673036,942,17,959,0,1196,80.18394649
臺北縣,蘆洲市,忠義里,1394,730,54.27509294,615,45.72490706,1345,31,1376,0,1713,80.32691185
臺北縣,蘆洲市,九芎里,1383,631,59.58451369,428,40.41548631,1059,12,1071,0,1334,80.28485757
臺北縣,蘆洲市,九芎里,1384,462,56.89655172,350,43.10344828,812,19,831,0,1018,81.63064833
臺北縣,蘆洲市,九芎里,1385,551,49.19642857,569,50.80357143,1120,29,1149,0,1358,84.60972018
臺北縣,蘆洲市,中華里,1388,598,55.21698984,485,44.78301016,1083,46,1129,1,1373,82.22869629
臺北縣,蘆洲市,中華里,1389,476,54.21412301,402,45.78587699,878,26,904,0,1070,84.48598131
臺北縣,蘆洲市,得仁里,1437,473,54.74537037,391,45.25462963,864,27,891,0,1066,83.58348968
臺北縣,蘆洲市,得仁里,1438,502,57.70114943,368,42.29885057,870,15,885,0,1083,81.71745152
臺北縣,蘆洲市,仁德里,1430,633,61.27783156,400,38.72216844,1033,15,1048,0,1294,80.98918083
臺北縣,蘆洲市,仁德里,1431,564,53.0075188,500,46.9924812,1064,26,1090,1,1292,84.36532508
臺北縣,蘆洲市,仁德里,1432,651,58.9673913,453,41.0326087,1104,30,1134,0,1379,82.23350254
臺北縣,蘆洲市,仁義里,1433,510,55.85980285,403,44.14019715,913,21,934,0,1505,62.05980066
臺北縣,蘆洲市,仁義里,1434,569,61.78067318,352,38.21932682,921,21,942,0,1160,81.20689655
臺北縣,蘆洲市,光明里,1377,689,58.88888889,481,41.11111111,1170,28,1198,0,1512,79.23280423
臺北縣,蘆洲市,光明里,1378,798,54.21195652,674,45.78804348,1472,31,1503,0,1840,81.68478261
臺北縣,蘆洲市,保新里,1460,459,56.3190184,356,43.6809816,815,14,829,2,1025,80.87804878
臺北縣,蘆洲市,保新里,1461,513,58.2292849,368,41.7707151,881,31,912,0,1082,84.2883549
臺北縣,蘆洲市,長安里,1392,784,58.03108808,567,41.96891192,1351,25,1376,0,1752,78.53881279
臺北縣,蘆洲市,長安里,1393,799,56.82788051,607,43.17211949,1406,37,1443,0,1800,80.16666667
臺北縣,蘆洲市,民和里,1443,554,54.2074364,468,45.7925636,1022,37,1059,0,1312,80.71646341
臺北縣,蘆洲市,民和里,1444,453,52.3699422,412,47.6300578,865,36,901,0,1092,82.50915751
臺北縣,蘆洲市,忠孝里,1456,437,57.34908136,325,42.65091864,762,12,774,0,938,82.51599147
臺北縣,蘆洲市,忠孝里,1457,395,61.43079316,248,38.56920684,643,15,658,0,805,81.73913043
臺北縣,蘆洲市,福安里,1419,572,60.08403361,380,39.91596639,952,19,971,0,1167,83.20479863
臺北縣,蘆洲市,福安里,1420,526,57.61226725,387,42.38773275,913,23,936,0,1126,83.12611012
臺北縣,蘆洲市,永安里,1381,663,56.09137056,519,43.90862944,1182,27,1209,0,1515,79.8019802
臺北縣,蘆洲市,永安里,1382,701,55.94573025,552,44.05426975,1253,21,1274,0,1508,84.48275862
臺北縣,蘆洲市,延平里,1386,664,55.47201337,533,44.52798663,1197,19,1216,0,1476,82.38482385
臺北縣,蘆洲市,延平里,1387,629,57.44292237,466,42.55707763,1095,18,1113,0,1336,83.30838323
臺北縣,蘆洲市,成功里,1402,635,58.25688073,455,41.74311927,1090,13,1103,0,1378,80.04354136
臺北縣,蘆洲市,成功里,1403,672,56.66104553,514,43.33895447,1186,26,1212,0,1486,81.56123822
臺北縣,蘆洲市,成功里,1404,776,58.74337623,545,41.25662377,1321,19,1340,0,1625,82.46153846
臺北縣,蘆洲市,永德里,1408,630,53.25443787,553,46.74556213,1183,11,1194,0,1467,81.39059305
臺北縣,蘆洲市,永德里,1409,743,58.68878357,523,41.31121643,1266,21,1287,0,1573,81.81818182
臺北縣,汐止市,義民里,1463,428,45.14767932,520,54.85232068,948,29,977,0,1208,80.87748344
臺北縣,汐止市,禮門里,1464,346,49.85590778,348,50.14409222,694,25,719,0,938,76.65245203
臺北縣,汐止市,智慧里,1465,466,40.31141869,690,59.68858131,1156,12,1168,0,1456,80.21978022
臺北縣,汐止市,智慧里,1466,443,40.456621,652,59.543379,1095,19,1114,0,1370,81.31386861
臺北縣,汐止市,信望里,1469,158,50.15873016,157,49.84126984,315,6,321,0,407,78.86977887
臺北縣,汐止市,橋東里,1493,420,42.63959391,565,57.36040609,985,7,992,0,1249,79.42353883
臺北縣,汐止市,橋東里,1494,347,46.76549865,395,53.23450135,742,17,759,0,944,80.40254237
臺北縣,汐止市,橋東里,1495,581,43.03703704,769,56.96296296,1350,32,1382,0,1719,80.39557882
臺北縣,汐止市,橋東里,1496,401,37.33705773,673,62.66294227,1074,24,1098,0,1319,83.24488249
臺北縣,汐止市,橋東里,1497,516,37.58193736,857,62.41806264,1373,9,1382,0,1661,83.20288983
臺北縣,汐止市,橋東里,1498,388,33.13407344,783,66.86592656,1171,14,1185,0,1477,80.23019634
臺北縣,汐止市,秀峰里,1475,353,53.64741641,305,46.35258359,658,22,680,0,853,79.71864009
臺北縣,汐止市,秀峰里,1476,369,49.79757085,372,50.20242915,741,15,756,0,983,76.90742625
臺北縣,汐止市,秀峰里,1477,444,48.31338411,475,51.68661589,919,18,937,0,1131,82.84703802
臺北縣,汐止市,新昌里,1470,533,49.67381174,540,50.32618826,1073,31,1104,0,1372,80.4664723
臺北縣,汐止市,新昌里,1471,515,45.65602837,613,54.34397163,1128,19,1147,0,1423,80.60435699
臺北縣,汐止市,新昌里,1472,604,48.63123994,638,51.36876006,1242,24,1266,0,1562,81.04993598
臺北縣,汐止市,復興里,1480,534,42.11356467,734,57.88643533,1268,29,1297,0,1918,67.62252346
臺北縣,汐止市,復興里,1481,513,38.11292719,833,61.88707281,1346,18,1364,0,1673,81.5301853
臺北縣,汐止市,復興里,1482,535,39.86587183,807,60.13412817,1342,14,1356,0,1626,83.39483395
臺北縣,汐止市,茄苳里,1489,673,53.15955766,593,46.84044234,1266,20,1286,0,1653,77.79794313
臺北縣,汐止市,茄苳里,1490,515,46.4801444,593,53.5198556,1108,41,1149,0,1457,78.86067261
臺北縣,汐止市,長安里,1499,571,53.36448598,499,46.63551402,1070,26,1096,0,1386,79.07647908
臺北縣,汐止市,保安里,1500,460,47.17948718,515,52.82051282,975,30,1005,1,1271,79.07159717
臺北縣,汐止市,保長里,1502,461,47.23360656,515,52.76639344,976,13,989,0,1275,77.56862745
臺北縣,汐止市,保長里,1503,453,55.7195572,360,44.2804428,813,31,844,0,1053,80.15194682
臺北縣,汐止市,保長里,1504,486,43.90243902,621,56.09756098,1107,26,1133,0,1491,75.98926895
臺北縣,汐止市,鄉長里,1505,605,45.97264438,711,54.02735562,1316,19,1335,0,1672,79.84449761
臺北縣,汐止市,江北里,1506,520,47.70642202,570,52.29357798,1090,17,1107,0,1365,81.0989011
臺北縣,汐止市,江北里,1507,417,46.12831858,487,53.87168142,904,23,927,1,1187,78.09604044
臺北縣,汐止市,江北里,1508,630,48.87509697,659,51.12490303,1289,28,1317,0,1644,80.10948905
臺北縣,汐止市,拱北里,1509,415,42.69547325,557,57.30452675,972,35,1007,0,1295,77.76061776
臺北縣,汐止市,拱北里,1510,285,34.09090909,551,65.90909091,836,9,845,0,1101,76.74841054
臺北縣,汐止市,拱北里,1511,372,42.27272727,508,57.72727273,880,25,905,0,1164,77.74914089
臺北縣,汐止市,烘內里,1512,430,47.40904079,477,52.59095921,907,30,937,0,1177,79.60917587
臺北縣,汐止市,八連里,1513,306,50.08183306,305,49.91816694,611,18,629,0,789,79.72116603
臺北縣,汐止市,樟樹里,1519,688,52.16072782,631,47.83927218,1319,37,1356,0,1685,80.47477745
臺北縣,汐止市,北峰里,1515,612,51.42857143,578,48.57142857,1190,51,1241,0,1563,79.39859245
臺北縣,汐止市,北峰里,1516,639,48.29931973,684,51.70068027,1323,33,1356,1,1703,79.6241926
臺北縣,汐止市,北山里,1541,334,43.20827943,439,56.79172057,773,15,788,0,957,82.34064786
臺北縣,汐止市,北山里,1542,382,39.30041152,590,60.69958848,972,14,986,0,1220,80.81967213
臺北縣,汐止市,北山里,1543,660,43.50692156,857,56.49307844,1517,35,1552,0,1908,81.34171908
臺北縣,汐止市,白雲里,1487,531,44.47236181,663,55.52763819,1194,20,1214,0,1552,78.22164948
臺北縣,汐止市,白雲里,1488,530,40.86353123,767,59.13646877,1297,22,1319,0,1595,82.69592476
臺北縣,汐止市,橫科里,1547,490,38.52201258,782,61.47798742,1272,24,1296,0,1603,80.84840923
臺北縣,汐止市,橫科里,1548,469,45.35783366,565,54.64216634,1034,17,1051,0,1268,82.88643533
臺北縣,汐止市,橫科里,1549,368,41.96123147,509,58.03876853,877,30,907,0,1101,82.37965486
臺北縣,汐止市,東山里,1501,216,56.1038961,169,43.8961039,385,18,403,0,497,81.08651911
臺北縣,汐止市,福山里,1550,494,43.48591549,642,56.51408451,1136,13,1149,0,1406,81.72119488
臺北縣,汐止市,福山里,1551,442,37.23673126,745,62.76326874,1187,11,1198,0,1469,81.55207624
臺北縣,汐止市,宜興里,1552,389,36.56015038,675,63.43984962,1064,22,1086,0,1313,82.71134806
臺北縣,汐止市,宜興里,1553,315,35.35353535,576,64.64646465,891,19,910,0,1102,82.57713249
臺北縣,汐止市,中興里,1527,642,46.72489083,732,53.27510917,1374,29,1403,0,1774,79.08680947
臺北縣,汐止市,中興里,1528,667,46.90576653,755,53.09423347,1422,33,1455,0,1838,79.16213275
臺北縣,汐止市,中興里,1529,592,48.28711256,634,51.71288744,1226,27,1253,0,1563,80.16634677
臺北縣,汐止市,湖光里,1536,470,35.33834586,860,64.66165414,1330,29,1359,0,1688,80.50947867
臺北縣,汐止市,湖光里,1537,564,40.51724138,828,59.48275862,1392,17,1409,1,1723,81.77597214
臺北縣,汐止市,湖光里,1538,282,35.11830635,521,64.88169365,803,7,810,0,1059,76.48725212
臺北縣,汐止市,仁德里,1462,571,47.78242678,624,52.21757322,1195,38,1233,0,1525,80.85245902
臺北縣,汐止市,厚德里,1523,461,41.87102634,640,58.12897366,1101,24,1125,0,1378,81.64005806
臺北縣,汐止市,厚德里,1524,425,37.51103266,708,62.48896734,1133,19,1152,1,1469,78.42069435
臺北縣,汐止市,厚德里,1525,447,34.22664625,859,65.77335375,1306,22,1328,0,1715,77.43440233
臺北縣,汐止市,忠孝里,1520,430,41.26679463,612,58.73320537,1042,27,1069,0,1356,78.83480826
臺北縣,汐止市,忠孝里,1521,612,41.04627767,879,58.95372233,1491,37,1528,0,1929,79.21202696
臺北縣,汐止市,忠孝里,1522,577,36.82195278,990,63.17804722,1567,28,1595,0,2031,78.53274249
臺北縣,汐止市,自強里,1483,627,49.96015936,628,50.03984064,1255,38,1293,0,1621,79.7655768
臺北縣,汐止市,自強里,1484,619,44.43646805,774,55.56353195,1393,36,1429,0,1807,79.0813503
臺北縣,汐止市,文化里,1485,496,47.64649376,545,52.35350624,1041,19,1060,0,1324,80.06042296
臺北縣,汐止市,文化里,1486,435,40.84507042,630,59.15492958,1065,28,1093,0,1329,82.24228743
臺北縣,汐止市,金龍里,1517,637,43.33333333,833,56.66666667,1470,23,1493,0,1928,77.43775934
臺北縣,汐止市,金龍里,1518,603,41.55754652,848,58.44245348,1451,35,1486,0,1867,79.59292983
臺北縣,汐止市,福德里,1530,406,46.45308924,468,53.54691076,874,21,895,0,1125,79.55555556
臺北縣,汐止市,福德里,1531,369,43.00699301,489,56.99300699,858,14,872,0,1158,75.30224525
臺北縣,汐止市,興福里,1532,324,36.81818182,556,63.18181818,880,14,894,0,1088,82.16911765
臺北縣,汐止市,興福里,1533,365,42.7901524,488,57.2098476,853,3,856,0,1078,79.40630798
臺北縣,汐止市,康福里,1534,389,40.14447884,580,59.85552116,969,22,991,0,1256,78.90127389
臺北縣,汐止市,康福里,1535,396,42.30769231,540,57.69230769,936,17,953,0,1157,82.3681936
臺北縣,汐止市,忠山里,1544,399,36.57195234,692,63.42804766,1091,18,1109,0,1351,82.08734271
臺北縣,汐止市,忠山里,1545,347,35.26422764,637,64.73577236,984,12,996,0,1169,85.20102652
臺北縣,汐止市,環河里,1546,457,59.50520833,311,40.49479167,768,28,796,0,984,80.89430894
臺北縣,汐止市,東勢里,1554,396,48,429,52,825,19,844,0,1020,82.74509804
臺北縣,汐止市,東勢里,1555,433,32.77819833,888,67.22180167,1321,13,1334,0,1608,82.960199
臺北縣,汐止市,山光里,1526,444,30.70539419,1002,69.29460581,1446,26,1472,0,1911,77.02773417
臺北縣,汐止市,大同里,1467,293,41.15168539,419,58.84831461,712,19,731,0,949,77.028451
臺北縣,汐止市,大同里,1468,266,34.01534527,516,65.98465473,782,17,799,0,985,81.11675127
臺北縣,汐止市,崇德里,1491,639,49.38176198,655,50.61823802,1294,36,1330,0,1670,79.64071856
臺北縣,汐止市,崇德里,1492,518,42.38952537,704,57.61047463,1222,31,1253,0,1563,80.16634677
臺北縣,汐止市,湖興里,1539,451,32.99195318,916,67.00804682,1367,22,1389,0,1791,77.55443886
臺北縣,汐止市,湖興里,1540,535,31.67554766,1154,68.32445234,1689,17,1706,0,2162,78.90841813
臺北縣,汐止市,長青里,1514,250,35.21126761,460,64.78873239,710,12,722,0,903,79.95570321
臺北縣,汐止市,福安里,1473,417,44.64668094,517,55.35331906,934,26,960,0,1156,83.0449827
臺北縣,汐止市,福安里,1474,432,45.95744681,508,54.04255319,940,15,955,0,1193,80.05029338
臺北縣,汐止市,秀山里,1478,527,47.60614273,580,52.39385727,1107,19,1126,0,1362,82.67254038
臺北縣,汐止市,秀山里,1479,450,38.52739726,718,61.47260274,1168,18,1186,0,1466,80.90040928
臺北縣,樹林市,三多里,1562,574,53.59477124,497,46.40522876,1071,25,1096,0,1411,77.67540751
臺北縣,樹林市,三多里,1563,722,56.01241272,567,43.98758728,1289,32,1321,0,1561,84.62524023
臺北縣,樹林市,三福里,1559,422,48.72979215,444,51.27020785,866,29,895,0,1119,79.9821269
臺北縣,樹林市,三福里,1560,429,47.56097561,473,52.43902439,902,23,925,0,1140,81.14035088
臺北縣,樹林市,三福里,1561,380,44.49648712,474,55.50351288,854,17,871,0,1069,81.47801684
臺北縣,樹林市,三興里,1556,448,51.73210162,418,48.26789838,866,28,894,0,1152,77.60416667
臺北縣,樹林市,三興里,1557,414,46.7268623,472,53.2731377,886,22,908,0,1127,80.56787933
臺北縣,樹林市,三興里,1558,575,54.45075758,481,45.54924242,1056,35,1091,0,1447,75.39737388
臺北縣,樹林市,圳安里,1582,514,62.60657734,307,37.39342266,821,22,843,0,1032,81.68604651
臺北縣,樹林市,圳安里,1583,642,51.85783522,596,48.14216478,1238,11,1249,0,1582,78.95069532
臺北縣,樹林市,保安里,1578,541,50.70290534,526,49.29709466,1067,31,1098,0,1333,82.37059265
臺北縣,樹林市,保安里,1579,530,48.3135825,567,51.6864175,1097,28,1125,0,1352,83.21005917
臺北縣,樹林市,保安里,1580,488,52.47311828,442,47.52688172,930,22,952,0,1162,81.92771084
臺北縣,樹林市,保安里,1581,443,51.21387283,422,48.78612717,865,17,882,0,1071,82.35294118
臺北縣,樹林市,潭底里,1572,500,62.73525721,297,37.26474279,797,24,821,0,1252,65.57507987
臺北縣,樹林市,潭底里,1573,376,53.25779037,330,46.74220963,706,22,728,0,872,83.48623853
臺北縣,樹林市,潭底里,1574,551,51.35135135,522,48.64864865,1073,24,1097,0,1348,81.37982196
臺北縣,樹林市,羌寮里,1565,535,59.31263858,367,40.68736142,902,19,921,0,1133,81.2886143
臺北縣,樹林市,羌寮里,1566,507,50.54835494,496,49.45164506,1003,27,1030,0,1273,80.91123331
臺北縣,樹林市,羌寮里,1567,428,49.59443801,435,50.40556199,863,16,879,0,1111,79.11791179
臺北縣,樹林市,樹德里,1590,521,46.31111111,604,53.68888889,1125,30,1155,0,1412,81.79886686
臺北縣,樹林市,樹德里,1591,616,50.32679739,608,49.67320261,1224,36,1260,0,1536,82.03125
臺北縣,樹林市,樹西里,1594,436,51.78147268,406,48.21852732,842,19,861,0,1056,81.53409091
臺北縣,樹林市,樹西里,1595,579,48.86075949,606,51.13924051,1185,21,1206,0,1451,83.11509304
臺北縣,樹林市,樹西里,1596,657,49.6223565,667,50.3776435,1324,23,1347,0,1589,84.77029578
臺北縣,樹林市,樹南里,1603,676,49.92614476,678,50.07385524,1354,20,1374,0,1669,82.32474536
臺北縣,樹林市,樹南里,1604,563,45.73517465,668,54.26482535,1231,41,1272,0,1545,82.33009709
臺北縣,樹林市,樹人里,1599,445,44.05940594,565,55.94059406,1010,21,1031,0,1245,82.81124498
臺北縣,樹林市,樹人里,1600,450,45,550,55,1000,19,1019,1,1226,83.11582382
臺北縣,樹林市,坡內里,1605,562,55.15210991,457,44.84789009,1019,37,1056,0,1280,82.5
臺北縣,樹林市,樹東里,1606,402,47.12778429,451,52.87221571,853,18,871,0,1059,82.24740321
臺北縣,樹林市,大同里,1619,515,47.64107308,566,52.35892692,1081,20,1101,0,1313,83.85376999
臺北縣,樹林市,大同里,1620,361,44.02439024,459,55.97560976,820,19,839,0,1069,78.48456501
臺北縣,樹林市,和平里,1611,733,55.91151793,578,44.08848207,1311,43,1354,0,1673,80.93245666
臺北縣,樹林市,和平里,1612,652,54.42404007,546,45.57595993,1198,32,1230,0,1551,79.30367505
臺北縣,樹林市,彭厝里,1616,538,57.35607676,400,42.64392324,938,18,956,0,1193,80.13411567
臺北縣,樹林市,彭厝里,1617,519,48.36905871,554,51.63094129,1073,26,1099,0,1324,83.0060423
臺北縣,樹林市,彭厝里,1618,432,54.27135678,364,45.72864322,796,21,817,0,1025,79.70731707
臺北縣,樹林市,彭福里,1608,539,51.62835249,505,48.37164751,1044,43,1087,0,1385,78.48375451
臺北縣,樹林市,彭福里,1609,565,60.6223176,367,39.3776824,932,34,966,0,1215,79.50617284
臺北縣,樹林市,彭福里,1610,476,48.12942366,513,51.87057634,989,23,1012,0,1251,80.89528377
臺北縣,樹林市,東山里,1631,682,55.35714286,550,44.64285714,1232,30,1262,0,1544,81.7357513
臺北縣,樹林市,東山里,1632,435,52.28365385,397,47.71634615,832,36,868,0,1091,79.56003666
臺北縣,樹林市,東陽里,1628,630,54.64006938,523,45.35993062,1153,34,1187,0,1486,79.87886945
臺北縣,樹林市,東陽里,1629,576,51.2455516,548,48.7544484,1124,44,1168,0,1453,80.3854095
臺北縣,樹林市,東陽里,1630,455,45.183714,552,54.816286,1007,16,1023,0,1299,78.75288684
臺北縣,樹林市,東昇里,1625,450,58.36575875,321,41.63424125,771,33,804,0,987,81.45896657
臺北縣,樹林市,東昇里,1626,514,52.55623722,464,47.44376278,978,19,997,0,1202,82.94509151
臺北縣,樹林市,東昇里,1627,351,51.54185022,330,48.45814978,681,22,703,0,849,82.803298
臺北縣,樹林市,樂山里,1638,560,53.84615385,480,46.15384615,1040,46,1086,0,1339,81.10530246
臺北縣,樹林市,東園里,1642,688,65.15151515,368,34.84848485,1056,48,1104,0,1348,81.89910979
臺北縣,樹林市,西園里,1640,707,69.65517241,308,30.34482759,1015,31,1046,0,1329,78.70579383
臺北縣,樹林市,南園里,1641,348,65.78449905,181,34.21550095,529,21,550,0,651,84.48540707
臺北縣,樹林市,北園里,1643,732,60.8478803,471,39.1521197,1203,31,1234,0,1525,80.91803279
臺北縣,樹林市,柑園里,1639,598,57.72200772,438,42.27799228,1036,32,1068,0,1262,84.62757528
臺北縣,樹林市,樹北里,1607,409,49.27710843,421,50.72289157,830,11,841,0,1015,82.85714286
臺北縣,樹林市,圳福里,1584,450,53.38078292,393,46.61921708,843,20,863,0,1087,79.39282429
臺北縣,樹林市,圳福里,1585,429,53.1598513,378,46.8401487,807,18,825,0,973,84.78931141
臺北縣,樹林市,圳福里,1586,409,48.45971564,435,51.54028436,844,17,861,0,1075,80.09302326
臺北縣,樹林市,樹興里,1597,468,48.75,492,51.25,960,24,984,0,1239,79.4188862
臺北縣,樹林市,樹興里,1598,656,48.27078734,703,51.72921266,1359,34,1393,0,1693,82.27997637
臺北縣,樹林市,樹福里,1592,419,45.99341383,492,54.00658617,911,16,927,0,1137,81.53034301
臺北縣,樹林市,樹福里,1593,329,53.67047308,284,46.32952692,613,20,633,0,764,82.85340314
臺北縣,樹林市,光興里,1568,570,53.22128852,501,46.77871148,1071,32,1103,0,1387,79.52415285
臺北縣,樹林市,光興里,1569,503,47.9047619,547,52.0952381,1050,25,1075,0,1398,76.89556509
臺北縣,樹林市,金寮里,1570,573,51.16071429,547,48.83928571,1120,34,1154,0,1415,81.55477032
臺北縣,樹林市,金寮里,1571,654,53.47506132,569,46.52493868,1223,36,1259,0,1584,79.48232323
臺北縣,樹林市,彭興里,1613,615,55.15695067,500,44.84304933,1115,22,1137,0,1467,77.50511247
臺北縣,樹林市,彭興里,1614,562,50.44883303,552,49.55116697,1114,32,1146,0,1466,78.17189632
臺北縣,樹林市,彭興里,1615,621,58.75118259,436,41.24881741,1057,29,1086,1,1383,78.52494577
臺北縣,樹林市,文林里,1575,662,54.62046205,550,45.37953795,1212,26,1238,0,1485,83.36700337
臺北縣,樹林市,文林里,1576,419,46.40088594,484,53.59911406,903,22,925,0,1175,78.72340426
臺北縣,樹林市,文林里,1577,365,44.78527607,450,55.21472393,815,25,840,0,1056,79.54545455
臺北縣,樹林市,山佳里,1633,446,54.52322738,372,45.47677262,818,24,842,0,1042,80.80614203
臺北縣,樹林市,山佳里,1634,529,54.20081967,447,45.79918033,976,37,1013,1,1259,80.46068308
臺北縣,樹林市,山佳里,1635,332,47.97687861,360,52.02312139,692,14,706,0,863,81.80764774
臺北縣,樹林市,中山里,1636,592,50.46888321,581,49.53111679,1173,48,1221,0,1537,79.44046845
臺北縣,樹林市,中山里,1637,652,52.66558966,586,47.33441034,1238,43,1281,0,1580,81.07594937
臺北縣,樹林市,育英里,1601,478,50.1048218,476,49.8951782,954,22,976,0,1179,82.78201866
臺北縣,樹林市,育英里,1602,468,49.36708861,480,50.63291139,948,21,969,0,1177,82.32795242
臺北縣,樹林市,中華里,1621,455,48.04646251,492,51.95353749,947,22,969,0,1208,80.21523179
臺北縣,樹林市,中華里,1622,402,48.25930372,431,51.74069628,833,20,853,0,1067,79.94376757
臺北縣,樹林市,太順里,1623,390,49.30467762,401,50.69532238,791,20,811,0,1010,80.2970297
臺北縣,樹林市,太順里,1624,417,49.94011976,418,50.05988024,835,24,859,0,1071,80.2054155
臺北縣,樹林市,圳民里,1587,370,50.68493151,360,49.31506849,730,12,742,0,928,79.95689655
臺北縣,樹林市,圳民里,1588,395,49.5608532,402,50.4391468,797,20,817,0,1022,79.94129159
臺北縣,樹林市,圳生里,1589,605,60.31904287,398,39.68095713,1003,19,1022,0,1252,81.62939297
臺北縣,樹林市,三龍里,1564,639,53.42809365,557,46.57190635,1196,40,1236,0,1525,81.04918033
臺北縣,鶯歌鎮,東鶯里,1645,398,55.27777778,322,44.72222222,720,20,740,0,904,81.85840708
臺北縣,鶯歌鎮,西鶯里,1647,424,52.80199253,379,47.19800747,803,12,815,0,984,82.82520325
臺北縣,鶯歌鎮,西鶯里,1648,369,56.25,287,43.75,656,19,675,0,848,79.5990566
臺北縣,鶯歌鎮,南鶯里,1650,634,53.36700337,554,46.63299663,1188,32,1220,0,1471,82.9367777
臺北縣,鶯歌鎮,南鶯里,1651,541,51.1342155,517,48.8657845,1058,34,1092,0,1353,80.70953437
臺北縣,鶯歌鎮,南鶯里,1652,596,54.2311192,503,45.7688808,1099,31,1130,0,1381,81.82476466
臺北縣,鶯歌鎮,北鶯里,1646,493,46.90770695,558,53.09229305,1051,27,1078,0,1433,75.22679693
臺北縣,鶯歌鎮,中鶯里,1649,354,51.90615836,328,48.09384164,682,5,687,0,825,83.27272727
臺北縣,鶯歌鎮,建德里,1644,167,49.11764706,173,50.88235294,340,7,347,0,446,77.80269058
臺北縣,鶯歌鎮,同慶里,1666,635,57.62250454,467,42.37749546,1102,22,1124,0,1351,83.19763138
臺北縣,鶯歌鎮,永昌里,1667,506,50.24826216,501,49.75173784,1007,27,1034,0,1298,79.66101695
臺北縣,鶯歌鎮,永昌里,1668,531,47.24199288,593,52.75800712,1124,18,1142,0,1415,80.70671378
臺北縣,鶯歌鎮,永昌里,1669,557,50.27075812,551,49.72924188,1108,25,1133,0,1464,77.39071038
臺北縣,鶯歌鎮,永昌里,1670,491,53.42763874,428,46.57236126,919,21,940,0,1165,80.68669528
臺北縣,鶯歌鎮,永昌里,1671,357,53.125,315,46.875,672,14,686,0,875,78.4
臺北縣,鶯歌鎮,南靖里,1663,502,53.29087049,440,46.70912951,942,13,955,0,1148,83.18815331
臺北縣,鶯歌鎮,南靖里,1664,371,55.53892216,297,44.46107784,668,12,680,0,803,84.68244085
臺北縣,鶯歌鎮,南靖里,1665,339,55.39215686,273,44.60784314,612,18,630,0,785,80.25477707
臺北縣,鶯歌鎮,尖山里,1660,564,53.10734463,498,46.89265537,1062,32,1094,0,1336,81.88622754
臺北縣,鶯歌鎮,尖山里,1661,631,53.61087511,546,46.38912489,1177,26,1203,0,1462,82.28454172
臺北縣,鶯歌鎮,尖山里,1662,666,53.23741007,585,46.76258993,1251,28,1279,0,1598,80.03754693
臺北縣,鶯歌鎮,二橋里,1657,684,52.90023202,609,47.09976798,1293,30,1323,0,1708,77.45901639
臺北縣,鶯歌鎮,二橋里,1658,724,58.105939,522,41.894061,1246,40,1286,0,1590,80.88050314
臺北縣,鶯歌鎮,二橋里,1659,761,57.82674772,555,42.17325228,1316,47,1363,0,1695,80.41297935
臺北縣,鶯歌鎮,二甲里,1656,385,59.13978495,266,40.86021505,651,24,675,0,809,83.43634116
臺北縣,鶯歌鎮,東湖里,1690,97,56.7251462,74,43.2748538,171,14,185,0,226,81.85840708
臺北縣,鶯歌鎮,大湖里,1684,521,48.60074627,551,51.39925373,1072,26,1098,0,1361,80.67597355
臺北縣,鶯歌鎮,大湖里,1685,461,38.64207879,732,61.35792121,1193,26,1219,0,1518,80.3030303
臺北縣,鶯歌鎮,大湖里,1686,441,43.70664024,568,56.29335976,1009,32,1041,0,1250,83.28
臺北縣,鶯歌鎮,鳳鳴里,1678,435,49.43181818,445,50.56818182,880,41,921,0,1181,77.98475868
臺北縣,鶯歌鎮,鳳鳴里,1679,509,50.79840319,493,49.20159681,1002,34,1036,0,1266,81.83254344
臺北縣,鶯歌鎮,鳳鳴里,1680,481,54.04494382,409,45.95505618,890,13,903,0,1086,83.14917127
臺北縣,鶯歌鎮,鳳福里,1681,460,51.97740113,425,48.02259887,885,22,907,0,1079,84.05931418
臺北縣,鶯歌鎮,鳳福里,1682,450,51.90311419,417,48.09688581,867,26,893,0,1123,79.51914515
臺北縣,鶯歌鎮,鳳福里,1683,556,53.66795367,480,46.33204633,1036,36,1072,0,1336,80.23952096
臺北縣,鶯歌鎮,永吉里,1672,552,50.64220183,538,49.35779817,1090,36,1126,0,1376,81.83139535
臺北縣,鶯歌鎮,永吉里,1673,529,53.05917753,468,46.94082247,997,29,1026,1,1240,82.74193548
臺北縣,鶯歌鎮,永吉里,1674,465,53.57142857,403,46.42857143,868,10,878,0,1084,80.99630996
臺北縣,鶯歌鎮,中湖里,1687,590,45.91439689,695,54.08560311,1285,39,1324,0,1735,76.31123919
臺北縣,鶯歌鎮,中湖里,1688,536,55.54404145,429,44.45595855,965,40,1005,0,1256,80.01592357
臺北縣,鶯歌鎮,中湖里,1689,581,51.55279503,546,48.44720497,1127,44,1171,0,1420,82.46478873
臺北縣,鶯歌鎮,鳳祥里,1675,501,50.81135903,485,49.18864097,986,43,1029,0,1287,79.95337995
臺北縣,鶯歌鎮,鳳祥里,1676,472,54.00457666,402,45.99542334,874,14,888,0,1143,77.69028871
臺北縣,鶯歌鎮,鳳祥里,1677,403,50.31210986,398,49.68789014,801,17,818,0,1059,77.24268178
臺北縣,鶯歌鎮,建國里,1653,613,53.4904014,533,46.5095986,1146,28,1174,0,1489,78.84486232
臺北縣,鶯歌鎮,建國里,1654,582,51.32275132,552,48.67724868,1134,27,1161,0,1497,77.55511022
臺北縣,鶯歌鎮,建國里,1655,493,45.86046512,582,54.13953488,1075,16,1091,2,1412,77.26628895
臺北縣,三峽鎮,三峽里,1691,135,47.70318021,148,52.29681979,283,9,292,0,351,83.19088319
臺北縣,三峽鎮,秀川里,1692,163,50.7788162,158,49.2211838,321,10,331,0,402,82.33830846
臺北縣,三峽鎮,八張里,1693,536,52.34375,488,47.65625,1024,33,1057,0,1287,82.12898213
臺北縣,三峽鎮,八張里,1694,518,48.23091248,556,51.76908752,1074,24,1098,0,1339,82.00149365
臺北縣,三峽鎮,中埔里,1695,550,46.92832765,622,53.07167235,1172,17,1189,0,1483,80.1753203
臺北縣,三峽鎮,弘道里,1696,464,63.1292517,271,36.8707483,735,32,767,0,930,82.47311828
臺北縣,三峽鎮,永館里,1697,452,46.02851324,530,53.97148676,982,29,1011,0,1277,79.16992952
臺北縣,三峽鎮,永館里,1698,537,53.115727,474,46.884273,1011,24,1035,0,1250,82.8
臺北縣,三峽鎮,永館里,1699,405,44.90022173,497,55.09977827,902,29,931,0,1132,82.24381625
臺北縣,三峽鎮,永館里,1700,569,52.97951583,505,47.02048417,1074,28,1102,0,1373,80.26219956
臺北縣,三峽鎮,礁溪里,1710,441,50.22779043,437,49.77220957,878,20,898,0,1119,80.25022341
臺北縣,三峽鎮,礁溪里,1711,306,42.32365145,417,57.67634855,723,17,740,0,898,82.40534521
臺北縣,三峽鎮,礁溪里,1712,422,47.25643897,471,52.74356103,893,14,907,0,1125,80.62222222
臺北縣,三峽鎮,鳶山里,1701,439,50.28636884,434,49.71363116,873,26,899,1,1076,83.55018587
臺北縣,三峽鎮,鳶山里,1702,393,49.55863808,400,50.44136192,793,31,824,0,1035,79.61352657
臺北縣,三峽鎮,鳶山里,1703,424,52.21674877,388,47.78325123,812,20,832,0,1031,80.69835112
臺北縣,三峽鎮,鳶山里,1704,435,48.87640449,455,51.12359551,890,28,918,0,1172,78.32764505
臺北縣,三峽鎮,鳶山里,1705,541,49.45155393,553,50.54844607,1094,29,1123,0,1433,78.36706211
臺北縣,三峽鎮,龍埔里,1706,495,45.70637119,588,54.29362881,1083,22,1105,0,1377,80.24691358
臺北縣,三峽鎮,龍埔里,1707,463,41.71171171,647,58.28828829,1110,17,1127,0,1361,82.80675974
臺北縣,三峽鎮,龍埔里,1708,457,47.95383001,496,52.04616999,953,26,979,0,1236,79.20711974
臺北縣,三峽鎮,龍埔里,1709,683,61.25560538,432,38.74439462,1115,14,1129,0,1429,79.00629811
臺北縣,三峽鎮,大埔里,1723,467,52.23713647,427,47.76286353,894,44,938,0,1220,76.8852459
臺北縣,三峽鎮,大埔里,1724,385,48.54981084,408,51.45018916,793,23,816,0,1028,79.37743191
臺北縣,三峽鎮,大埔里,1725,210,28.03738318,539,71.96261682,749,31,780,0,932,83.69098712
臺北縣,三峽鎮,嘉添里,1726,451,48.02981896,488,51.97018104,939,10,949,0,1182,80.28764805
臺北縣,三峽鎮,嘉添里,1727,241,24.64212679,737,75.35787321,978,63,1041,0,1409,73.88218595
臺北縣,三峽鎮,添福里,1728,426,55.32467532,344,44.67532468,770,38,808,0,988,81.78137652
臺北縣,三峽鎮,金圳里,1729,179,54.57317073,149,45.42682927,328,32,360,0,465,77.41935484
臺北縣,三峽鎮,五寮里,1730,331,49.10979228,343,50.89020772,674,43,717,0,881,81.38479001
臺北縣,三峽鎮,插角里,1731,345,58.57385399,244,41.42614601,589,51,640,0,811,78.91491985
臺北縣,三峽鎮,有木里,1732,338,60.5734767,220,39.4265233,558,43,601,0,793,75.78814628
臺北縣,三峽鎮,溪北里,1736,287,57.86290323,209,42.13709677,496,5,501,0,618,81.06796117
臺北縣,三峽鎮,溪北里,1737,633,61.69590643,393,38.30409357,1026,7,1033,0,1244,83.03858521
臺北縣,三峽鎮,溪南里,1735,563,56.98380567,425,43.01619433,988,38,1026,0,1254,81.81818182
臺北縣,三峽鎮,溪東里,1738,415,52.00501253,383,47.99498747,798,36,834,0,1044,79.88505747
臺北縣,三峽鎮,溪東里,1739,502,50.40160643,494,49.59839357,996,32,1028,0,1326,77.52639517
臺北縣,三峽鎮,成福里,1740,422,61.78623719,261,38.21376281,683,17,700,0,830,84.3373494
臺北縣,三峽鎮,安坑里,1743,598,64.92942454,323,35.07057546,921,59,980,0,1275,76.8627451
臺北縣,三峽鎮,竹崙里,1741,434,68.56240126,199,31.43759874,633,51,684,0,860,79.53488372
臺北縣,三峽鎮,竹崙里,1742,394,56.12535613,308,43.87464387,702,28,730,0,891,81.93041526
臺北縣,三峽鎮,介壽里,1717,484,52.60869565,436,47.39130435,920,25,945,0,1268,74.52681388
臺北縣,三峽鎮,介壽里,1718,474,50.42553191,466,49.57446809,940,19,959,0,1213,79.06018137
臺北縣,三峽鎮,介壽里,1719,492,49.54682779,501,50.45317221,993,16,1009,0,1263,79.88915281
臺北縣,三峽鎮,安溪里,1713,504,49.9009901,506,50.0990099,1010,34,1044,0,1297,80.49344641
臺北縣,三峽鎮,安溪里,1714,471,43.53049908,611,56.46950092,1082,33,1115,0,1443,77.26957727
臺北縣,三峽鎮,安溪里,1715,453,42.37605239,616,57.62394761,1069,16,1085,0,1305,83.14176245
臺北縣,三峽鎮,安溪里,1716,324,36.04004449,575,63.95995551,899,8,907,0,1123,80.76580588
臺北縣,三峽鎮,中正里,1720,416,47.16553288,466,52.83446712,882,26,908,0,1154,78.68284229
臺北縣,三峽鎮,中正里,1721,445,48.68708972,469,51.31291028,914,28,942,0,1145,82.27074236
臺北縣,三峽鎮,中正里,1722,521,58.60517435,368,41.39482565,889,27,916,0,1121,81.71275647
臺北縣,三峽鎮,二鬮里,1733,321,35.70634038,578,64.29365962,899,28,927,0,1187,78.09604044
臺北縣,三峽鎮,二鬮里,1734,454,44.86166008,558,55.13833992,1012,16,1028,0,1264,81.32911392
臺北縣,淡水鎮,中和里,1744,268,60.36036036,176,39.63963964,444,28,472,0,577,81.80242634
臺北縣,淡水鎮,屯山里,1745,403,55.20547945,327,44.79452055,730,41,771,0,959,80.39624609
臺北縣,淡水鎮,賢孝里,1746,451,43.91431353,576,56.08568647,1027,48,1075,0,1338,80.34379671
臺北縣,淡水鎮,興仁里,1747,567,52.54865616,512,47.45134384,1079,50,1129,0,1397,80.81603436
臺北縣,淡水鎮,蕃薯里,1748,247,43.87211368,316,56.12788632,563,21,584,0,791,73.83059418
臺北縣,淡水鎮,義山里,1750,419,51.85643564,389,48.14356436,808,38,846,1,1086,77.90055249
臺北縣,淡水鎮,義山里,1751,379,46.10705596,443,53.89294404,822,34,856,1,1092,78.38827839
臺北縣,淡水鎮,忠山里,1749,337,50.90634441,325,49.09365559,662,28,690,0,820,84.14634146
臺北縣,淡水鎮,崁頂里,1770,497,47.37845567,552,52.62154433,1049,14,1063,0,1263,84.16468725
臺北縣,淡水鎮,埤島里,1771,493,59.61305925,334,40.38694075,827,31,858,0,1071,80.11204482
臺北縣,淡水鎮,新興里,1778,639,49.49651433,652,50.50348567,1291,38,1329,0,1614,82.34200743
臺北縣,淡水鎮,新興里,1779,688,51.6904583,643,48.3095417,1331,41,1372,0,1744,78.66972477
臺北縣,淡水鎮,新興里,1780,537,42.99439552,712,57.00560448,1249,26,1275,0,1592,80.0879397
臺北縣,淡水鎮,新興里,1781,479,41.54379879,674,58.45620121,1153,20,1173,0,1500,78.2
臺北縣,淡水鎮,新興里,1782,510,40.12588513,761,59.87411487,1271,30,1301,0,1703,76.39459777
臺北縣,淡水鎮,新興里,1783,455,39.05579399,710,60.94420601,1165,25,1190,0,1478,80.51420839
臺北縣,淡水鎮,新興里,1784,493,44.6557971,611,55.3442029,1104,30,1134,0,1429,79.35619314
臺北縣,淡水鎮,新興里,1785,472,40.2044293,702,59.7955707,1174,19,1193,0,1479,80.66260987
臺北縣,淡水鎮,新興里,1786,598,46.14197531,698,53.85802469,1296,14,1310,0,1642,79.78075518
臺北縣,淡水鎮,水碓里,1772,582,51.77935943,542,48.22064057,1124,29,1153,1,1424,80.96910112
臺北縣,淡水鎮,水碓里,1773,554,47.35042735,616,52.64957265,1170,40,1210,0,1474,82.08955224
臺北縣,淡水鎮,水碓里,1774,516,46.78150499,587,53.21849501,1103,10,1113,0,1374,81.00436681
臺北縣,淡水鎮,水碓里,1775,496,38.81064163,782,61.18935837,1278,16,1294,0,1594,81.17942284
臺北縣,淡水鎮,水碓里,1776,527,38.83566691,830,61.16433309,1357,21,1378,0,1695,81.2979351
臺北縣,淡水鎮,水碓里,1777,518,43.02325581,686,56.97674419,1204,21,1225,0,1514,80.91149273
臺北縣,淡水鎮,北投里,1787,648,49.9614495,649,50.0385505,1297,45,1342,0,1675,80.11940299
臺北縣,淡水鎮,水源里,1752,403,56.76056338,307,43.23943662,710,22,732,0,950,77.05263158
臺北縣,淡水鎮,水源里,1753,438,64.50662739,241,35.49337261,679,42,721,0,888,81.19369369
臺北縣,淡水鎮,忠寮里,1754,465,61.67108753,289,38.32891247,754,56,810,0,999,81.08108108
臺北縣,淡水鎮,樹興里,1755,385,65.6996587,201,34.3003413,586,30,616,0,780,78.97435897
臺北縣,淡水鎮,坪頂里,1756,405,49.09090909,420,50.90909091,825,30,855,0,1047,81.66189112
臺北縣,淡水鎮,福德里,1757,641,40.93231162,925,59.06768838,1566,22,1588,1,1931,82.23718281
臺北縣,淡水鎮,福德里,1758,373,33.72513562,733,66.27486438,1106,19,1125,0,1399,80.41458184
臺北縣,淡水鎮,福德里,1759,401,35.29929577,735,64.70070423,1136,34,1170,0,1430,81.81818182
臺北縣,淡水鎮,竹圍里,1760,538,40.51204819,790,59.48795181,1328,31,1359,0,1655,82.11480363
臺北縣,淡水鎮,竹圍里,1761,596,43.7913299,765,56.2086701,1361,39,1400,0,1737,80.59873345
臺北縣,淡水鎮,竹圍里,1762,579,43.43585896,754,56.56414104,1333,34,1367,0,1699,80.45909358
臺北縣,淡水鎮,竹圍里,1763,575,43.16816817,757,56.83183183,1332,31,1363,0,1660,82.10843373
臺北縣,淡水鎮,民生里,1764,538,45.0209205,657,54.9790795,1195,10,1205,0,1517,79.43309163
臺北縣,淡水鎮,民生里,1765,475,44.06307978,603,55.93692022,1078,35,1113,0,1417,78.54622442
臺北縣,淡水鎮,民生里,1766,492,47.39884393,546,52.60115607,1038,27,1065,0,1307,81.48431523
臺北縣,淡水鎮,八勢里,1767,644,46.13180516,752,53.86819484,1396,40,1436,0,1784,80.49327354
臺北縣,淡水鎮,竿蓁里,1768,692,43.00807955,917,56.99192045,1609,23,1632,1,2076,78.61271676
臺北縣,淡水鎮,竿蓁里,1769,528,47.95640327,573,52.04359673,1101,28,1129,0,1381,81.75235337
臺北縣,淡水鎮,鄧公里,1788,590,44.6969697,730,55.3030303,1320,27,1347,0,1655,81.3897281
臺北縣,淡水鎮,鄧公里,1789,609,41.48501362,859,58.51498638,1468,36,1504,0,1837,81.8726184
臺北縣,淡水鎮,鄧公里,1790,553,41.26865672,787,58.73134328,1340,22,1362,0,1670,81.55688623
臺北縣,淡水鎮,鄧公里,1791,602,44.55958549,749,55.44041451,1351,25,1376,0,1741,79.03503733
臺北縣,淡水鎮,鄧公里,1792,588,46.22641509,684,53.77358491,1272,45,1317,0,1628,80.8968059
臺北縣,淡水鎮,鄧公里,1793,659,48.0671043,712,51.9328957,1371,41,1412,0,1742,81.05625718
臺北縣,淡水鎮,中興里,1794,361,41.97674419,499,58.02325581,860,27,887,0,1112,79.76618705
臺北縣,淡水鎮,中興里,1795,514,50.1953125,510,49.8046875,1024,20,1044,0,1300,80.30769231
臺北縣,淡水鎮,中興里,1796,433,47.06521739,487,52.93478261,920,28,948,0,1144,82.86713287
臺北縣,淡水鎮,長庚里,1797,620,52.58693808,559,47.41306192,1179,19,1198,0,1474,81.27544098
臺北縣,淡水鎮,清文里,1798,406,51.58831004,381,48.41168996,787,27,814,0,1056,77.08333333
臺北縣,淡水鎮,草東里,1799,408,61.72465961,253,38.27534039,661,33,694,0,811,85.57336621
臺北縣,淡水鎮,協元里,1800,517,47.60589319,569,52.39410681,1086,34,1120,0,1375,81.45454545
臺北縣,淡水鎮,永吉里,1801,291,48.90756303,304,51.09243697,595,18,613,0,739,82.94993234
臺北縣,淡水鎮,民安里,1802,349,59.25297114,240,40.74702886,589,8,597,0,736,81.11413043
臺北縣,淡水鎮,新生里,1803,174,47.2826087,194,52.7173913,368,7,375,0,638,58.77742947
臺北縣,淡水鎮,文化里,1804,505,43.4595525,657,56.5404475,1162,28,1190,0,1498,79.43925234
臺北縣,淡水鎮,油車里,1805,391,41.28827878,556,58.71172122,947,30,977,0,1201,81.34887594
臺北縣,淡水鎮,油車里,1806,402,39.5280236,615,60.4719764,1017,18,1035,0,1304,79.37116564
臺北縣,淡水鎮,油車里,1807,452,44.35721295,567,55.64278705,1019,30,1049,0,1251,83.85291767
臺北縣,淡水鎮,沙崙里,1808,610,45.59043348,728,54.40956652,1338,35,1373,0,1686,81.43534994
臺北縣,淡水鎮,沙崙里,1809,573,44.3841983,718,55.6158017,1291,25,1316,0,1668,78.89688249
臺北縣,淡水鎮,沙崙里,1810,607,48.28957836,650,51.71042164,1257,15,1272,0,1593,79.84934087
臺北縣,瑞芳鎮,龍潭里,1811,263,42.97385621,349,57.02614379,612,15,627,0,767,81.74706649
臺北縣,瑞芳鎮,龍興里,1812,332,45.85635359,392,54.14364641,724,17,741,0,924,80.19480519
臺北縣,瑞芳鎮,龍興里,1813,230,38.33333333,370,61.66666667,600,18,618,0,762,81.1023622
臺北縣,瑞芳鎮,龍鎮里,1814,433,45.86864407,511,54.13135593,944,42,986,0,1298,75.96302003
臺北縣,瑞芳鎮,龍川里,1816,281,43.63354037,363,56.36645963,644,20,664,0,845,78.57988166
臺北縣,瑞芳鎮,龍川里,1817,258,47.08029197,290,52.91970803,548,25,573,0,751,76.29826897
臺北縣,瑞芳鎮,龍山里,1818,400,42.19409283,548,57.80590717,948,30,978,0,1292,75.69659443
臺北縣,瑞芳鎮,龍安里,1815,190,41.12554113,272,58.87445887,462,19,481,0,634,75.86750789
臺北縣,瑞芳鎮,爪峰里,1819,575,48.44144903,612,51.55855097,1187,54,1241,0,1552,79.96134021
臺北縣,瑞芳鎮,爪峰里,1820,370,45.2876377,447,54.7123623,817,41,858,0,1072,80.03731343
臺北縣,瑞芳鎮,爪峰里,1821,342,45.41832669,411,54.58167331,753,33,786,0,980,80.20408163
臺北縣,瑞芳鎮,柑坪里,1826,426,51.69902913,398,48.30097087,824,52,876,0,1112,78.77697842
臺北縣,瑞芳鎮,東和里,1824,413,50.48899756,405,49.51100244,818,13,831,0,1085,76.58986175
臺北縣,瑞芳鎮,東和里,1825,239,43.77289377,307,56.22710623,546,15,561,0,735,76.32653061
臺北縣,瑞芳鎮,上天里,1836,226,45.29058116,273,54.70941884,499,23,522,0,650,80.30769231
臺北縣,瑞芳鎮,上天里,1837,249,54.60526316,207,45.39473684,456,26,482,0,620,77.74193548
臺北縣,瑞芳鎮,吉慶里,1831,282,43.85692068,361,56.14307932,643,22,665,0,843,78.88493476
臺北縣,瑞芳鎮,吉慶里,1832,260,46.34581105,301,53.65418895,561,28,589,0,797,73.902133
臺北縣,瑞芳鎮,吉安里,1833,323,45.81560284,382,54.18439716,705,33,738,0,940,78.5106383
臺北縣,瑞芳鎮,吉安里,1834,278,43.2348367,365,56.7651633,643,16,659,0,832,79.20673077
臺北縣,瑞芳鎮,吉安里,1835,364,45.61403509,434,54.38596491,798,13,811,0,1031,78.6614937
臺北縣,瑞芳鎮,傑魚里,1838,378,50.94339623,364,49.05660377,742,14,756,0,966,78.26086957
臺北縣,瑞芳鎮,傑魚里,1839,306,50,306,50,612,29,641,0,853,75.14654162
臺北縣,瑞芳鎮,侯硐里,1828,175,49.85754986,176,50.14245014,351,23,374,0,504,74.20634921
臺北縣,瑞芳鎮,光復里,1829,129,51.80722892,120,48.19277108,249,17,266,0,347,76.65706052
臺北縣,瑞芳鎮,弓橋里,1827,106,51.45631068,100,48.54368932,206,9,215,0,298,72.14765101
臺北縣,瑞芳鎮,碩仁里,1830,40,50,40,50,80,3,83,0,118,70.33898305
臺北縣,瑞芳鎮,基山里,1840,199,52.23097113,182,47.76902887,381,20,401,0,557,71.99281867
臺北縣,瑞芳鎮,永慶里,1841,219,57.18015666,164,42.81984334,383,19,402,0,558,72.04301075
臺北縣,瑞芳鎮,崇文里,1842,137,49.63768116,139,50.36231884,276,8,284,0,420,67.61904762
臺北縣,瑞芳鎮,福住里,1843,80,47.33727811,89,52.66272189,169,11,180,0,249,72.28915663
臺北縣,瑞芳鎮,頌德里,1844,136,48.0565371,147,51.9434629,283,6,289,0,397,72.79596977
臺北縣,瑞芳鎮,新山里,1847,160,47.76119403,175,52.23880597,335,10,345,0,447,77.18120805
臺北縣,瑞芳鎮,瓜山里,1845,79,43.16939891,104,56.83060109,183,7,190,0,264,71.96969697
臺北縣,瑞芳鎮,銅山里,1846,82,38.67924528,130,61.32075472,212,7,219,0,287,76.30662021
臺北縣,瑞芳鎮,石山里,1848,119,38.51132686,190,61.48867314,309,14,323,0,452,71.46017699
臺北縣,瑞芳鎮,濂新里,1850,121,47.82608696,132,52.17391304,253,10,263,0,338,77.81065089
臺北縣,瑞芳鎮,濂洞里,1849,159,36.97674419,271,63.02325581,430,21,451,0,612,73.69281046
臺北縣,瑞芳鎮,海濱里,1853,293,40.0273224,439,59.9726776,732,32,764,0,1004,76.09561753
臺北縣,瑞芳鎮,瑞濱里,1854,372,48.81889764,390,51.18110236,762,7,769,0,1037,74.15621986
臺北縣,瑞芳鎮,瑞濱里,1855,229,34.43609023,436,65.56390977,665,28,693,0,900,77
臺北縣,瑞芳鎮,深澳里,1856,287,35.21472393,528,64.78527607,815,33,848,0,1184,71.62162162
臺北縣,瑞芳鎮,南雅里,1851,92,48.67724868,97,51.32275132,189,6,195,0,258,75.58139535
臺北縣,瑞芳鎮,鼻頭里,1852,229,44.12331407,290,55.87668593,519,22,541,0,767,70.5345502
臺北縣,瑞芳鎮,新峰里,1822,332,43.28552803,435,56.71447197,767,41,808,0,1052,76.80608365
臺北縣,瑞芳鎮,新峰里,1823,390,36.21169916,687,63.78830084,1077,40,1117,0,1560,71.6025641
臺北縣,五股鄉,興珍村,1857,618,62.9969419,363,37.0030581,981,19,1000,0,1256,79.61783439
臺北縣,五股鄉,興珍村,1858,597,54.87132353,491,45.12867647,1088,24,1112,0,1377,80.75526507
臺北縣,五股鄉,興珍村,1859,662,67.00404858,326,32.99595142,988,26,1014,0,1197,84.71177945
臺北縣,五股鄉,更寮村,1860,607,68.58757062,278,31.41242938,885,42,927,0,1137,81.53034301
臺北縣,五股鄉,集福村,1861,778,50.91623037,750,49.08376963,1528,34,1562,0,1945,80.30848329
臺北縣,五股鄉,集福村,1862,240,59.70149254,162,40.29850746,402,13,415,0,520,79.80769231
臺北縣,五股鄉,觀音村,1865,649,66.90721649,321,33.09278351,970,50,1020,0,1281,79.62529274
臺北縣,五股鄉,成州村,1866,675,58.59375,477,41.40625,1152,26,1178,0,1443,81.63548164
臺北縣,五股鄉,成州村,1867,550,59.13978495,380,40.86021505,930,24,954,0,1191,80.10075567
臺北縣,五股鄉,成州村,1868,680,58.62068966,480,41.37931034,1160,27,1187,0,1501,79.08061292
臺北縣,五股鄉,成功村,1871,676,59.14260717,467,40.85739283,1143,29,1172,0,1514,77.41083223
臺北縣,五股鄉,成功村,1872,690,56.65024631,528,43.34975369,1218,21,1239,0,1599,77.48592871
臺北縣,五股鄉,五龍村,1875,628,68.78422782,285,31.21577218,913,45,958,0,1179,81.2553011
臺北縣,五股鄉,五股村,1880,606,51.31244708,575,48.68755292,1181,25,1206,0,1610,74.9068323
臺北縣,五股鄉,五股村,1881,716,54.11942555,607,45.88057445,1323,16,1339,0,1610,83.16770186
臺北縣,五股鄉,五福村,1876,460,42.04753199,634,57.95246801,1094,23,1117,0,1391,80.30194105
臺北縣,五股鄉,五福村,1877,556,46.41068447,642,53.58931553,1198,29,1227,0,1505,81.5282392
臺北縣,五股鄉,德音村,1884,427,44.06604747,542,55.93395253,969,19,988,0,1206,81.92371476
臺北縣,五股鄉,德音村,1885,436,44.85596708,536,55.14403292,972,17,989,0,1210,81.73553719
臺北縣,五股鄉,德音村,1886,502,50.70707071,488,49.29292929,990,26,1016,0,1218,83.41543514
臺北縣,五股鄉,陸一村,1881,716,54.11942555,607,45.88057445,1323,16,1339,0,1610,83.16770186
臺北縣,五股鄉,貿商村,1894,43,3.023909986,1379,96.97609001,1422,31,1453,0,1646,88.2746051
臺北縣,五股鄉,德泰村,1891,505,45.78422484,598,54.21577516,1103,13,1116,0,1367,81.63862473
臺北縣,五股鄉,德泰村,1892,483,48.39679359,515,51.60320641,998,20,1018,0,1291,78.85360186
臺北縣,五股鄉,德泰村,1893,762,47.50623441,842,52.49376559,1604,39,1643,0,2114,77.71996216
臺北縣,五股鄉,成德村,1869,530,59.68468468,358,40.31531532,888,27,915,0,1153,79.35819601
臺北縣,五股鄉,成德村,1870,576,64.93799324,311,35.06200676,887,29,916,0,1132,80.91872792
臺北縣,五股鄉,六福村,1878,363,34.60438513,686,65.39561487,1049,14,1063,0,1298,81.89522342
臺北縣,五股鄉,六福村,1879,460,42.12454212,632,57.87545788,1092,15,1107,0,1314,84.24657534
臺北縣,五股鄉,集賢村,1863,646,56.66666667,494,43.33333333,1140,29,1169,0,1442,81.06796117
臺北縣,五股鄉,集賢村,1864,552,53.43659245,481,46.56340755,1033,22,1055,0,1300,81.15384615
臺北縣,五股鄉,民義村,1882,487,43.21206744,640,56.78793256,1127,25,1152,0,1397,82.46241947
臺北縣,五股鄉,民義村,1883,449,49.23245614,463,50.76754386,912,28,940,0,1176,79.93197279
臺北縣,五股鄉,成泰村,1873,657,60.38602941,431,39.61397059,1088,37,1125,0,1386,81.16883117
臺北縣,五股鄉,成泰村,1874,599,60.68895643,388,39.31104357,987,38,1025,0,1255,81.67330677
臺北縣,五股鄉,水碓村,1887,548,54.52736318,457,45.47263682,1005,24,1029,0,1246,82.58426966
臺北縣,五股鄉,水碓村,1888,524,49.85727878,527,50.14272122,1051,17,1068,0,1337,79.88032909
臺北縣,五股鄉,水碓村,1889,523,51.6798419,489,48.3201581,1012,30,1042,0,1277,81.59749413
臺北縣,五股鄉,水碓村,1890,482,46.61508704,552,53.38491296,1034,30,1064,0,1283,82.93063133
臺北縣,泰山鄉,大科村,1895,315,64.94845361,170,35.05154639,485,23,508,0,619,82.06785137
臺北縣,泰山鄉,大科村,1896,108,45.18828452,131,54.81171548,239,1,240,0,281,85.40925267
臺北縣,泰山鄉,黎明村,1897,547,50.41474654,538,49.58525346,1085,18,1103,0,1309,84.26279603
臺北縣,泰山鄉,黎明村,1898,469,53.41685649,409,46.58314351,878,13,891,0,1048,85.01908397
臺北縣,泰山鄉,黎明村,1899,102,24.69733656,311,75.30266344,413,8,421,0,486,86.6255144
臺北縣,泰山鄉,山腳村,1900,457,44.67253177,566,55.32746823,1023,20,1043,0,1281,81.42076503
臺北縣,泰山鄉,山腳村,1901,452,47.83068783,493,52.16931217,945,20,965,0,1206,80.01658375
臺北縣,泰山鄉,山腳村,1902,346,46.5679677,397,53.4320323,743,18,761,0,961,79.18834547
臺北縣,泰山鄉,山腳村,1903,384,48.18067754,413,51.81932246,797,11,808,0,982,82.28105906
臺北縣,泰山鄉,福泰村,1904,370,44.47115385,462,55.52884615,832,23,855,0,1036,82.52895753
臺北縣,泰山鄉,福泰村,1905,435,51.29716981,413,48.70283019,848,16,864,0,1042,82.91746641
臺北縣,泰山鄉,福泰村,1906,504,48.60173578,533,51.39826422,1037,25,1062,0,1253,84.7565842
臺北縣,泰山鄉,福泰村,1907,549,50.88044486,530,49.11955514,1079,21,1100,0,1301,84.55034589
臺北縣,泰山鄉,楓樹村,1908,374,49.14586071,387,50.85413929,761,12,773,0,936,82.58547009
臺北縣,泰山鄉,楓樹村,1909,296,47.74193548,324,52.25806452,620,24,644,0,804,80.09950249
臺北縣,泰山鄉,楓樹村,1910,400,55.02063274,327,44.97936726,727,9,736,0,880,83.63636364
臺北縣,泰山鄉,同榮村,1911,396,39.01477833,619,60.98522167,1015,16,1031,0,1231,83.7530463
臺北縣,泰山鄉,同榮村,1912,394,45.81395349,466,54.18604651,860,16,876,0,1060,82.64150943
臺北縣,泰山鄉,同榮村,1913,355,54.36447167,298,45.63552833,653,22,675,0,828,81.52173913
臺北縣,泰山鄉,義學村,1916,411,52.96391753,365,47.03608247,776,8,784,0,962,81.4968815
臺北縣,泰山鄉,義學村,1917,402,53.5286285,349,46.4713715,751,21,772,0,974,79.26078029
臺北縣,泰山鄉,義學村,1918,516,51.44566301,487,48.55433699,1003,25,1028,0,1260,81.58730159
臺北縣,泰山鄉,明志村,1922,460,53.6756126,397,46.3243874,857,21,878,1,1082,81.14602588
臺北縣,泰山鄉,明志村,1923,375,49.27726675,386,50.72273325,761,4,765,0,944,81.03813559
臺北縣,泰山鄉,明志村,1924,341,42.09876543,469,57.90123457,810,15,825,0,981,84.09785933
臺北縣,泰山鄉,貴子村,1929,427,51.07655502,409,48.92344498,836,20,856,0,1032,82.94573643
臺北縣,泰山鄉,貴子村,1930,423,51.08695652,405,48.91304348,828,21,849,0,1039,81.71318576
臺北縣,泰山鄉,貴子村,1931,417,48.26388889,447,51.73611111,864,11,875,0,1051,83.25404377
臺北縣,泰山鄉,貴和村,1934,479,42.57777778,646,57.42222222,1125,18,1143,0,1377,83.00653595
臺北縣,泰山鄉,貴和村,1935,574,53.54477612,498,46.45522388,1072,19,1091,0,1323,82.46409675
臺北縣,泰山鄉,貴和村,1936,478,51.50862069,450,48.49137931,928,25,953,0,1195,79.74895397
臺北縣,泰山鄉,同興村,1914,673,51.3740458,637,48.6259542,1310,34,1344,0,1679,80.04764741
臺北縣,泰山鄉,同興村,1915,670,52.46671887,607,47.53328113,1277,26,1303,0,1552,83.95618557
臺北縣,泰山鄉,義仁村,1919,679,58.13356164,489,41.86643836,1168,20,1188,0,1447,82.10089841
臺北縣,泰山鄉,義仁村,1920,636,52.38879736,578,47.61120264,1214,29,1243,0,1451,85.66505858
臺北縣,泰山鄉,義仁村,1921,617,56.91881919,467,43.08118081,1084,30,1114,0,1326,84.01206637
臺北縣,泰山鄉,泰友村,1925,357,47.03557312,402,52.96442688,759,13,772,0,929,83.10010764
臺北縣,泰山鄉,泰友村,1926,359,51.35908441,340,48.64091559,699,14,713,0,867,82.23760092
臺北縣,泰山鄉,新明村,1927,576,50.70422535,560,49.29577465,1136,21,1157,0,1381,83.77986966
臺北縣,泰山鄉,新明村,1928,562,52.23048327,514,47.76951673,1076,22,1098,0,1358,80.85419735
臺北縣,泰山鄉,貴賢村,1932,504,43.22469983,662,56.77530017,1166,13,1179,0,1397,84.39513243
臺北縣,泰山鄉,貴賢村,1933,655,52.31629393,597,47.68370607,1252,32,1284,0,1575,81.52380952
臺北縣,林口鄉,東林村,1937,515,57.93025872,374,42.06974128,889,30,919,0,1122,81.90730838
臺北縣,林口鄉,東林村,1938,404,50.37406484,398,49.62593516,802,21,823,0,1037,79.3635487
臺北縣,林口鄉,東林村,1939,511,48.66666667,539,51.33333333,1050,30,1080,0,1323,81.63265306
臺北縣,林口鄉,林口村,1940,365,47.34111543,406,52.65888457,771,18,789,0,1087,72.5850966
臺北縣,林口鄉,林口村,1941,481,46.33911368,557,53.66088632,1038,28,1066,0,1315,81.06463878
臺北縣,林口鄉,林口村,1942,442,47.0713525,497,52.9286475,939,19,958,0,1148,83.44947735
臺北縣,林口鄉,西林村,1943,418,47.60820046,460,52.39179954,878,22,900,1,1090,82.56880734
臺北縣,林口鄉,西林村,1944,517,49.28503337,532,50.71496663,1049,42,1091,0,1346,81.05497771
臺北縣,林口鄉,西林村,1945,324,46.61870504,371,53.38129496,695,21,716,0,863,82.96639629
臺北縣,林口鄉,菁湖村,1946,680,50,680,50,1360,27,1387,1,1675,82.80597015
臺北縣,林口鄉,菁湖村,1947,643,51.23505976,612,48.76494024,1255,47,1302,2,1586,82.09331652
臺北縣,林口鄉,中湖村,1948,571,53.76647834,491,46.23352166,1062,37,1099,0,1358,80.92783505
臺北縣,林口鄉,中湖村,1949,407,49.93865031,408,50.06134969,815,26,841,1,1005,83.68159204
臺北縣,林口鄉,湖北村,1950,577,66.16972477,295,33.83027523,872,42,914,0,1098,83.24225865
臺北縣,林口鄉,湖南村,1951,629,59.45179584,429,40.54820416,1058,18,1076,0,1292,83.28173375
臺北縣,林口鄉,南勢村,1952,365,61.86440678,225,38.13559322,590,26,616,0,774,79.58656331
臺北縣,林口鄉,東勢村,1959,472,46.50246305,543,53.49753695,1015,17,1032,0,1274,81.00470958
臺北縣,林口鄉,東勢村,1960,420,41.87437687,583,58.12562313,1003,22,1025,0,1268,80.83596215
臺北縣,林口鄉,東勢村,1961,476,40.30482642,705,59.69517358,1181,31,1212,0,1532,79.11227154
臺北縣,林口鄉,頂福村,1964,480,67.89250354,227,32.10749646,707,57,764,3,963,79.33541018
臺北縣,林口鄉,下福村,1965,378,51.85185185,351,48.14814815,729,44,773,0,931,83.02900107
臺北縣,林口鄉,嘉寶村,1966,329,63.02681992,193,36.97318008,522,39,561,0,653,85.91117917
臺北縣,林口鄉,瑞平村,1967,213,63.58208955,122,36.41791045,335,27,362,0,453,79.91169978
臺北縣,林口鄉,太平村,1968,429,67.13615023,210,32.86384977,639,33,672,0,809,83.06551298
臺北縣,林口鄉,仁愛村,1953,386,36.1423221,682,63.8576779,1068,16,1084,0,1304,83.12883436
臺北縣,林口鄉,仁愛村,1954,280,32.71028037,576,67.28971963,856,19,875,0,1088,80.42279412
臺北縣,林口鄉,仁愛村,1955,319,40.53367217,468,59.46632783,787,8,795,0,950,83.68421053
臺北縣,林口鄉,麗林村,1956,342,36.30573248,600,63.69426752,942,10,952,0,1197,79.53216374
臺北縣,林口鄉,麗林村,1957,448,38.0952381,728,61.9047619,1176,24,1200,0,1475,81.3559322
臺北縣,林口鄉,麗林村,1958,333,32.80788177,682,67.19211823,1015,11,1026,0,1226,83.6867863
臺北縣,林口鄉,麗園村,1962,448,42.66666667,602,57.33333333,1050,27,1077,0,1341,80.31319911
臺北縣,林口鄉,麗園村,1963,487,42.23764094,666,57.76235906,1153,19,1172,0,1433,81.78646197
臺北縣,深坑鄉,深坑村,1976,461,49.14712154,477,50.85287846,938,32,970,4,1196,81.10367893
臺北縣,深坑鄉,深坑村,1977,427,43.08779011,564,56.91220989,991,30,1021,0,1254,81.41945774
臺北縣,深坑鄉,萬順村,1969,366,50.90403338,353,49.09596662,719,30,749,0,932,80.36480687
臺北縣,深坑鄉,萬順村,1970,377,48.08673469,407,51.91326531,784,19,803,0,995,80.70351759
臺北縣,深坑鄉,土庫村,1973,379,44.53584019,472,55.46415981,851,25,876,0,1065,82.25352113
臺北縣,深坑鄉,土庫村,1974,360,45.91836735,424,54.08163265,784,23,807,0,1018,79.27308448
臺北縣,深坑鄉,昇高村,1981,495,40.74074074,720,59.25925926,1215,37,1252,0,1587,78.89098929
臺北縣,深坑鄉,阿柔村,1982,211,57.02702703,159,42.97297297,370,18,388,0,467,83.08351178
臺北縣,深坑鄉,埔新村,1978,388,39.63227783,591,60.36772217,979,17,996,0,1244,80.06430868
臺北縣,深坑鄉,埔新村,1979,390,40.70981211,568,59.29018789,958,17,975,0,1193,81.72673931
臺北縣,深坑鄉,埔新村,1980,438,42.15591915,601,57.84408085,1039,23,1062,0,1302,81.56682028
臺北縣,深坑鄉,萬福村,1971,413,51.94968553,382,48.05031447,795,17,812,0,1010,80.3960396
臺北縣,深坑鄉,萬福村,1972,304,45.99092284,357,54.00907716,661,24,685,0,868,78.91705069
臺北縣,深坑鄉,賴仲村,1975,424,35.51088777,770,64.48911223,1194,28,1222,0,1540,79.35064935
臺北縣,石碇鄉,石碇村,1983,175,54.17956656,148,45.82043344,323,9,332,0,392,84.69387755
臺北縣,石碇鄉,潭邊村,1984,264,52.07100592,243,47.92899408,507,40,547,0,674,81.15727003
臺北縣,石碇鄉,隆盛村,1989,318,58.56353591,225,41.43646409,543,8,551,0,696,79.16666667
臺北縣,石碇鄉,烏塗村,1985,349,68.83629191,158,31.16370809,507,9,516,0,607,85.00823723
臺北縣,石碇鄉,彭山村,1986,122,54.46428571,102,45.53571429,224,14,238,0,300,79.33333333
臺北縣,石碇鄉,豐田村,1987,152,67.25663717,74,32.74336283,226,17,243,0,301,80.73089701
臺北縣,石碇鄉,豐田村,1988,52,51.48514851,49,48.51485149,101,5,106,0,125,84.8
臺北縣,石碇鄉,永定村,1992,239,56.23529412,186,43.76470588,425,23,448,0,583,76.84391081
臺北縣,石碇鄉,中民村,1991,326,55.82191781,258,44.17808219,584,29,613,0,764,80.23560209
臺北縣,石碇鄉,光明村,1993,116,60.10362694,77,39.89637306,193,11,204,0,245,83.26530612
臺北縣,石碇鄉,豐林村,1990,88,50.86705202,85,49.13294798,173,8,181,0,230,78.69565217
臺北縣,石碇鄉,永安村,1994,190,57.92682927,138,42.07317073,328,20,348,0,430,80.93023256
臺北縣,石碇鄉,格頭村,1995,356,67.29678639,173,32.70321361,529,31,560,0,679,82.4742268
臺北縣,坪林鄉,粗窟村,2000,289,70.14563107,123,29.85436893,412,1,413,0,516,80.03875969
臺北縣,坪林鄉,粗窟村,2001,67,43.22580645,88,56.77419355,155,8,163,0,212,76.88679245
臺北縣,坪林鄉,坪林村,1996,502,61.8226601,310,38.1773399,812,45,857,0,1046,81.93116635
臺北縣,坪林鄉,大林村,1998,460,71.31782946,185,28.68217054,645,39,684,0,939,72.84345048
臺北縣,坪林鄉,石曹村,1999,172,70.20408163,73,29.79591837,245,26,271,0,375,72.26666667
臺北縣,坪林鄉,上德村,2002,145,66.21004566,74,33.78995434,219,23,242,0,313,77.31629393
臺北縣,坪林鄉,上德村,2003,134,44.81605351,165,55.18394649,299,20,319,0,394,80.96446701
臺北縣,坪林鄉,水德村,1997,256,58.44748858,182,41.55251142,438,25,463,0,571,81.08581436
臺北縣,坪林鄉,漁光村,2004,210,77.49077491,61,22.50922509,271,21,292,0,372,78.49462366
臺北縣,坪林鄉,漁光村,2005,206,70.30716724,87,29.69283276,293,26,319,0,404,78.96039604
臺北縣,三芝鄉,八賢村,2006,162,57.24381625,121,42.75618375,283,17,300,0,381,78.74015748
臺北縣,三芝鄉,埔頭村,2007,178,40,267,60,445,9,454,0,583,77.87307033
臺北縣,三芝鄉,埔頭村,2008,445,43.41463415,580,56.58536585,1025,35,1060,0,1341,79.04548844
臺北縣,三芝鄉,埔頭村,2009,582,44.39359268,729,55.60640732,1311,31,1342,0,1726,77.75202781
臺北縣,三芝鄉,古庄村,2010,284,43.89489954,363,56.10510046,647,40,687,0,920,74.67391304
臺北縣,三芝鄉,新庄村,2011,250,42.01680672,345,57.98319328,595,29,624,0,800,78
臺北縣,三芝鄉,埔坪村,2012,666,40.31476998,986,59.68523002,1652,35,1687,0,2278,74.05618964
臺北縣,三芝鄉,埔坪村,2013,316,38.53658537,504,61.46341463,820,38,858,0,1087,78.93284269
臺北縣,三芝鄉,埔坪村,2014,458,38.61720067,728,61.38279933,1186,52,1238,0,1659,74.62326703
臺北縣,三芝鄉,茂長村,2015,142,41.8879056,197,58.1120944,339,18,357,0,444,80.40540541
臺北縣,三芝鄉,橫山村,2016,182,44.28223844,229,55.71776156,411,27,438,0,545,80.36697248
臺北縣,三芝鄉,錫板村,2017,311,50.98360656,299,49.01639344,610,19,629,1,770,81.68831169
臺北縣,三芝鄉,後厝村,2018,466,37.52012882,776,62.47987118,1242,47,1289,0,1609,80.11187073
臺北縣,三芝鄉,福德村,2019,220,45.17453799,267,54.82546201,487,33,520,0,665,78.19548872
臺北縣,三芝鄉,圓山村,2020,210,56.4516129,162,43.5483871,372,27,399,0,507,78.69822485
臺北縣,三芝鄉,店子村,2021,315,68.62745098,144,31.37254902,459,44,503,0,630,79.84126984
臺北縣,三芝鄉,興華村,2022,428,53.10173697,378,46.89826303,806,49,855,0,1120,76.33928571
臺北縣,石門鄉,德茂村,2023,327,49.0990991,339,50.9009009,666,25,691,0,901,76.69256382
臺北縣,石門鄉,富基村,2024,343,40.97968937,494,59.02031063,837,42,879,0,1094,80.34734918
臺北縣,石門鄉,老梅村,2025,629,48.72192099,662,51.27807901,1291,85,1376,0,1798,76.5294772
臺北縣,石門鄉,山溪村,2026,221,41.77693762,308,58.22306238,529,40,569,0,735,77.41496599
臺北縣,石門鄉,石門村,2027,369,39.17197452,573,60.82802548,942,33,975,0,1221,79.85257985
臺北縣,石門鄉,尖鹿村,2028,387,41.21405751,552,58.78594249,939,49,988,0,1247,79.23015237
臺北縣,石門鄉,乾華村,2029,93,42.85714286,124,57.14285714,217,11,228,0,307,74.26710098
臺北縣,石門鄉,茂林村,2030,175,45.10309278,213,54.89690722,388,24,412,0,518,79.53667954
臺北縣,石門鄉,草里村,2031,219,38.02083333,357,61.97916667,576,29,605,0,767,78.87874837
臺北縣,八里鄉,龍源村,2032,601,45.77303884,712,54.22696116,1313,19,1332,0,1637,81.36835675
臺北縣,八里鄉,龍源村,2033,518,43.45637584,674,56.54362416,1192,27,1219,0,1509,80.78197482
臺北縣,八里鄉,龍源村,2034,442,43.46116028,575,56.53883972,1017,27,1044,0,1260,82.85714286
臺北縣,八里鄉,米倉村,2035,505,52.22337125,462,47.77662875,967,35,1002,0,1273,78.71170463
臺北縣,八里鄉,米倉村,2036,404,49.38875306,414,50.61124694,818,39,857,0,1031,83.12318138
臺北縣,八里鄉,大崁村,2037,599,51.6824849,560,48.3175151,1159,53,1212,0,1504,80.58510638
臺北縣,八里鄉,埤頭村,2038,456,51.23595506,434,48.76404494,890,22,912,0,1139,80.07023705
臺北縣,八里鄉,埤頭村,2039,546,53.21637427,480,46.78362573,1026,47,1073,0,1324,81.04229607
臺北縣,八里鄉,頂罟村,2040,484,53.59911406,419,46.40088594,903,32,935,0,1141,81.9456617
臺北縣,八里鄉,舊城村,2041,579,51.97486535,535,48.02513465,1114,17,1131,0,1441,78.48716169
臺北縣,八里鄉,舊城村,2042,547,46.39525021,632,53.60474979,1179,31,1210,0,1583,76.43714466
臺北縣,八里鄉,舊城村,2043,484,44.36296975,607,55.63703025,1091,29,1120,0,1399,80.0571837
臺北縣,八里鄉,訊塘村,2044,474,44.80151229,584,55.19848771,1058,35,1093,1,1367,79.95610827
臺北縣,八里鄉,訊塘村,2045,471,48.90965732,492,51.09034268,963,24,987,0,1204,81.97674419
臺北縣,八里鄉,荖阡村,2046,524,52.08747515,482,47.91252485,1006,35,1041,0,1313,79.28408225
臺北縣,八里鄉,長坑村,2047,427,47.86995516,465,52.13004484,892,45,937,0,1113,84.1868823
臺北縣,八里鄉,下罟村,2048,327,38.4253819,524,61.5746181,851,44,895,0,1072,83.48880597
臺北縣,平溪鄉,薯榔村,2049,189,59.6214511,128,40.3785489,317,26,343,0,448,76.5625
臺北縣,平溪鄉,菁桐村,2050,97,42.54385965,131,57.45614035,228,11,239,0,308,77.5974026
臺北縣,平溪鄉,白石村,2051,135,60,90,40,225,6,231,0,281,82.20640569
臺北縣,平溪鄉,石底村,2052,238,57.76699029,174,42.23300971,412,25,437,0,561,77.89661319
臺北縣,平溪鄉,平溪村,2053,78,41.05263158,112,58.94736842,190,14,204,0,271,75.27675277
臺北縣,平溪鄉,嶺腳村,2054,237,50.10570825,236,49.89429175,473,38,511,0,685,74.59854015
臺北縣,平溪鄉,東勢村,2055,169,54.87012987,139,45.12987013,308,20,328,0,428,76.63551402
臺北縣,平溪鄉,望古村,2057,61,52.5862069,55,47.4137931,116,6,122,0,152,80.26315789
臺北縣,平溪鄉,南山村,2058,209,58.70786517,147,41.29213483,356,29,385,0,492,78.25203252
臺北縣,平溪鄉,平湖村,2060,62,50.81967213,60,49.18032787,122,6,128,0,167,76.64670659
臺北縣,平溪鄉,十分村,2056,368,52.12464589,338,47.87535411,706,43,749,0,1000,74.9
臺北縣,平溪鄉,新寮村,2059,61,46.92307692,69,53.07692308,130,9,139,0,185,75.13513514
臺北縣,雙溪鄉,雙溪村,2061,197,47.58454106,217,52.41545894,414,21,435,0,562,77.40213523
臺北縣,雙溪鄉,共和村,2073,29,27.88461538,75,72.11538462,104,4,108,0,151,71.52317881
臺北縣,雙溪鄉,共和村,2074,119,51.29310345,113,48.70689655,232,8,240,0,326,73.6196319
臺北縣,雙溪鄉,新基村,2062,69,29.48717949,165,70.51282051,234,8,242,0,307,78.82736156
臺北縣,雙溪鄉,新基村,2063,208,44.82758621,256,55.17241379,464,13,477,0,591,80.7106599
臺北縣,雙溪鄉,魚行村,2075,133,54.28571429,112,45.71428571,245,13,258,0,338,76.33136095
臺北縣,雙溪鄉,魚行村,2076,114,47.89915966,124,52.10084034,238,14,252,0,324,77.77777778
臺北縣,雙溪鄉,三港村,2064,187,60.91205212,120,39.08794788,307,28,335,0,460,72.82608696
臺北縣,雙溪鄉,牡丹村,2065,340,47.48603352,376,52.51396648,716,54,770,0,1033,74.54017425
臺北縣,雙溪鄉,牡丹村,2066,284,50.08818342,283,49.91181658,567,33,600,0,761,78.84362681
臺北縣,雙溪鄉,三貂村,2067,122,47.47081712,135,52.52918288,257,20,277,0,355,78.02816901
臺北縣,雙溪鄉,平林村,2068,215,44.14784394,272,55.85215606,487,22,509,0,645,78.91472868
臺北縣,雙溪鄉,平林村,2069,109,51.65876777,102,48.34123223,211,18,229,0,301,76.07973422
臺北縣,雙溪鄉,上林村,2070,270,54.76673428,223,45.23326572,493,36,529,0,704,75.14204545
臺北縣,雙溪鄉,外柑村,2071,192,57.31343284,143,42.68656716,335,31,366,0,501,73.05389222
臺北縣,雙溪鄉,長源村,2072,207,72.12543554,80,27.87456446,287,28,315,0,421,74.82185273
臺北縣,雙溪鄉,泰平村,2077,155,60.546875,101,39.453125,256,20,276,0,385,71.68831169
臺北縣,雙溪鄉,泰平村,2078,33,35.10638298,61,64.89361702,94,5,99,0,143,69.23076923
臺北縣,貢寮鄉,貢寮村,2079,353,53.97553517,301,46.02446483,654,45,699,0,908,76.98237885
臺北縣,貢寮鄉,吉林村,2081,187,56.66666667,143,43.33333333,330,23,353,0,514,68.6770428
臺北縣,貢寮鄉,雙玉村,2082,214,66.875,106,33.125,320,18,338,0,438,77.16894977
臺北縣,貢寮鄉,雙玉村,2083,142,57.72357724,104,42.27642276,246,23,269,0,350,76.85714286
臺北縣,貢寮鄉,龍崗村,2080,182,58.52090032,129,41.47909968,311,26,337,0,443,76.07223476
臺北縣,貢寮鄉,龍門村,2087,323,66.59793814,162,33.40206186,485,26,511,0,689,74.16545718
臺北縣,貢寮鄉,福隆村,2084,360,48.45222073,383,51.54777927,743,33,776,0,988,78.54251012
臺北縣,貢寮鄉,福隆村,2085,252,58.46867749,179,41.53132251,431,28,459,0,626,73.32268371
臺北縣,貢寮鄉,仁里村,2088,703,58.68113523,495,41.31886477,1198,69,1267,0,1669,75.91372079
臺北縣,貢寮鄉,真理村,2089,542,69.04458599,243,30.95541401,785,46,831,0,1136,73.15140845
臺北縣,貢寮鄉,真理村,2090,428,74.82517483,144,25.17482517,572,21,593,0,805,73.66459627
臺北縣,貢寮鄉,福連村,2086,390,63.62153344,223,36.37846656,613,32,645,0,866,74.48036952
臺北縣,貢寮鄉,美豐村,2091,188,66.1971831,96,33.8028169,284,28,312,0,409,76.28361858
臺北縣,貢寮鄉,美豐村,2092,197,68.64111498,90,31.35888502,287,36,323,0,421,76.72209026
臺北縣,貢寮鄉,和美村,2093,217,65.55891239,114,34.44108761,331,26,357,0,470,75.95744681
臺北縣,貢寮鄉,和美村,2094,186,60.19417476,123,39.80582524,309,19,328,0,454,72.24669604
臺北縣,金山鄉,和平村,2095,172,50,172,50,344,11,355,0,449,79.06458797
臺北縣,金山鄉,大同村,2096,221,43.33333333,289,56.66666667,510,8,518,0,644,80.43478261
臺北縣,金山鄉,豐漁村,2097,177,51.60349854,166,48.39650146,343,22,365,0,479,76.20041754
臺北縣,金山鄉,磺港村,2098,681,61.02150538,435,38.97849462,1116,73,1189,0,1584,75.06313131
臺北縣,金山鄉,美田村,2099,649,46.52329749,746,53.47670251,1395,57,1452,0,1831,79.30092845
臺北縣,金山鄉,美田村,2100,575,46.18473896,670,53.81526104,1245,55,1300,0,1649,78.83565797
臺北縣,金山鄉,美田村,2101,666,50,666,50,1332,45,1377,0,1784,77.18609865
臺北縣,金山鄉,美田村,2102,513,42.89297659,683,57.10702341,1196,26,1222,0,1586,77.04918033
臺北縣,金山鄉,五湖村,2103,231,42.77777778,309,57.22222222,540,22,562,0,690,81.44927536
臺北縣,金山鄉,五湖村,2104,316,56.93693694,239,43.06306306,555,32,587,0,757,77.54293263
臺北縣,金山鄉,重和村,2105,393,56.95652174,297,43.04347826,690,45,735,0,976,75.30737705
臺北縣,金山鄉,兩湖村,2106,142,50.71428571,138,49.28571429,280,35,315,0,389,80.97686375
臺北縣,金山鄉,六股村,2107,229,56.96517413,173,43.03482587,402,29,431,0,535,80.56074766
臺北縣,金山鄉,三界村,2108,239,55.8411215,189,44.1588785,428,36,464,0,587,79.04599659
臺北縣,金山鄉,清泉村,2109,288,49.06303237,299,50.93696763,587,50,637,0,836,76.19617225
臺北縣,金山鄉,萬壽村,2111,175,50.28735632,173,49.71264368,348,24,372,0,461,80.69414317
臺北縣,金山鄉,西湖村,2110,81,52.94117647,72,47.05882353,153,12,165,0,200,82.5
臺北縣,金山鄉,永興村,2112,200,50.63291139,195,49.36708861,395,31,426,0,586,72.69624573
臺北縣,萬里鄉,萬里村,2113,550,42.37288136,748,57.62711864,1298,60,1358,0,1664,81.61057692
臺北縣,萬里鄉,萬里村,2114,460,43.39622642,600,56.60377358,1060,67,1127,0,1485,75.89225589
臺北縣,萬里鄉,龜吼村,2117,123,35.44668588,224,64.55331412,347,36,383,0,590,64.91525424
臺北縣,萬里鄉,龜吼村,2118,371,45.63345633,442,54.36654367,813,47,860,0,1154,74.52339688
臺北縣,萬里鄉,野柳村,2119,438,46.59574468,502,53.40425532,940,41,981,0,1278,76.76056338
臺北縣,萬里鄉,野柳村,2120,424,51.20772947,404,48.79227053,828,37,865,0,1128,76.68439716
臺北縣,萬里鄉,大鵬村,2121,263,48.16849817,283,51.83150183,546,16,562,0,723,77.73167358
臺北縣,萬里鄉,大鵬村,2122,489,43.00791557,648,56.99208443,1137,32,1169,0,1493,78.29872739
臺北縣,萬里鄉,磺潭村,2123,156,42.04851752,215,57.95148248,371,21,392,0,477,82.1802935
臺北縣,萬里鄉,雙興村,2124,353,59.93208829,236,40.06791171,589,52,641,0,781,82.07426376
臺北縣,萬里鄉,溪底村,2125,243,61.83206107,150,38.16793893,393,25,418,0,537,77.83985102
臺北縣,萬里鄉,崁腳村,2126,218,53.82716049,187,46.17283951,405,22,427,0,560,76.25
臺北縣,萬里鄉,中幅村,2127,241,41.33790738,342,58.66209262,583,35,618,0,823,75.09113001
臺北縣,萬里鄉,北基村,2115,256,35.85434174,458,64.14565826,714,29,743,0,1066,69.69981238
臺北縣,萬里鄉,北基村,2116,270,38.51640514,431,61.48359486,701,26,727,0,1017,71.4847591
臺北縣,烏來鄉,烏來村,2129,493,37.7199694,814,62.2800306,1307,25,1332,0,1650,80.72727273
臺北縣,烏來鄉,忠治村,2128,308,38.83984868,485,61.16015132,793,23,816,0,1012,80.63241107
臺北縣,烏來鄉,福山村,2132,64,19.9376947,257,80.0623053,321,2,323,0,415,77.8313253
臺北縣,烏來鄉,信賢村,2131,108,41.22137405,154,58.77862595,262,16,278,0,341,81.52492669
臺北縣,烏來鄉,孝義村,2130,64,55.17241379,52,44.82758621,116,3,119,0,142,83.8028169
宜蘭縣,宜蘭市,神農里,16,229,45.70858283,272,54.29141717,501,5,506,0,648,78.08641975
宜蘭縣,宜蘭市,民權里,23,207,45.39473684,249,54.60526316,456,8,464,0,602,77.07641196
宜蘭縣,宜蘭市,民權里,24,315,42,435,58,750,15,765,0,1028,74.41634241
宜蘭縣,宜蘭市,民生里,17,220,64.70588235,120,35.29411765,340,11,351,0,427,82.20140515
宜蘭縣,宜蘭市,昇平里,18,327,59.56284153,222,40.43715847,549,13,562,0,697,80.6312769
宜蘭縣,宜蘭市,大東里,19,233,54.69483568,193,45.30516432,426,10,436,0,552,78.98550725
宜蘭縣,宜蘭市,新興里,20,235,49.3697479,241,50.6302521,476,12,488,1,612,79.73856209
宜蘭縣,宜蘭市,和睦里,21,269,47.27592267,300,52.72407733,569,10,579,0,734,78.88283379
宜蘭縣,宜蘭市,和睦里,22,454,42.78982092,607,57.21017908,1061,19,1080,0,1392,77.5862069
宜蘭縣,宜蘭市,進士里,25,467,44.5610687,581,55.4389313,1048,12,1060,0,1289,82.23429015
宜蘭縣,宜蘭市,進士里,26,541,49.13714805,560,50.86285195,1101,10,1111,0,1424,78.01966292
宜蘭縣,宜蘭市,進士里,27,293,60.66252588,190,39.33747412,483,15,498,0,666,74.77477477
宜蘭縣,宜蘭市,進士里,28,503,46.96545285,568,53.03454715,1071,14,1085,0,1344,80.72916667
宜蘭縣,宜蘭市,南橋里,29,316,59.62264151,214,40.37735849,530,19,549,0,691,79.45007236
宜蘭縣,宜蘭市,建業里,30,437,58.34445928,312,41.65554072,749,29,778,0,1028,75.68093385
宜蘭縣,宜蘭市,南津里,31,375,64.54388985,206,35.45611015,581,28,609,0,792,76.89393939
宜蘭縣,宜蘭市,凱旋里,32,488,60.54590571,318,39.45409429,806,38,844,0,1069,78.95229186
宜蘭縣,宜蘭市,黎明里,33,611,60.61507937,397,39.38492063,1008,38,1046,0,1303,80.2762855
宜蘭縣,宜蘭市,東村里,34,418,54.92772668,343,45.07227332,761,16,777,0,968,80.26859504
宜蘭縣,宜蘭市,東村里,35,460,45.81673307,544,54.18326693,1004,21,1025,0,1261,81.28469469
宜蘭縣,宜蘭市,東村里,36,581,50.25951557,575,49.74048443,1156,22,1178,0,1500,78.53333333
宜蘭縣,宜蘭市,延平里,37,423,54.51030928,353,45.48969072,776,21,797,1,995,80.10050251
宜蘭縣,宜蘭市,延平里,38,585,45.17374517,710,54.82625483,1295,27,1322,0,1657,79.78273989
宜蘭縣,宜蘭市,延平里,39,444,50.16949153,441,49.83050847,885,18,903,0,1143,79.00262467
宜蘭縣,宜蘭市,七張里,40,600,66.81514477,298,33.18485523,898,47,945,0,1178,80.22071307
宜蘭縣,宜蘭市,慈安里,41,445,49.33481153,457,50.66518847,902,32,934,0,1232,75.81168831
宜蘭縣,宜蘭市,慈安里,42,494,48.28934506,529,51.71065494,1023,27,1050,0,1344,78.125
宜蘭縣,宜蘭市,慈安里,43,526,46.26209323,611,53.73790677,1137,9,1146,1,1491,76.861167
宜蘭縣,宜蘭市,新民里,44,298,59.00990099,207,40.99009901,505,16,521,0,659,79.05918058
宜蘭縣,宜蘭市,東門里,45,257,58.81006865,180,41.18993135,437,9,446,0,545,81.83486239
宜蘭縣,宜蘭市,中正里,46,261,56.61605206,200,43.38394794,461,14,475,0,619,76.73667205
宜蘭縣,宜蘭市,小東里,47,509,50.14778325,506,49.85221675,1015,27,1042,0,1304,79.90797546
宜蘭縣,宜蘭市,菜園里,48,536,51.53846154,504,48.46153846,1040,27,1067,0,1342,79.50819672
宜蘭縣,宜蘭市,孝廉里,49,445,58.16993464,320,41.83006536,765,29,794,1,1009,78.69177403
宜蘭縣,宜蘭市,新生里,50,621,60.34985423,408,39.65014577,1029,35,1064,0,1375,77.38181818
宜蘭縣,宜蘭市,新生里,51,371,58.05946792,268,41.94053208,639,19,658,0,821,80.14616322
宜蘭縣,宜蘭市,茭白里,52,846,62.66666667,504,37.33333333,1350,41,1391,0,1822,76.34467618
宜蘭縣,宜蘭市,北津里,53,689,60.12216405,457,39.87783595,1146,33,1179,0,1508,78.18302387
宜蘭縣,宜蘭市,梅洲里,54,656,61.82846371,405,38.17153629,1061,28,1089,0,1373,79.31536781
宜蘭縣,宜蘭市,梅洲里,55,592,66.81715576,294,33.18284424,886,27,913,0,1147,79.59895379
宜蘭縣,宜蘭市,北門里,56,408,56.82451253,310,43.17548747,718,14,732,0,921,79.47882736
宜蘭縣,宜蘭市,慶和里,57,340,63.78986867,193,36.21013133,533,19,552,0,724,76.24309392
宜蘭縣,宜蘭市,鄂王里,58,379,64.02027027,213,35.97972973,592,16,608,0,800,76
宜蘭縣,宜蘭市,中山里,60,350,63.75227687,199,36.24772313,549,26,575,0,781,73.62355954
宜蘭縣,宜蘭市,西門里,59,571,59.66562173,386,40.33437827,957,30,987,0,1257,78.5202864
宜蘭縣,宜蘭市,大道里,61,583,56.98924731,440,43.01075269,1023,29,1052,0,1359,77.40986019
宜蘭縣,宜蘭市,南門里,1,204,43.96551724,260,56.03448276,464,10,474,0,618,76.69902913
宜蘭縣,宜蘭市,負郭里,2,269,44.31630972,338,55.68369028,607,16,623,0,772,80.69948187
宜蘭縣,宜蘭市,負郭里,3,555,49.6866607,562,50.3133393,1117,28,1145,0,1433,79.90230286
宜蘭縣,宜蘭市,民族里,4,418,45.53376906,500,54.46623094,918,20,938,0,1168,80.30821918
宜蘭縣,宜蘭市,民族里,5,382,42.82511211,510,57.17488789,892,25,917,0,1125,81.51111111
宜蘭縣,宜蘭市,建軍里,6,507,48.51674641,538,51.48325359,1045,11,1056,0,1339,78.8648245
宜蘭縣,宜蘭市,建軍里,7,417,42.90123457,555,57.09876543,972,20,992,0,1243,79.80691874
宜蘭縣,宜蘭市,思源里,11,675,47.07112971,759,52.92887029,1434,16,1450,0,1807,80.24349751
宜蘭縣,宜蘭市,思源里,12,582,43.72652141,749,56.27347859,1331,23,1354,0,1692,80.02364066
宜蘭縣,宜蘭市,思源里,13,366,40.89385475,529,59.10614525,895,20,915,0,1136,80.54577465
宜蘭縣,宜蘭市,文化里,14,492,46.59090909,564,53.40909091,1056,25,1081,0,1366,79.13616398
宜蘭縣,宜蘭市,文化里,15,528,46.97508897,596,53.02491103,1124,23,1147,0,1450,79.10344828
宜蘭縣,宜蘭市,復興里,8,254,31.39678616,555,68.60321384,809,10,819,0,1031,79.43743938
宜蘭縣,宜蘭市,復興里,9,314,49.0625,326,50.9375,640,14,654,0,798,81.95488722
宜蘭縣,宜蘭市,復興里,10,394,48.52216749,418,51.47783251,812,27,839,0,1048,80.05725191
宜蘭縣,羅東鎮,開羅里,62,228,61.29032258,144,38.70967742,372,10,382,0,498,76.70682731
宜蘭縣,羅東鎮,開元里,63,282,66.66666667,141,33.33333333,423,15,438,0,539,81.26159555
宜蘭縣,羅東鎮,東明里,64,230,62.5,138,37.5,368,21,389,0,500,77.8
宜蘭縣,羅東鎮,大新里,65,583,61.04712042,372,38.95287958,955,20,975,0,1243,78.43925986
宜蘭縣,羅東鎮,東安里,66,442,66.86838124,219,33.13161876,661,22,683,0,843,81.02016607
宜蘭縣,羅東鎮,東安里,67,694,55.74297189,551,44.25702811,1245,19,1264,0,1613,78.3632982
宜蘭縣,羅東鎮,新群里,68,611,70.7995365,252,29.2004635,863,27,890,0,1084,82.10332103
宜蘭縣,羅東鎮,新群里,69,462,63.90041494,261,36.09958506,723,24,747,1,985,75.83756345
宜蘭縣,羅東鎮,羅莊里,70,491,59.80511571,330,40.19488429,821,22,843,0,1077,78.2729805
宜蘭縣,羅東鎮,羅莊里,71,436,56.54993515,335,43.45006485,771,9,780,0,1006,77.53479125
宜蘭縣,羅東鎮,南昌里,72,636,58.29514207,455,41.70485793,1091,28,1119,0,1420,78.8028169
宜蘭縣,羅東鎮,南昌里,73,259,37.81021898,426,62.18978102,685,17,702,0,873,80.41237113
宜蘭縣,羅東鎮,南豪里,74,609,58.89748549,425,41.10251451,1034,35,1069,0,1316,81.23100304
宜蘭縣,羅東鎮,成功里,75,582,56.01539942,457,43.98460058,1039,21,1060,0,1270,83.46456693
宜蘭縣,羅東鎮,仁德里,76,395,57.91788856,287,42.08211144,682,20,702,0,863,81.34414832
宜蘭縣,羅東鎮,居仁里,77,314,57.50915751,232,42.49084249,546,15,561,0,734,76.43051771
宜蘭縣,羅東鎮,義和里,78,381,61.05769231,243,38.94230769,624,19,643,0,832,77.28365385
宜蘭縣,羅東鎮,羅東里,79,281,57.23014257,210,42.76985743,491,14,505,0,616,81.98051948
宜蘭縣,羅東鎮,浮崙里,80,342,61.51079137,214,38.48920863,556,13,569,0,710,80.14084507
宜蘭縣,羅東鎮,漢民里,81,507,61.52912621,317,38.47087379,824,22,846,0,1070,79.06542056
宜蘭縣,羅東鎮,漢民里,82,569,50.08802817,567,49.91197183,1136,18,1154,0,1434,80.47419805
宜蘭縣,羅東鎮,漢民里,83,408,51.19196989,389,48.80803011,797,15,812,0,1026,79.14230019
宜蘭縣,羅東鎮,西安里,84,434,54.86725664,357,45.13274336,791,4,795,0,995,79.89949749
宜蘭縣,羅東鎮,西安里,85,662,55.58354324,529,44.41645676,1191,11,1202,0,1503,79.97338656
宜蘭縣,羅東鎮,西安里,86,514,62.00241255,315,37.99758745,829,27,856,0,1093,78.31655993
宜蘭縣,羅東鎮,西安里,87,600,55.65862709,478,44.34137291,1078,19,1097,0,1394,78.69440459
宜蘭縣,羅東鎮,北成里,88,719,67.63875823,344,32.36124177,1063,30,1093,0,1388,78.74639769
宜蘭縣,羅東鎮,北成里,89,611,57.8051088,446,42.1948912,1057,22,1079,1,1338,80.64275037
宜蘭縣,羅東鎮,北成里,90,651,56.65796345,498,43.34203655,1149,14,1163,0,1426,81.55680224
宜蘭縣,羅東鎮,北成里,91,630,56.91056911,477,43.08943089,1107,11,1118,0,1373,81.42753095
宜蘭縣,羅東鎮,賢文里,92,553,52.81757402,494,47.18242598,1047,24,1071,0,1370,78.17518248
宜蘭縣,羅東鎮,賢文里,93,471,59.69581749,318,40.30418251,789,25,814,0,1041,78.19404419
宜蘭縣,羅東鎮,賢文里,94,430,52.89052891,383,47.10947109,813,13,826,0,1043,79.19463087
宜蘭縣,羅東鎮,公正里,95,461,57.91457286,335,42.08542714,796,15,811,0,1009,80.37661051
宜蘭縣,羅東鎮,公正里,96,376,54.17867435,318,45.82132565,694,12,706,0,856,82.47663551
宜蘭縣,羅東鎮,集祥里,97,462,58.18639798,332,41.81360202,794,9,803,0,1051,76.40342531
宜蘭縣,羅東鎮,信義里,98,650,54.89864865,534,45.10135135,1184,18,1202,0,1527,78.71643746
宜蘭縣,羅東鎮,信義里,99,697,58.42414082,496,41.57585918,1193,29,1222,0,1520,80.39473684
宜蘭縣,羅東鎮,竹林里,103,643,59.20810313,443,40.79189687,1086,31,1117,0,1413,79.05166313
宜蘭縣,羅東鎮,竹林里,104,591,63.27623126,343,36.72376874,934,24,958,0,1231,77.8229082
宜蘭縣,羅東鎮,仁愛里,105,672,59.89304813,450,40.10695187,1122,31,1153,0,1419,81.25440451
宜蘭縣,羅東鎮,仁愛里,106,625,64.5661157,343,35.4338843,968,2,970,0,1194,81.23953099
宜蘭縣,羅東鎮,樹林里,100,441,48.40834248,470,51.59165752,911,11,922,0,1139,80.94820018
宜蘭縣,羅東鎮,樹林里,101,519,56.59760087,398,43.40239913,917,14,931,0,1173,79.36913896
宜蘭縣,羅東鎮,樹林里,102,485,56.79156909,369,43.20843091,854,16,870,0,1126,77.26465364
宜蘭縣,蘇澳鎮,龍德里,107,327,65.53106212,172,34.46893788,499,32,531,0,653,81.31699847
宜蘭縣,蘇澳鎮,龍德里,108,588,65.40600667,311,34.59399333,899,38,937,0,1208,77.56622517
宜蘭縣,蘇澳鎮,龍德里,109,561,63.10461192,328,36.89538808,889,30,919,0,1167,78.74892888
宜蘭縣,蘇澳鎮,頂寮里,110,429,68.97106109,193,31.02893891,622,31,653,0,775,84.25806452
宜蘭縣,蘇澳鎮,永榮里,111,522,62.06896552,319,37.93103448,841,20,861,0,1100,78.27272727
宜蘭縣,蘇澳鎮,永榮里,112,461,59.0268886,320,40.9731114,781,26,807,0,1009,79.98017839
宜蘭縣,蘇澳鎮,永榮里,113,432,60.84507042,278,39.15492958,710,20,730,0,906,80.57395143
宜蘭縣,蘇澳鎮,存仁里,114,299,65,161,35,460,25,485,0,601,80.69883527
宜蘭縣,蘇澳鎮,存仁里,115,206,72.79151943,77,27.20848057,283,1,284,0,358,79.32960894
宜蘭縣,蘇澳鎮,港邊里,116,362,65.22522523,193,34.77477477,555,40,595,0,758,78.49604222
宜蘭縣,蘇澳鎮,港邊里,117,209,62.95180723,123,37.04819277,332,14,346,0,441,78.45804989
宜蘭縣,蘇澳鎮,岳明里,118,13,8.441558442,141,91.55844156,154,2,156,0,253,61.66007905
宜蘭縣,蘇澳鎮,隘丁里,119,486,61.36363636,306,38.63636364,792,30,822,0,1040,79.03846154
宜蘭縣,蘇澳鎮,隘丁里,120,512,63.4448575,295,36.5551425,807,27,834,0,1084,76.93726937
宜蘭縣,蘇澳鎮,新城里,121,494,59.87878788,331,40.12121212,825,29,854,1,1098,77.77777778
宜蘭縣,蘇澳鎮,聖湖里,122,564,56.56970913,433,43.43029087,997,33,1030,0,1394,73.88809182
宜蘭縣,蘇澳鎮,聖湖里,123,382,49.93464052,383,50.06535948,765,20,785,0,1019,77.03631011
宜蘭縣,蘇澳鎮,聖湖里,124,518,51.13524186,495,48.86475814,1013,28,1041,0,1323,78.68480726
宜蘭縣,蘇澳鎮,聖湖里,125,446,46.12202689,521,53.87797311,967,25,992,0,1339,74.08513816
宜蘭縣,蘇澳鎮,蘇西里,126,470,52.63157895,423,47.36842105,893,22,915,1,1149,79.63446475
宜蘭縣,蘇澳鎮,蘇西里,127,434,48.92897407,453,51.07102593,887,34,921,0,1209,76.17866005
宜蘭縣,蘇澳鎮,蘇北里,128,468,51.14754098,447,48.85245902,915,24,939,0,1217,77.1569433
宜蘭縣,蘇澳鎮,蘇南里,129,224,53.97590361,191,46.02409639,415,19,434,0,562,77.22419929
宜蘭縣,蘇澳鎮,蘇東里,130,199,55.58659218,159,44.41340782,358,14,372,0,535,69.53271028
宜蘭縣,蘇澳鎮,長安里,131,237,51.52173913,223,48.47826087,460,19,479,0,613,78.14029364
宜蘭縣,蘇澳鎮,永光里,132,193,50.12987013,192,49.87012987,385,8,393,0,495,79.39393939
宜蘭縣,蘇澳鎮,永春里,133,281,62.3059867,170,37.6940133,451,20,471,0,642,73.36448598
宜蘭縣,蘇澳鎮,永樂里,134,204,56.50969529,157,43.49030471,361,29,390,0,503,77.53479125
宜蘭縣,蘇澳鎮,南安里,135,474,59.39849624,324,40.60150376,798,31,829,0,1065,77.84037559
宜蘭縣,蘇澳鎮,南正里,136,471,61.89224704,290,38.10775296,761,15,776,0,1048,74.04580153
宜蘭縣,蘇澳鎮,南成里,137,529,60.11363636,351,39.88636364,880,45,925,0,1249,74.0592474
宜蘭縣,蘇澳鎮,南興里,138,313,51.82119205,291,48.17880795,604,23,627,0,855,73.33333333
宜蘭縣,蘇澳鎮,南興里,139,302,57.52380952,223,42.47619048,525,33,558,0,802,69.57605985
宜蘭縣,蘇澳鎮,南寧里,140,464,56.51644336,357,43.48355664,821,28,849,0,1144,74.21328671
宜蘭縣,蘇澳鎮,南建里,141,608,63.59832636,348,36.40167364,956,22,978,0,1324,73.86706949
宜蘭縣,蘇澳鎮,東澳里,142,117,52.46636771,106,47.53363229,223,7,230,0,303,75.90759076
宜蘭縣,蘇澳鎮,南強里,143,373,63.00675676,219,36.99324324,592,25,617,0,872,70.75688073
宜蘭縣,蘇澳鎮,朝陽里,144,235,70.14925373,100,29.85074627,335,23,358,0,493,72.61663286
宜蘭縣,蘇澳鎮,朝陽里,145,122,71.34502924,49,28.65497076,171,9,180,0,253,71.14624506
宜蘭縣,頭城鎮,石城里,146,136,53.75494071,117,46.24505929,253,17,270,0,374,72.19251337
宜蘭縣,頭城鎮,大里里,147,246,48.71287129,259,51.28712871,505,33,538,0,739,72.80108254
宜蘭縣,頭城鎮,大溪里,149,382,58.14307458,275,41.85692542,657,34,691,0,929,74.3810549
宜蘭縣,頭城鎮,合興里,150,131,46.61921708,150,53.38078292,281,20,301,0,403,74.6898263
宜蘭縣,頭城鎮,更新里,151,401,41.55440415,564,58.44559585,965,46,1011,0,1409,71.75301632
宜蘭縣,頭城鎮,外澳里,152,284,47.09784411,319,52.90215589,603,47,650,2,937,69.37033084
宜蘭縣,頭城鎮,港口里,153,234,50.10706638,233,49.89293362,467,21,488,0,641,76.13104524
宜蘭縣,頭城鎮,武營里,154,425,39.53488372,650,60.46511628,1075,39,1114,1,1447,76.98686938
宜蘭縣,頭城鎮,大坑里,155,431,47.99554566,467,52.00445434,898,31,929,1,1208,76.90397351
宜蘭縣,頭城鎮,城東里,156,241,40.57239057,353,59.42760943,594,12,606,0,745,81.34228188
宜蘭縣,頭城鎮,城北里,157,158,37.52969121,263,62.47030879,421,16,437,0,560,78.03571429
宜蘭縣,頭城鎮,城西里,158,217,43.31337325,284,56.68662675,501,3,504,0,632,79.74683544
宜蘭縣,頭城鎮,城南里,159,184,37.24696356,310,62.75303644,494,11,505,0,628,80.41401274
宜蘭縣,頭城鎮,竹安里,160,385,56.20437956,300,43.79562044,685,22,707,0,994,71.12676056
宜蘭縣,頭城鎮,竹安里,161,288,38.29787234,464,61.70212766,752,21,773,0,1026,75.3411306
宜蘭縣,頭城鎮,新建里,162,312,52.61382799,281,47.38617201,593,20,613,0,787,77.89072427
宜蘭縣,頭城鎮,新建里,163,328,44.87004104,403,55.12995896,731,19,750,0,1006,74.5526839
宜蘭縣,頭城鎮,拔雅里,164,481,46.33911368,557,53.66088632,1038,36,1074,0,1406,76.38691323
宜蘭縣,頭城鎮,福成里,165,394,52.95698925,350,47.04301075,744,32,776,0,1004,77.29083665
宜蘭縣,頭城鎮,金面里,166,539,44.65617233,668,55.34382767,1207,51,1258,0,1669,75.37447573
宜蘭縣,頭城鎮,金盈里,167,240,46.60194175,275,53.39805825,515,26,541,0,711,76.09001406
宜蘭縣,頭城鎮,頂埔里,168,430,44.60580913,534,55.39419087,964,33,997,0,1274,78.25745683
宜蘭縣,頭城鎮,下埔里,169,361,50.41899441,355,49.58100559,716,27,743,0,962,77.23492723
宜蘭縣,頭城鎮,中崙里,170,340,46.83195592,386,53.16804408,726,31,757,0,963,78.60851506
宜蘭縣,頭城鎮,二城里,171,428,53.5,372,46.5,800,37,837,1,1076,77.78810409
宜蘭縣,頭城鎮,龜山里,148,208,42.97520661,276,57.02479339,484,20,504,0,652,77.3006135
宜蘭縣,礁溪鄉,白雲村,172,565,54.27473583,476,45.72526417,1041,56,1097,0,1406,78.0227596
宜蘭縣,礁溪鄉,玉石村,173,637,51.16465863,608,48.83534137,1245,56,1301,0,1660,78.37349398
宜蘭縣,礁溪鄉,德陽村,174,604,48.2428115,648,51.7571885,1252,38,1290,0,1706,75.61547479
宜蘭縣,礁溪鄉,德陽村,175,491,37.16881151,830,62.83118849,1321,36,1357,0,1799,75.43079489
宜蘭縣,礁溪鄉,大忠村,176,420,40.93567251,606,59.06432749,1026,27,1053,0,1357,77.59764186
宜蘭縣,礁溪鄉,大忠村,177,287,46.44012945,331,53.55987055,618,29,647,0,800,80.875
宜蘭縣,礁溪鄉,大義村,178,300,58.82352941,210,41.17647059,510,22,532,0,665,80
宜蘭縣,礁溪鄉,六結村,179,487,45.2181987,590,54.7818013,1077,29,1106,1,1394,79.34002869
宜蘭縣,礁溪鄉,二龍村,180,527,62.514828,316,37.485172,843,33,876,0,1092,80.21978022
宜蘭縣,礁溪鄉,時潮村,181,701,69.75124378,304,30.24875622,1005,45,1050,0,1380,76.08695652
宜蘭縣,礁溪鄉,玉田村,182,419,69.94991653,180,30.05008347,599,41,640,0,850,75.29411765
宜蘭縣,礁溪鄉,玉田村,183,596,75.25252525,196,24.74747475,792,31,823,0,1009,81.56590684
宜蘭縣,礁溪鄉,三民村,184,631,60.90733591,405,39.09266409,1036,52,1088,0,1385,78.55595668
宜蘭縣,礁溪鄉,三民村,185,361,54.12293853,306,45.87706147,667,30,697,0,905,77.01657459
宜蘭縣,礁溪鄉,林美村,186,521,63.92638037,294,36.07361963,815,57,872,0,1085,80.36866359
宜蘭縣,礁溪鄉,白鵝村,187,342,60.31746032,225,39.68253968,567,22,589,0,737,79.91858887
宜蘭縣,礁溪鄉,玉光村,188,544,71.57894737,216,28.42105263,760,27,787,0,963,81.72377985
宜蘭縣,礁溪鄉,光武村,189,534,63.64719905,305,36.35280095,839,41,880,0,1109,79.35076646
宜蘭縣,礁溪鄉,吳沙村,190,432,53.46534653,376,46.53465347,808,21,829,0,1049,79.02764538
宜蘭縣,礁溪鄉,吳沙村,191,556,64.95327103,300,35.04672897,856,33,889,0,1141,77.91411043
宜蘭縣,礁溪鄉,龍潭村,192,808,71.886121,316,28.113879,1124,50,1174,0,1451,80.90971744
宜蘭縣,礁溪鄉,龍潭村,193,713,69.4255112,314,30.5744888,1027,48,1075,0,1322,81.31618759
宜蘭縣,礁溪鄉,匏崙村,194,480,67.41573034,232,32.58426966,712,25,737,0,955,77.17277487
宜蘭縣,礁溪鄉,二結村,195,245,74.01812689,86,25.98187311,331,10,341,0,414,82.36714976
宜蘭縣,壯圍鄉,吉祥村,196,435,58.86332882,304,41.13667118,739,27,766,1,957,80.04179728
宜蘭縣,壯圍鄉,吉祥村,197,396,59.19282511,273,40.80717489,669,25,694,0,888,78.15315315
宜蘭縣,壯圍鄉,美福村,199,354,58.22368421,254,41.77631579,608,26,634,0,815,77.79141104
宜蘭縣,壯圍鄉,美福村,200,402,65.25974026,214,34.74025974,616,24,640,0,801,79.90012484
宜蘭縣,壯圍鄉,新南村,201,428,63.22008863,249,36.77991137,677,37,714,0,872,81.88073394
宜蘭縣,壯圍鄉,東港村,202,462,63.02864939,271,36.97135061,733,8,741,0,989,74.92416582
宜蘭縣,壯圍鄉,復興村,203,402,67.11185309,197,32.88814691,599,17,616,0,788,78.17258883
宜蘭縣,壯圍鄉,復興村,204,369,63.51118761,212,36.48881239,581,38,619,0,814,76.04422604
宜蘭縣,壯圍鄉,過嶺村,205,443,67.84073507,210,32.15926493,653,22,675,0,889,75.928009
宜蘭縣,壯圍鄉,過嶺村,206,292,58.16733068,210,41.83266932,502,22,524,0,687,76.27365357
宜蘭縣,壯圍鄉,永鎮村,207,439,70.46548957,184,29.53451043,623,26,649,0,857,75.72928821
宜蘭縣,壯圍鄉,忠孝村,208,365,60.2310231,241,39.7689769,606,31,637,0,830,76.74698795
宜蘭縣,壯圍鄉,忠孝村,209,610,64.07563025,342,35.92436975,952,35,987,0,1256,78.58280255
宜蘭縣,壯圍鄉,古亭村,210,642,67.57894737,308,32.42105263,950,43,993,0,1264,78.56012658
宜蘭縣,壯圍鄉,功勞村,211,479,64.20911528,267,35.79088472,746,40,786,0,986,79.71602434
宜蘭縣,壯圍鄉,美城村,212,464,65.16853933,248,34.83146067,712,34,746,0,934,79.87152034
宜蘭縣,壯圍鄉,美城村,213,503,64.81958763,273,35.18041237,776,26,802,0,1010,79.40594059
宜蘭縣,壯圍鄉,新社村,214,469,60.75129534,303,39.24870466,772,43,815,0,1066,76.45403377
宜蘭縣,壯圍鄉,大福村,215,378,59.81012658,254,40.18987342,632,32,664,0,882,75.28344671
宜蘭縣,壯圍鄉,大福村,216,345,63.18681319,201,36.81318681,546,27,573,0,742,77.22371968
宜蘭縣,壯圍鄉,古結村,198,483,67.17663421,236,32.82336579,719,22,741,0,936,79.16666667
宜蘭縣,員山鄉,員山村,217,663,58.62068966,468,41.37931034,1131,43,1174,0,1525,76.98360656
宜蘭縣,員山鄉,員山村,218,624,59.88483685,418,40.11516315,1042,39,1081,0,1363,79.31034483
宜蘭縣,員山鄉,員山村,219,484,43.52517986,628,56.47482014,1112,13,1125,0,1445,77.85467128
宜蘭縣,員山鄉,尚德村,220,493,69.83002833,213,30.16997167,706,41,747,0,971,76.93099897
宜蘭縣,員山鄉,尚德村,221,397,58.81481481,278,41.18518519,675,27,702,0,909,77.22772277
宜蘭縣,員山鄉,惠好村,222,686,71.30977131,276,28.69022869,962,42,1004,0,1228,81.75895765
宜蘭縣,員山鄉,七賢村,223,383,53.79213483,329,46.20786517,712,38,750,0,958,78.28810021
宜蘭縣,員山鄉,深溝村,224,733,71.8627451,287,28.1372549,1020,52,1072,0,1435,74.70383275
宜蘭縣,員山鄉,蓁巷村,225,599,71.6507177,237,28.3492823,836,50,886,0,1190,74.45378151
宜蘭縣,員山鄉,內城村,226,317,45.28571429,383,54.71428571,700,47,747,0,986,75.76064909
宜蘭縣,員山鄉,內城村,227,135,41.41104294,191,58.58895706,326,25,351,0,450,78
宜蘭縣,員山鄉,中華村,228,244,73.93939394,86,26.06060606,330,26,356,0,458,77.72925764
宜蘭縣,員山鄉,中華村,229,107,61.14285714,68,38.85714286,175,13,188,0,273,68.86446886
宜蘭縣,員山鄉,永和村,230,753,61.16978067,478,38.83021933,1231,49,1280,0,1620,79.01234568
宜蘭縣,員山鄉,頭分村,231,516,63.62515413,295,36.37484587,811,50,861,0,1064,80.92105263
宜蘭縣,員山鄉,枕山村,232,892,72.99509002,330,27.00490998,1222,49,1271,0,1585,80.18927445
宜蘭縣,員山鄉,枕山村,233,277,72.70341207,104,27.29658793,381,21,402,0,513,78.3625731
宜蘭縣,員山鄉,同樂村,234,570,60.96256684,365,39.03743316,935,41,976,0,1246,78.33065811
宜蘭縣,員山鄉,同樂村,235,626,65.96417281,323,34.03582719,949,40,989,0,1246,79.37399679
宜蘭縣,員山鄉,湖東村,236,369,62.22596965,224,37.77403035,593,43,636,0,850,74.82352941
宜蘭縣,員山鄉,逸仙村,237,445,74.41471572,153,25.58528428,598,41,639,0,824,77.54854369
宜蘭縣,員山鄉,湖北村,238,470,64.64924347,257,35.35075653,727,52,779,0,1008,77.28174603
宜蘭縣,員山鄉,湖西村,239,757,73.28170378,276,26.71829622,1033,77,1110,0,1457,76.1839396
宜蘭縣,冬山鄉,武淵村,260,578,70.48780488,242,29.51219512,820,42,862,0,1055,81.70616114
宜蘭縣,冬山鄉,珍珠村,240,734,69.50757576,322,30.49242424,1056,44,1100,0,1346,81.72362556
宜蘭縣,冬山鄉,補城村,241,546,71.27937337,220,28.72062663,766,33,799,0,988,80.87044534
宜蘭縣,冬山鄉,三奇村,242,425,69.33115824,188,30.66884176,613,39,652,0,820,79.51219512
宜蘭縣,冬山鄉,大興村,243,518,70.28493894,219,29.71506106,737,26,763,1,956,79.81171548
宜蘭縣,冬山鄉,東城村,244,605,64.08898305,339,35.91101695,944,33,977,0,1223,79.88552739
宜蘭縣,冬山鄉,香和村,245,493,64.27640156,274,35.72359844,767,32,799,0,992,80.54435484
宜蘭縣,冬山鄉,香和村,246,563,68.24242424,262,31.75757576,825,46,871,0,1079,80.72289157
宜蘭縣,冬山鄉,南興村,247,411,63.42592593,237,36.57407407,648,21,669,0,828,80.79710145
宜蘭縣,冬山鄉,南興村,248,558,64.58333333,306,35.41666667,864,24,888,0,1087,81.69273229
宜蘭縣,冬山鄉,冬山村,250,399,63.23296355,232,36.76703645,631,19,650,0,833,78.03121248
宜蘭縣,冬山鄉,安平村,249,371,71.34615385,149,28.65384615,520,20,540,0,702,76.92307692
宜蘭縣,冬山鄉,太和村,251,728,67.7839851,346,32.2160149,1074,45,1119,1,1321,84.70855413
宜蘭縣,冬山鄉,八寶村,252,431,70.4248366,181,29.5751634,612,21,633,0,796,79.52261307
宜蘭縣,冬山鄉,丸山村,253,691,69.16916917,308,30.83083083,999,43,1042,0,1276,81.66144201
宜蘭縣,冬山鄉,中山村,254,272,74.52054795,93,25.47945205,365,17,382,0,449,85.077951
宜蘭縣,冬山鄉,順安村,255,613,67.0678337,301,32.9321663,914,23,937,0,1205,77.7593361
宜蘭縣,冬山鄉,順安村,256,830,69.28213689,368,30.71786311,1198,39,1237,0,1608,76.9278607
宜蘭縣,冬山鄉,順安村,257,777,66.6380789,389,33.3619211,1166,36,1202,0,1531,78.51077727
宜蘭縣,冬山鄉,永美村,258,471,68.26086957,219,31.73913043,690,15,705,0,872,80.84862385
宜蘭縣,冬山鄉,永美村,259,583,65.35874439,309,34.64125561,892,43,935,0,1176,79.50680272
宜蘭縣,冬山鄉,群英村,261,649,66.3599182,329,33.6400818,978,14,992,0,1209,82.05128205
宜蘭縣,冬山鄉,群英村,262,517,63.20293399,301,36.79706601,818,24,842,0,1073,78.47157502
宜蘭縣,冬山鄉,群英村,263,570,56.71641791,435,43.28358209,1005,27,1032,0,1255,82.2310757
宜蘭縣,冬山鄉,群英村,264,462,60.70959264,299,39.29040736,761,13,774,0,970,79.79381443
宜蘭縣,冬山鄉,清溝村,265,633,63.04780876,371,36.95219124,1004,30,1034,0,1308,79.05198777
宜蘭縣,冬山鄉,清溝村,266,696,66.15969582,356,33.84030418,1052,22,1074,0,1398,76.82403433
宜蘭縣,冬山鄉,鹿埔村,267,631,76.11580217,198,23.88419783,829,37,866,0,1111,77.94779478
宜蘭縣,冬山鄉,鹿埔村,268,473,58.1795818,340,41.8204182,813,62,875,0,1101,79.47320618
宜蘭縣,冬山鄉,得安村,269,478,61.99740597,293,38.00259403,771,39,810,0,1050,77.14285714
宜蘭縣,冬山鄉,廣興村,270,556,65.10538642,298,34.89461358,854,36,890,0,1110,80.18018018
宜蘭縣,冬山鄉,廣興村,271,579,66.55172414,291,33.44827586,870,28,898,0,1099,81.71064604
宜蘭縣,冬山鄉,廣安村,272,640,63.87225549,362,36.12774451,1002,49,1051,0,1347,78.02524128
宜蘭縣,冬山鄉,柯林村,273,593,68.16091954,277,31.83908046,870,28,898,1,1111,80.82808281
宜蘭縣,冬山鄉,大進村,274,489,75.93167702,155,24.06832298,644,37,681,0,847,80.40141677
宜蘭縣,五結鄉,三興村,275,848,72.91487532,315,27.08512468,1163,59,1222,0,1572,77.73536896
宜蘭縣,五結鄉,二結村,276,691,58.85860307,483,41.14139693,1174,34,1208,0,1476,81.84281843
宜蘭縣,五結鄉,鎮安村,277,520,65.32663317,276,34.67336683,796,13,809,0,1023,79.08113392
宜蘭縣,五結鄉,鎮安村,278,557,67.76155718,265,32.23844282,822,14,836,0,1047,79.84718243
宜蘭縣,五結鄉,上四村,279,721,63.30114135,418,36.69885865,1139,27,1166,0,1466,79.5361528
宜蘭縣,五結鄉,中興村,280,521,66.45408163,263,33.54591837,784,26,810,0,1040,77.88461538
宜蘭縣,五結鄉,四結村,281,357,50.78236131,346,49.21763869,703,27,730,0,913,79.95618839
宜蘭縣,五結鄉,四結村,282,562,61.2868048,355,38.7131952,917,25,942,0,1176,80.10204082
宜蘭縣,五結鄉,福興村,283,774,67.36292428,375,32.63707572,1149,42,1191,0,1499,79.45296865
宜蘭縣,五結鄉,五結村,284,647,59.03284672,449,40.96715328,1096,24,1120,0,1373,81.57319738
宜蘭縣,五結鄉,五結村,285,670,62.79287723,397,37.20712277,1067,28,1095,1,1408,77.76988636
宜蘭縣,五結鄉,大吉村,286,792,59.63855422,536,40.36144578,1328,26,1354,2,1670,81.07784431
宜蘭縣,五結鄉,大吉村,287,588,67.74193548,280,32.25806452,868,40,908,0,1106,82.09764919
宜蘭縣,五結鄉,協和村,288,781,68.38879159,361,31.61120841,1142,38,1180,0,1461,80.76659822
宜蘭縣,五結鄉,協和村,289,462,69.89409985,199,30.10590015,661,21,682,0,905,75.35911602
宜蘭縣,五結鄉,孝威村,290,733,73.37337337,266,26.62662663,999,55,1054,0,1361,77.44305658
宜蘭縣,五結鄉,錦眾村,291,742,69.02325581,333,30.97674419,1075,67,1142,0,1467,77.8459441
宜蘭縣,五結鄉,利澤村,292,477,63.01188904,280,36.98811096,757,25,782,0,1003,77.96610169
宜蘭縣,五結鄉,利澤村,293,523,71.44808743,209,28.55191257,732,35,767,0,967,79.31747673
宜蘭縣,五結鄉,成興村,294,840,68.73977087,382,31.26022913,1222,53,1275,0,1616,78.89851485
宜蘭縣,五結鄉,成興村,295,409,72.5177305,155,27.4822695,564,14,578,0,739,78.21380244
宜蘭縣,五結鄉,季新村,296,857,66.17760618,438,33.82239382,1295,50,1345,0,1734,77.56632065
宜蘭縣,五結鄉,季新村,297,383,67.31107206,186,32.68892794,569,23,592,0,770,76.88311688
宜蘭縣,三星鄉,員山村,298,106,57.2972973,79,42.7027027,185,3,188,0,246,76.42276423
宜蘭縣,三星鄉,天山村,299,253,61.40776699,159,38.59223301,412,20,432,0,584,73.97260274
宜蘭縣,三星鄉,天福村,300,384,70.20109689,163,29.79890311,547,42,589,0,796,73.99497487
宜蘭縣,三星鄉,雙賢村,301,327,69.27966102,145,30.72033898,472,39,511,0,672,76.04166667
宜蘭縣,三星鄉,人和村,302,184,54.92537313,151,45.07462687,335,26,361,0,463,77.96976242
宜蘭縣,三星鄉,義德村,303,436,53.36597307,381,46.63402693,817,46,863,0,1103,78.24116047
宜蘭縣,三星鄉,集慶村,304,535,61.49425287,335,38.50574713,870,40,910,0,1184,76.85810811
宜蘭縣,三星鄉,月眉村,305,346,59.0443686,240,40.9556314,586,41,627,0,800,78.375
宜蘭縣,三星鄉,拱照村,306,518,69.71736205,225,30.28263795,743,57,800,0,1004,79.6812749
宜蘭縣,三星鄉,大隱村,307,823,64.65043205,450,35.34956795,1273,43,1316,1,1682,78.24019025
宜蘭縣,三星鄉,大隱村,308,697,65.32333646,370,34.67666354,1067,67,1134,0,1474,76.93351425
宜蘭縣,三星鄉,行健村,309,326,68.05845511,153,31.94154489,479,33,512,0,667,76.76161919
宜蘭縣,三星鄉,萬德村,310,220,52.63157895,198,47.36842105,418,28,446,0,585,76.23931624
宜蘭縣,三星鄉,貴林村,311,191,54.7277937,158,45.2722063,349,16,365,1,495,73.73737374
宜蘭縣,三星鄉,萬富村,312,350,69.30693069,155,30.69306931,505,27,532,0,678,78.4660767
宜蘭縣,三星鄉,大義村,313,599,73.95061728,211,26.04938272,810,39,849,0,1087,78.1048758
宜蘭縣,三星鄉,尚武村,314,402,70.15706806,171,29.84293194,573,41,614,0,783,78.41634738
宜蘭縣,三星鄉,大洲村,315,748,75.7852077,239,24.2147923,987,41,1028,0,1257,81.78202068
宜蘭縣,三星鄉,尾塹村,316,694,78.95335609,185,21.04664391,879,43,922,0,1138,81.01933216
宜蘭縣,大同鄉,寒溪村,317,52,8.981001727,527,91.01899827,579,25,604,0,753,80.2124834
宜蘭縣,大同鄉,崙埤村,318,31,8.401084011,338,91.59891599,369,9,378,0,479,78.91440501
宜蘭縣,大同鄉,松羅村,319,138,32.62411348,285,67.37588652,423,17,440,0,557,78.994614
宜蘭縣,大同鄉,復興村,320,101,49.50980392,103,50.49019608,204,9,213,0,291,73.19587629
宜蘭縣,大同鄉,英士村,321,53,23.98190045,168,76.01809955,221,6,227,0,331,68.58006042
宜蘭縣,大同鄉,樂水村,322,31,13.96396396,191,86.03603604,222,11,233,0,303,76.89768977
宜蘭縣,大同鄉,太平村,323,25,56.81818182,19,43.18181818,44,2,46,0,68,67.64705882
宜蘭縣,大同鄉,四季村,325,26,5.689277899,431,94.3107221,457,29,486,0,613,79.2822186
宜蘭縣,大同鄉,南山村,326,113,25.56561086,329,74.43438914,442,11,453,0,543,83.42541436
宜蘭縣,大同鄉,茂安村,324,12,8,138,92,150,2,152,0,174,87.35632184
宜蘭縣,南澳鄉,南澳村,328,67,8.502538071,721,91.49746193,788,16,804,0,1019,78.90088322
宜蘭縣,南澳鄉,碧候村,329,41,7.008547009,544,92.99145299,585,13,598,0,736,81.25
宜蘭縣,南澳鄉,東岳村,327,23,7.1875,297,92.8125,320,10,330,0,417,79.13669065
宜蘭縣,南澳鄉,金岳村,330,18,6.593406593,255,93.40659341,273,3,276,0,364,75.82417582
宜蘭縣,南澳鄉,武塔村,331,65,21.45214521,238,78.54785479,303,4,307,0,409,75.06112469
宜蘭縣,南澳鄉,金洋村,332,18,6.02006689,281,93.97993311,299,15,314,0,407,77.14987715
宜蘭縣,南澳鄉,澳花村,333,39,8.647450111,412,91.35254989,451,18,469,0,625,75.04
桃園縣,桃園市,文化里,29,271,42.34375,369,57.65625,640,12,652,0,806,80.89330025
桃園縣,桃園市,文明里,30,509,45.98012647,598,54.01987353,1107,42,1149,0,1406,81.72119488
桃園縣,桃園市,武陵里,27,603,51.89328744,559,48.10671256,1162,50,1212,0,1542,78.59922179
桃園縣,桃園市,大林里,1,486,53.82059801,417,46.17940199,903,19,922,0,1104,83.51449275
桃園縣,桃園市,大林里,2,673,57.47224594,498,42.52775406,1171,28,1199,0,1430,83.84615385
桃園縣,桃園市,大林里,3,619,47.28800611,690,52.71199389,1309,14,1323,0,1635,80.91743119
桃園縣,桃園市,大林里,4,477,49.22600619,492,50.77399381,969,24,993,0,1161,85.52971576
桃園縣,桃園市,忠義里,152,515,40.39215686,760,59.60784314,1275,45,1320,0,1655,79.75830816
桃園縣,桃園市,忠義里,153,369,36.53465347,641,63.46534653,1010,13,1023,0,1281,79.85948478
桃園縣,桃園市,忠義里,154,712,44.52782989,887,55.47217011,1599,51,1650,0,2018,81.76412289
桃園縣,桃園市,忠義里,155,466,35.62691131,842,64.37308869,1308,19,1327,0,1634,81.21175031
桃園縣,桃園市,會稽里,160,481,35.05830904,891,64.94169096,1372,16,1388,0,1802,77.02552719
桃園縣,桃園市,會稽里,161,511,40.01566171,766,59.98433829,1277,27,1304,0,1638,79.60927961
桃園縣,桃園市,會稽里,162,418,36.76341249,719,63.23658751,1137,21,1158,0,1512,76.58730159
桃園縣,桃園市,長美里,39,457,60.36988111,300,39.63011889,757,11,768,0,925,83.02702703
桃園縣,桃園市,民生里,28,589,52.49554367,533,47.50445633,1122,31,1153,0,1409,81.83108588
桃園縣,桃園市,永興里,40,418,66.24405705,213,33.75594295,631,18,649,0,783,82.88633461
桃園縣,桃園市,永興里,41,420,55.26315789,340,44.73684211,760,20,780,0,943,82.71474019
桃園縣,桃園市,汴洲里,170,735,60.59356966,478,39.40643034,1213,40,1253,0,1492,83.98123324
桃園縣,桃園市,汴洲里,171,672,46.89462666,761,53.10537334,1433,62,1495,0,1844,81.07375271
桃園縣,桃園市,永安里,100,556,58.46477392,395,41.53522608,951,25,976,0,1183,82.50211327
桃園縣,桃園市,永安里,101,585,60.37151703,384,39.62848297,969,33,1002,0,1226,81.72920065
桃園縣,桃園市,永安里,102,641,56.08048994,502,43.91951006,1143,33,1176,0,1438,81.78025035
桃園縣,桃園市,東埔里,94,611,54.79820628,504,45.20179372,1115,28,1143,0,1393,82.05312276
桃園縣,桃園市,東埔里,95,601,55.03663004,491,44.96336996,1092,28,1120,0,1365,82.05128205
桃園縣,桃園市,東埔里,96,537,52.75049116,481,47.24950884,1018,34,1052,0,1286,81.80404355
桃園縣,桃園市,東門里,22,432,43.2,568,56.8,1000,14,1014,0,1274,79.59183673
桃園縣,桃園市,東門里,23,488,46.12476371,570,53.87523629,1058,10,1068,0,1333,80.12003001
桃園縣,桃園市,東山里,24,404,49.32844933,415,50.67155067,819,22,841,0,1026,81.96881092
桃園縣,桃園市,東山里,25,340,53.4591195,296,46.5408805,636,12,648,0,832,77.88461538
桃園縣,桃園市,萬壽里,26,369,51.17891817,352,48.82108183,721,31,752,0,914,82.27571116
桃園縣,桃園市,長安里,138,587,52.55147717,530,47.44852283,1117,33,1150,0,1408,81.67613636
桃園縣,桃園市,長安里,139,591,51.61572052,554,48.38427948,1145,33,1178,0,1459,80.74023304
桃園縣,桃園市,中埔里,108,525,63.79100851,298,36.20899149,823,31,854,0,1034,82.59187621
桃園縣,桃園市,中埔里,109,482,65.13513514,258,34.86486486,740,30,770,0,913,84.3373494
桃園縣,桃園市,西埔里,119,723,66.75900277,360,33.24099723,1083,51,1134,0,1348,84.12462908
桃園縣,桃園市,西埔里,120,585,66.10169492,300,33.89830508,885,33,918,0,1062,86.44067797
桃園縣,桃園市,西門里,37,546,51.90114068,506,48.09885932,1052,29,1081,1,1376,78.56104651
桃園縣,桃園市,中和里,142,710,61.20689655,450,38.79310345,1160,28,1188,0,1408,84.375
桃園縣,桃園市,文昌里,31,446,58.68421053,314,41.31578947,760,10,770,0,944,81.56779661
桃園縣,桃園市,新埔里,124,645,43.64005413,833,56.35994587,1478,25,1503,0,1819,82.62781748
桃園縣,桃園市,新埔里,125,595,40.61433447,870,59.38566553,1465,35,1500,0,1852,80.99352052
桃園縣,桃園市,新埔里,126,555,38.32872928,893,61.67127072,1448,42,1490,0,1730,86.12716763
桃園縣,桃園市,中山里,53,614,46.62110858,703,53.37889142,1317,22,1339,0,1616,82.85891089
桃園縣,桃園市,中山里,54,539,45.29411765,651,54.70588235,1190,25,1215,0,1487,81.70813719
桃園縣,桃園市,中山里,55,482,44.30147059,606,55.69852941,1088,18,1106,0,1334,82.90854573
桃園縣,桃園市,慈文里,121,540,47.95737123,586,52.04262877,1126,41,1167,0,1448,80.59392265
桃園縣,桃園市,慈文里,122,656,53.37672905,573,46.62327095,1229,30,1259,0,1540,81.75324675
桃園縣,桃園市,慈文里,123,542,47.00780572,611,52.99219428,1153,23,1176,0,1461,80.49281314
桃園縣,桃園市,西湖里,38,527,48.04010939,570,51.95989061,1097,22,1119,0,1334,83.88305847
桃園縣,桃園市,南門里,32,457,50,457,50,914,16,930,0,1148,81.01045296
桃園縣,桃園市,南門里,33,549,45.2970297,663,54.7029703,1212,21,1233,0,1487,82.91862811
桃園縣,桃園市,南門里,34,427,47.28682171,476,52.71317829,903,23,926,0,1118,82.82647585
桃園縣,桃園市,南門里,35,385,47.18137255,431,52.81862745,816,32,848,0,1045,81.14832536
桃園縣,桃園市,南華里,36,647,57.35815603,481,42.64184397,1128,22,1150,0,1375,83.63636364
桃園縣,桃園市,玉山里,75,626,60.07677543,416,39.92322457,1042,29,1071,0,1292,82.89473684
桃園縣,桃園市,玉山里,76,534,48.15148783,575,51.84851217,1109,32,1141,0,1389,82.14542837
桃園縣,桃園市,玉山里,77,566,48.08836024,611,51.91163976,1177,31,1208,0,1529,79.0058862
桃園縣,桃園市,中成里,72,511,63.55721393,293,36.44278607,804,32,836,0,1002,83.43313373
桃園縣,桃園市,中成里,73,674,55.79470199,534,44.20529801,1208,24,1232,0,1494,82.46318608
桃園縣,桃園市,中成里,74,329,37.38636364,551,62.61363636,880,27,907,1,1155,78.52813853
桃園縣,桃園市,中正里,67,485,43.14946619,639,56.85053381,1124,23,1147,0,1361,84.27626745
桃園縣,桃園市,中正里,68,388,40.20725389,577,59.79274611,965,21,986,0,1208,81.62251656
桃園縣,桃園市,中正里,69,625,48.18812645,672,51.81187355,1297,32,1329,0,1576,84.32741117
桃園縣,桃園市,北門里,143,717,56.59037096,550,43.40962904,1267,41,1308,0,1584,82.57575758
桃園縣,桃園市,雲林里,5,620,41.49933066,874,58.50066934,1494,21,1515,0,1837,82.47142079
桃園縣,桃園市,雲林里,6,387,36.89227836,662,63.10772164,1049,21,1070,0,1266,84.51816746
桃園縣,桃園市,雲林里,7,635,48.25227964,681,51.74772036,1316,39,1355,0,1655,81.87311178
桃園縣,桃園市,福林里,11,545,50.79217148,528,49.20782852,1073,35,1108,0,1297,85.42791056
桃園縣,桃園市,福林里,12,585,40.09595613,874,59.90404387,1459,27,1486,0,1784,83.29596413
桃園縣,桃園市,福林里,13,582,51.8254675,541,48.1745325,1123,35,1158,0,1398,82.83261803
桃園縣,桃園市,光興里,45,625,55.95344673,492,44.04655327,1117,36,1153,0,1402,82.23965763
桃園縣,桃園市,光興里,46,627,52.29357798,572,47.70642202,1199,37,1236,0,1464,84.42622951
桃園縣,桃園市,光興里,47,532,45.31516184,642,54.68483816,1174,18,1192,0,1821,65.45853926
桃園縣,桃園市,龍山里,91,438,57.55584757,323,42.44415243,761,27,788,0,950,82.94736842
桃園縣,桃園市,龍山里,92,267,36.92946058,456,63.07053942,723,19,742,0,926,80.12958963
桃園縣,桃園市,龍山里,93,329,29.24444444,796,70.75555556,1125,61,1186,0,1480,80.13513514
桃園縣,桃園市,龍岡里,80,667,41.07142857,957,58.92857143,1624,25,1649,0,1980,83.28282828
桃園縣,桃園市,龍岡里,81,466,33.04964539,944,66.95035461,1410,29,1439,0,1790,80.39106145
桃園縣,桃園市,成功里,148,540,43.02788845,715,56.97211155,1255,19,1274,0,1515,84.09240924
桃園縣,桃園市,成功里,149,696,45.07772021,848,54.92227979,1544,22,1566,0,1871,83.69855692
桃園縣,桃園市,青溪里,145,719,60.52188552,469,39.47811448,1188,28,1216,3,1505,80.79734219
桃園縣,桃園市,青溪里,146,556,61.30099228,351,38.69900772,907,35,942,1,1133,83.14210062
桃園縣,桃園市,青溪里,147,625,46.95717506,706,53.04282494,1331,24,1355,0,1614,83.95291202
桃園縣,桃園市,朝陽里,144,764,52.87197232,681,47.12802768,1445,51,1496,0,1867,80.12854847
桃園縣,桃園市,中興里,42,773,56.63003663,592,43.36996337,1365,36,1401,0,1671,83.84201077
桃園縣,桃園市,中興里,43,580,52.25225225,530,47.74774775,1110,26,1136,0,1348,84.27299703
桃園縣,桃園市,中興里,44,654,47.94721408,710,52.05278592,1364,30,1394,0,1719,81.0936591
桃園縣,桃園市,豐林里,16,631,49.76340694,637,50.23659306,1268,36,1304,0,1603,81.34747349
桃園縣,桃園市,豐林里,17,715,50.63739377,697,49.36260623,1412,34,1446,0,1776,81.41891892
桃園縣,桃園市,豐林里,18,614,44.42836469,768,55.57163531,1382,30,1412,0,1709,82.62141603
桃園縣,桃園市,建國里,19,584,50.7826087,566,49.2173913,1150,29,1179,0,1460,80.75342466
桃園縣,桃園市,建國里,20,563,42.6838514,756,57.3161486,1319,31,1350,0,1636,82.51833741
桃園縣,桃園市,建國里,21,428,45.24312896,518,54.75687104,946,12,958,0,1200,79.83333333
桃園縣,桃園市,大豐里,8,505,50.5,495,49.5,1000,27,1027,0,1232,83.36038961
桃園縣,桃園市,大豐里,9,662,51.59781761,621,48.40218239,1283,31,1314,0,1556,84.44730077
桃園縣,桃園市,大豐里,10,495,45.41284404,595,54.58715596,1090,25,1115,0,1378,80.91436865
桃園縣,桃園市,福安里,14,604,44.67455621,748,55.32544379,1352,40,1392,0,1732,80.36951501
桃園縣,桃園市,福安里,15,646,51.31056394,613,48.68943606,1259,39,1298,0,1555,83.47266881
桃園縣,桃園市,三民里,150,547,37.9334258,895,62.0665742,1442,25,1467,0,1750,83.82857143
桃園縣,桃園市,三民里,151,476,32.58042437,985,67.41957563,1461,37,1498,1,1837,81.54599891
桃園縣,桃園市,大興里,156,501,44.6126447,622,55.3873553,1123,22,1145,0,1414,80.97595474
桃園縣,桃園市,大興里,157,537,54.46247465,449,45.53752535,986,41,1027,0,1302,78.87864823
桃園縣,桃園市,大興里,158,767,45.33096927,925,54.66903073,1692,23,1715,0,2099,81.70557408
桃園縣,桃園市,大興里,159,436,50.6387921,425,49.3612079,861,33,894,0,1085,82.39631336
桃園縣,桃園市,春日里,167,479,42.61565836,645,57.38434164,1124,35,1159,0,1458,79.49245542
桃園縣,桃園市,春日里,168,640,52.63157895,576,47.36842105,1216,43,1259,0,1559,80.75689545
桃園縣,桃園市,春日里,169,456,42.18316374,625,57.81683626,1081,24,1105,0,1446,76.41770401
桃園縣,桃園市,信光里,97,534,52.45579568,484,47.54420432,1018,31,1049,0,1307,80.26013772
桃園縣,桃園市,信光里,98,645,48.64253394,681,51.35746606,1326,31,1357,0,1664,81.55048077
桃園縣,桃園市,信光里,99,517,55.95238095,407,44.04761905,924,28,952,0,1185,80.33755274
桃園縣,桃園市,中寧里,103,563,41.39705882,797,58.60294118,1360,15,1375,1,1697,81.02533883
桃園縣,桃園市,中寧里,104,454,40.71748879,661,59.28251121,1115,14,1129,0,1355,83.32103321
桃園縣,桃園市,中寧里,105,499,41.86241611,693,58.13758389,1192,18,1210,0,1453,83.27598073
桃園縣,桃園市,中寧里,106,471,44.81446242,580,55.18553758,1051,14,1065,0,1314,81.05022831
桃園縣,桃園市,中寧里,107,520,42.10526316,715,57.89473684,1235,13,1248,0,1542,80.93385214
桃園縣,桃園市,同安里,127,398,41.28630705,566,58.71369295,964,20,984,0,1235,79.67611336
桃園縣,桃園市,同安里,128,580,51.78571429,540,48.21428571,1120,28,1148,0,1414,81.18811881
桃園縣,桃園市,同安里,129,470,46.95304695,531,53.04695305,1001,7,1008,0,1224,82.35294118
桃園縣,桃園市,同安里,130,463,47.43852459,513,52.56147541,976,20,996,0,1246,79.93579454
桃園縣,桃園市,莊敬里,131,439,37.7472055,724,62.2527945,1163,20,1183,0,1418,83.42736248
桃園縣,桃園市,莊敬里,132,402,35.86083854,719,64.13916146,1121,14,1135,0,1409,80.5535841
桃園縣,桃園市,莊敬里,133,396,41.25,564,58.75,960,19,979,0,1190,82.26890756
桃園縣,桃園市,莊敬里,134,335,39.08984831,522,60.91015169,857,12,869,0,1119,77.65862377
桃園縣,桃園市,文中里,70,540,54.10821643,458,45.89178357,998,28,1026,0,1262,81.29952456
桃園縣,桃園市,文中里,71,410,39.42307692,630,60.57692308,1040,20,1060,0,1243,85.2775543
桃園縣,桃園市,泰山里,78,515,49.00095147,536,50.99904853,1051,29,1080,0,1303,82.8856485
桃園縣,桃園市,泰山里,79,610,45.2186805,739,54.7813195,1349,40,1389,0,1710,81.22807018
桃園縣,桃園市,中路里,48,547,48.3642794,584,51.6357206,1131,20,1151,0,1418,81.17066291
桃園縣,桃園市,中路里,49,533,39.80582524,806,60.19417476,1339,32,1371,0,1659,82.64014467
桃園縣,桃園市,中德里,64,407,33.63636364,803,66.36363636,1210,48,1258,0,1568,80.22959184
桃園縣,桃園市,中德里,65,423,40.79074253,614,59.20925747,1037,28,1065,0,1284,82.94392523
桃園縣,桃園市,中德里,66,776,63.14076485,453,36.85923515,1229,27,1256,0,1490,84.29530201
桃園縣,桃園市,龍祥里,87,388,37.02290076,660,62.97709924,1048,25,1073,0,1348,79.59940653
桃園縣,桃園市,龍祥里,88,492,42.48704663,666,57.51295337,1158,36,1194,0,1413,84.50106157
桃園縣,桃園市,龍祥里,89,479,40.11725293,715,59.88274707,1194,15,1209,0,1559,77.54971135
桃園縣,桃園市,龍祥里,90,480,41.70286707,671,58.29713293,1151,17,1168,0,1430,81.67832168
桃園縣,桃園市,大有里,163,404,37.79232928,665,62.20767072,1069,16,1085,0,1312,82.69817073
桃園縣,桃園市,大有里,164,292,29.94871795,683,70.05128205,975,22,997,0,1288,77.4068323
桃園縣,桃園市,寶山里,165,729,42.73153576,977,57.26846424,1706,20,1726,0,2156,80.05565863
桃園縣,桃園市,寶山里,166,695,36.75304072,1196,63.24695928,1891,42,1933,0,2429,79.5800741
桃園縣,桃園市,龍鳳里,84,583,40.68387997,850,59.31612003,1433,26,1459,0,1785,81.73669468
桃園縣,桃園市,龍鳳里,85,383,37.8458498,629,62.1541502,1012,12,1024,0,1231,83.18440292
桃園縣,桃園市,龍鳳里,86,421,37.69024172,696,62.30975828,1117,37,1154,0,1447,79.7512094
桃園縣,桃園市,龍安里,82,558,43.83346426,715,56.16653574,1273,27,1300,0,1608,80.84577114
桃園縣,桃園市,龍安里,83,512,44.75524476,632,55.24475524,1144,15,1159,0,1384,83.74277457
桃園縣,桃園市,自強里,135,750,44.56327986,933,55.43672014,1683,27,1710,0,2057,83.13077297
桃園縣,桃園市,自強里,136,536,43.50649351,696,56.49350649,1232,19,1251,1,1511,82.79285242
桃園縣,桃園市,自強里,137,354,36.08562691,627,63.91437309,981,4,985,0,1205,81.74273859
桃園縣,桃園市,中信里,50,569,46.37326813,658,53.62673187,1227,25,1252,0,1528,81.93717277
桃園縣,桃園市,中信里,51,447,50.45146727,439,49.54853273,886,15,901,0,1102,81.76043557
桃園縣,桃園市,中信里,52,379,46.44607843,437,53.55392157,816,29,845,0,1068,79.11985019
桃園縣,桃園市,長德里,140,673,52.78431373,602,47.21568627,1275,26,1301,0,1616,80.50742574
桃園縣,桃園市,長德里,141,638,50.51464766,625,49.48535234,1263,38,1301,0,1592,81.72110553
桃園縣,桃園市,中平里,56,529,37.94835007,865,62.05164993,1394,28,1422,0,1765,80.56657224
桃園縣,桃園市,中平里,57,640,47.65450484,703,52.34549516,1343,35,1378,0,1688,81.63507109
桃園縣,桃園市,中原里,58,409,36.51785714,711,63.48214286,1120,28,1148,0,1391,82.53055356
桃園縣,桃園市,中原里,59,453,40.23090586,673,59.76909414,1126,15,1141,0,1380,82.68115942
桃園縣,桃園市,中泰里,60,440,36.85092127,754,63.14907873,1194,16,1210,1,1482,81.64642375
桃園縣,桃園市,中泰里,61,419,31.5037594,911,68.4962406,1330,16,1346,0,1576,85.40609137
桃園縣,桃園市,中泰里,62,455,40.26548673,675,59.73451327,1130,18,1148,0,1410,81.41843972
桃園縣,桃園市,中泰里,63,354,29.84822934,832,70.15177066,1186,21,1207,0,1543,78.2242385
桃園縣,桃園市,南埔里,110,600,45.31722054,724,54.68277946,1324,10,1334,0,1623,82.19346888
桃園縣,桃園市,南埔里,111,570,52.2456462,521,47.7543538,1091,22,1113,0,1343,82.87416232
桃園縣,桃園市,寶慶里,112,686,39.06605923,1070,60.93394077,1756,24,1780,0,2149,82.82922289
桃園縣,桃園市,寶慶里,113,499,39.41548183,767,60.58451817,1266,24,1290,0,1633,78.99571341
桃園縣,桃園市,寶慶里,114,600,41.43646409,848,58.56353591,1448,31,1479,0,1844,80.20607375
桃園縣,桃園市,北埔里,115,483,40.21648626,718,59.78351374,1201,17,1218,0,1581,77.0398482
桃園縣,桃園市,北埔里,116,461,43.16479401,607,56.83520599,1068,24,1092,0,1347,81.06904232
桃園縣,桃園市,北埔里,117,740,46.39498433,855,53.60501567,1595,32,1627,0,2049,79.4045876
桃園縣,桃園市,北埔里,118,456,37.04305443,775,62.95694557,1231,15,1246,0,1553,80.2318094
桃園縣,龜山鄉,楓樹村,732,662,54.12919052,561,45.87080948,1223,33,1256,0,1533,81.93085453
桃園縣,龜山鄉,楓樹村,733,693,55,567,45,1260,29,1289,0,1540,83.7012987
桃園縣,龜山鄉,龜山村,672,612,57.51879699,452,42.48120301,1064,28,1092,0,1346,81.12927192
桃園縣,龜山鄉,龜山村,673,483,38.92022562,758,61.07977438,1241,61,1302,0,1588,81.98992443
桃園縣,龜山鄉,龜山村,674,643,46.69571532,734,53.30428468,1377,40,1417,0,1761,80.46564452
桃園縣,龜山鄉,兔坑村,690,479,46.32495164,555,53.67504836,1034,35,1069,1,1389,76.96184305
桃園縣,龜山鄉,兔坑村,691,514,50.29354207,508,49.70645793,1022,25,1047,0,1371,76.36761488
桃園縣,龜山鄉,大同村,679,525,43.53233831,681,56.46766169,1206,19,1225,0,1544,79.33937824
桃園縣,龜山鄉,大同村,680,568,51.03324349,545,48.96675651,1113,31,1144,0,1444,79.22437673
桃園縣,龜山鄉,大同村,681,407,37,693,63,1100,31,1131,0,1373,82.37436271
桃園縣,龜山鄉,山福村,711,565,48.37328767,603,51.62671233,1168,29,1197,0,1497,79.95991984
桃園縣,龜山鄉,山福村,712,513,48.21428571,551,51.78571429,1064,31,1095,0,1361,80.45554739
桃園縣,龜山鄉,山頂村,709,424,36.9982548,722,63.0017452,1146,44,1190,0,1469,81.00748809
桃園縣,龜山鄉,山頂村,710,808,45.24076148,978,54.75923852,1786,63,1849,0,2674,69.1473448
桃園縣,龜山鄉,陸光村,686,16,3.125,496,96.875,512,21,533,0,679,78.49779087
桃園縣,龜山鄉,精忠村,687,230,22.03065134,814,77.96934866,1044,26,1070,1,1258,85.05564388
桃園縣,龜山鄉,精忠村,688,77,9.948320413,697,90.05167959,774,33,807,0,916,88.10043668
桃園縣,龜山鄉,公西村,722,427,46.11231102,499,53.88768898,926,44,970,0,1187,81.71861837
桃園縣,龜山鄉,樂善村,725,654,55.84970111,517,44.15029889,1171,35,1206,0,1575,76.57142857
桃園縣,龜山鄉,樂善村,726,400,39.96003996,601,60.03996004,1001,24,1025,0,1339,76.54966393
桃園縣,龜山鄉,南上村,730,570,54.49330784,476,45.50669216,1046,44,1090,0,1308,83.33333333
桃園縣,龜山鄉,大坑村,729,658,61.61048689,410,38.38951311,1068,43,1111,0,1361,81.63115356
桃園縣,龜山鄉,中興村,682,402,40.03984064,602,59.96015936,1004,37,1041,0,1309,79.526356
桃園縣,龜山鄉,中興村,683,512,49.46859903,523,50.53140097,1035,26,1061,0,1328,79.89457831
桃園縣,龜山鄉,中興村,684,498,51.82101977,463,48.17898023,961,41,1002,0,1227,81.66259169
桃園縣,龜山鄉,山德村,706,515,42.80964256,688,57.19035744,1203,33,1236,0,1599,77.29831144
桃園縣,龜山鄉,山德村,707,580,48.90387858,606,51.09612142,1186,39,1225,0,1500,81.66666667
桃園縣,龜山鄉,山德村,708,656,48.34193073,701,51.65806927,1357,43,1400,0,1721,81.34805346
桃園縣,龜山鄉,新路村,675,494,39.64686998,752,60.35313002,1246,52,1298,0,1535,84.56026059
桃園縣,龜山鄉,新路村,676,428,50.11709602,426,49.88290398,854,28,882,2,1095,80.54794521
桃園縣,龜山鄉,新路村,677,430,41.03053435,618,58.96946565,1048,25,1073,0,1354,79.24667651
桃園縣,龜山鄉,新路村,678,512,49.75704568,517,50.24295432,1029,35,1064,0,1263,84.24386382
桃園縣,龜山鄉,嶺頂村,699,453,62.56906077,271,37.43093923,724,37,761,0,976,77.97131148
桃園縣,龜山鄉,嶺頂村,700,423,50.35714286,417,49.64285714,840,29,869,0,1078,80.6122449
桃園縣,龜山鄉,嶺頂村,701,430,51.19047619,410,48.80952381,840,20,860,0,1120,76.78571429
桃園縣,龜山鄉,龍壽村,697,207,47.04545455,233,52.95454545,440,21,461,0,602,76.57807309
桃園縣,龜山鄉,龍壽村,698,549,69.40581542,242,30.59418458,791,27,818,0,954,85.7442348
桃園縣,龜山鄉,舊路村,704,537,66.13300493,275,33.86699507,812,54,866,0,1047,82.71251194
桃園縣,龜山鄉,舊路村,705,440,63.03724928,258,36.96275072,698,44,742,0,905,81.98895028
桃園縣,龜山鄉,大崗村,720,411,34.07960199,795,65.92039801,1206,71,1277,0,1625,78.58461538
桃園縣,龜山鄉,大崗村,721,650,54.25709516,548,45.74290484,1198,41,1239,0,1518,81.62055336
桃園縣,龜山鄉,文化村,723,538,50.61147695,525,49.38852305,1063,32,1095,0,1333,82.14553638
桃園縣,龜山鄉,文化村,724,590,48.51973684,626,51.48026316,1216,28,1244,1,1568,79.33673469
桃園縣,龜山鄉,南美村,731,557,49.03169014,579,50.96830986,1136,35,1171,0,1432,81.77374302
桃園縣,龜山鄉,幸福村,713,436,39.70856102,662,60.29143898,1098,35,1133,0,1456,77.81593407
桃園縣,龜山鄉,幸福村,714,460,41.47880974,649,58.52119026,1109,37,1146,0,1494,76.70682731
桃園縣,龜山鄉,幸福村,715,427,39.50046253,654,60.49953747,1081,36,1117,0,1437,77.73138483
桃園縣,龜山鄉,福源村,689,634,44.27374302,798,55.72625698,1432,50,1482,0,1841,80.49972841
桃園縣,龜山鄉,龍華村,695,488,48.26904055,523,51.73095945,1011,27,1038,0,1305,79.54022989
桃園縣,龜山鄉,龍華村,696,510,45.61717352,608,54.38282648,1118,19,1137,0,1430,79.51048951
桃園縣,龜山鄉,迴龍村,692,669,52.51177394,605,47.48822606,1274,32,1306,0,1620,80.61728395
桃園縣,龜山鄉,迴龍村,693,487,45.30232558,588,54.69767442,1075,19,1094,0,1379,79.33284989
桃園縣,龜山鄉,迴龍村,694,520,46.59498208,596,53.40501792,1116,33,1149,0,1461,78.64476386
桃園縣,龜山鄉,新嶺村,702,450,39.75265018,682,60.24734982,1132,33,1165,0,1501,77.61492338
桃園縣,龜山鄉,新嶺村,703,650,53.49794239,565,46.50205761,1215,37,1252,0,1614,77.57125155
桃園縣,龜山鄉,大湖村,716,423,37.00787402,720,62.99212598,1143,24,1167,0,1478,78.95805142
桃園縣,龜山鄉,大湖村,717,349,43.51620948,453,56.48379052,802,10,812,0,981,82.77268094
桃園縣,龜山鄉,大華村,718,554,45.18760196,672,54.81239804,1226,22,1248,0,1582,78.8874842
桃園縣,龜山鄉,大華村,719,686,48.82562278,719,51.17437722,1405,20,1425,0,1765,80.73654391
桃園縣,龜山鄉,長庚村,727,466,46.18434093,543,53.81565907,1009,24,1033,0,1300,79.46153846
桃園縣,龜山鄉,長庚村,728,571,47.74247492,625,52.25752508,1196,19,1215,0,1462,83.10533516
桃園縣,龜山鄉,新興村,685,336,27.97668609,865,72.02331391,1201,36,1237,0,1730,71.50289017
桃園縣,八德市,興仁里,463,632,51.59183673,593,48.40816327,1225,46,1271,0,1617,78.60235003
桃園縣,八德市,興仁里,464,546,41.14544084,781,58.85455916,1327,41,1368,0,2008,68.12749004
桃園縣,八德市,福興里,465,656,54.71226022,543,45.28773978,1199,26,1225,0,1475,83.05084746
桃園縣,八德市,福興里,466,413,38.5620915,658,61.4379085,1071,51,1122,0,1378,81.42235123
桃園縣,八德市,瑞豐里,467,344,30.55062167,782,69.44937833,1126,43,1169,0,1395,83.79928315
桃園縣,八德市,瑞發里,471,483,39.59016393,737,60.40983607,1220,54,1274,0,1523,83.65068943
桃園縣,八德市,瑞發里,472,403,31.09567901,893,68.90432099,1296,56,1352,0,1670,80.95808383
桃園縣,八德市,瑞德里,473,400,31.10419907,886,68.89580093,1286,49,1335,0,1580,84.49367089
桃園縣,八德市,瑞德里,474,261,20.37470726,1020,79.62529274,1281,12,1293,0,1624,79.6182266
桃園縣,八德市,瑞祥里,475,341,28.20512821,868,71.79487179,1209,56,1265,0,1517,83.38826632
桃園縣,八德市,瑞祥里,476,256,20.96642097,965,79.03357903,1221,39,1260,0,1511,83.38848445
桃園縣,八德市,廣興里,477,744,49.73262032,752,50.26737968,1496,53,1549,0,1945,79.64010283
桃園縣,八德市,廣興里,478,620,45.18950437,752,54.81049563,1372,53,1425,0,1737,82.03799655
桃園縣,八德市,廣興里,479,454,44.64110128,563,55.35889872,1017,22,1039,0,1214,85.58484349
桃園縣,八德市,廣隆里,480,568,33.66923533,1119,66.33076467,1687,83,1770,0,2074,85.34233365
桃園縣,八德市,廣隆里,481,367,44.59295261,456,55.40704739,823,22,845,0,1007,83.91261172
桃園縣,八德市,竹園里,482,481,40.90136054,695,59.09863946,1176,47,1223,0,1517,80.61964403
桃園縣,八德市,竹園里,483,542,48.34968778,579,51.65031222,1121,21,1142,1,1408,81.10795455
桃園縣,八德市,霄裡里,484,591,48.12703583,637,51.87296417,1228,36,1264,0,1607,78.65588052
桃園縣,八德市,霄裡里,485,149,16.74157303,741,83.25842697,890,32,922,0,1126,81.88277087
桃園縣,八德市,霄裡里,486,209,21.41393443,767,78.58606557,976,44,1020,0,1197,85.21303258
桃園縣,八德市,茄苳里,489,705,53.8579068,604,46.1420932,1309,39,1348,0,1616,83.41584158
桃園縣,八德市,茄苳里,490,540,51.87319885,501,48.12680115,1041,32,1073,0,1323,81.10355253
桃園縣,八德市,茄苳里,491,453,44.54277286,564,55.45722714,1017,34,1051,0,1269,82.82111899
桃園縣,八德市,高明里,492,686,49.6382055,696,50.3617945,1382,49,1431,0,1768,80.93891403
桃園縣,八德市,高明里,493,434,42.54901961,586,57.45098039,1020,44,1064,0,1307,81.40780413
桃園縣,八德市,白鷺里,495,782,55.6980057,622,44.3019943,1404,46,1450,0,1748,82.95194508
桃園縣,八德市,白鷺里,496,217,38.00350263,354,61.99649737,571,23,594,0,732,81.14754098
桃園縣,八德市,大湳里,497,539,57.03703704,406,42.96296296,945,27,972,0,1161,83.72093023
桃園縣,八德市,大湳里,498,567,47.09302326,637,52.90697674,1204,30,1234,0,1575,78.34920635
桃園縣,八德市,大安里,504,539,58.65070729,380,41.34929271,919,31,950,0,1148,82.75261324
桃園縣,八德市,大安里,505,549,47.0437018,618,52.9562982,1167,28,1195,0,1425,83.85964912
桃園縣,八德市,大興里,507,365,41.05736783,524,58.94263217,889,20,909,0,1117,81.37869293
桃園縣,八德市,大興里,508,522,55.65031983,416,44.34968017,938,29,967,0,1106,87.43218807
桃園縣,八德市,大和里,514,512,32.75751759,1051,67.24248241,1563,39,1602,0,1997,80.2203305
桃園縣,八德市,大和里,515,396,41.68421053,554,58.31578947,950,29,979,0,1225,79.91836735
桃園縣,八德市,大同里,521,79,4.49374289,1679,95.50625711,1758,59,1817,0,2109,86.15457563
桃園縣,八德市,大同里,522,600,50.37783375,591,49.62216625,1191,36,1227,0,1455,84.32989691
桃園縣,八德市,大成里,524,699,50.5788712,683,49.4211288,1382,47,1429,0,1706,83.76318875
桃園縣,八德市,大成里,525,551,39.18918919,855,60.81081081,1406,64,1470,0,1756,83.71298405
桃園縣,八德市,大義里,526,366,30.83403538,821,69.16596462,1187,60,1247,0,1560,79.93589744
桃園縣,八德市,大義里,527,486,38.14756672,788,61.85243328,1274,47,1321,0,1603,82.40798503
桃園縣,八德市,大忠里,528,404,50.69008783,393,49.30991217,797,25,822,0,1008,81.54761905
桃園縣,八德市,大忠里,529,135,21.22641509,501,78.77358491,636,42,678,0,868,78.11059908
桃園縣,八德市,大福里,535,604,52.06896552,556,47.93103448,1160,27,1187,0,1469,80.80326753
桃園縣,八德市,大福里,536,414,50.12106538,412,49.87893462,826,19,845,0,1039,81.32820019
桃園縣,八德市,大福里,537,281,34.69135802,529,65.30864198,810,7,817,0,951,85.90956887
桃園縣,八德市,大勇里,540,498,50.97236438,479,49.02763562,977,38,1015,0,1186,85.58178752
桃園縣,八德市,大勇里,541,376,44.76190476,464,55.23809524,840,19,859,0,1054,81.49905123
桃園縣,八德市,大信里,518,555,39.72798855,842,60.27201145,1397,35,1432,0,1889,75.80730545
桃園縣,八德市,大信里,519,241,27.48004561,636,72.51995439,877,63,940,0,1140,82.45614035
桃園縣,八德市,大信里,520,23,2.944942382,758,97.05505762,781,159,940,0,1868,50.32119914
桃園縣,八德市,大華里,511,395,39.73843058,599,60.26156942,994,17,1011,0,1219,82.93683347
桃園縣,八德市,大華里,512,512,41.65988609,717,58.34011391,1229,23,1252,0,1613,77.61934284
桃園縣,八德市,大華里,513,353,35.26473526,648,64.73526474,1001,41,1042,1,1274,81.78963893
桃園縣,八德市,大仁里,500,735,49.32885906,755,50.67114094,1490,28,1518,0,1834,82.76990185
桃園縣,八德市,大仁里,501,569,52.73401297,510,47.26598703,1079,36,1115,0,1360,81.98529412
桃園縣,八德市,大智里,530,294,27.86729858,761,72.13270142,1055,57,1112,0,1327,83.79804069
桃園縣,八德市,大智里,531,258,28.57142857,645,71.42857143,903,14,917,0,1075,85.30232558
桃園縣,八德市,瑞泰里,469,521,41.91472245,722,58.08527755,1243,33,1276,0,1591,80.20113136
桃園縣,八德市,瑞泰里,470,595,49.25496689,613,50.74503311,1208,34,1242,0,1555,79.87138264
桃園縣,八德市,大昌里,516,361,45.52332913,432,54.47667087,793,31,824,0,962,85.65488565
桃園縣,八德市,大昌里,517,492,37.27272727,828,62.72727273,1320,47,1367,0,1697,80.55391868
桃園縣,八德市,大正里,533,442,49.44071588,452,50.55928412,894,14,908,0,1091,83.2263978
桃園縣,八德市,大正里,534,308,37.46958637,514,62.53041363,822,10,832,0,1057,78.71333964
桃園縣,八德市,大強里,538,594,47.14285714,666,52.85714286,1260,36,1296,0,1592,81.40703518
桃園縣,八德市,大強里,539,477,57.1257485,358,42.8742515,835,26,861,1,1041,82.70893372
桃園縣,八德市,大發里,499,698,52.56024096,630,47.43975904,1328,42,1370,0,1722,79.55865273
桃園縣,八德市,大明里,502,803,53.32005312,703,46.67994688,1506,32,1538,0,1894,81.20380148
桃園縣,八德市,大明里,503,149,50.85324232,144,49.14675768,293,6,299,0,379,78.89182058
桃園縣,八德市,大竹里,506,589,50.90751945,568,49.09248055,1157,42,1199,0,1492,80.36193029
桃園縣,八德市,大慶里,523,488,43.37777778,637,56.62222222,1125,29,1154,0,1414,81.61244696
桃園縣,八德市,大千里,543,413,32.46855346,859,67.53144654,1272,54,1326,0,1611,82.30912477
桃園縣,八德市,大榮里,542,561,45.98360656,659,54.01639344,1220,25,1245,0,1547,80.47834518
桃園縣,八德市,茄明里,487,527,41.3982718,746,58.6017282,1273,37,1310,0,1639,79.92678462
桃園縣,八德市,茄明里,488,402,38.21292776,650,61.78707224,1052,23,1075,0,1394,77.11621234
桃園縣,八德市,高城里,494,710,43.47826087,923,56.52173913,1633,47,1680,1,2080,80.76923077
桃園縣,八德市,瑞興里,468,851,48.8238669,892,51.1761331,1743,53,1796,0,2191,81.97170242
桃園縣,八德市,大愛里,509,264,35.67567568,476,64.32432432,740,31,771,0,937,82.28388474
桃園縣,八德市,大愛里,510,294,39.7834912,445,60.2165088,739,12,751,0,881,85.24404086
桃園縣,八德市,大宏里,532,651,38.42975207,1043,61.57024793,1694,21,1715,0,2069,82.89028516
桃園縣,八德市,大漢里,544,357,36.76622039,614,63.23377961,971,27,998,0,1253,79.64884278
桃園縣,八德市,大漢里,545,316,28.29006267,801,71.70993733,1117,23,1140,0,1355,84.13284133
桃園縣,蘆竹鄉,新興村,734,710,72.59713701,268,27.40286299,978,42,1020,0,1220,83.60655738
桃園縣,蘆竹鄉,新興村,735,544,66.09963548,279,33.90036452,823,29,852,0,1014,84.02366864
桃園縣,蘆竹鄉,新興村,736,486,55.73394495,386,44.26605505,872,28,900,0,1093,82.34217749
桃園縣,蘆竹鄉,中福村,737,766,56.53136531,589,43.46863469,1355,44,1399,0,1737,80.54116292
桃園縣,蘆竹鄉,中福村,738,923,69.34635612,408,30.65364388,1331,45,1376,0,1654,83.19226119
桃園縣,蘆竹鄉,新莊村,739,897,63.61702128,513,36.38297872,1410,10,1420,0,1785,79.55182073
桃園縣,蘆竹鄉,新莊村,740,568,57.31584258,423,42.68415742,991,48,1039,0,1246,83.38683788
桃園縣,蘆竹鄉,大竹村,745,670,47.89135096,729,52.10864904,1399,28,1427,0,1708,83.54800937
桃園縣,蘆竹鄉,大竹村,746,471,48.11031665,508,51.88968335,979,28,1007,0,1219,82.60869565
桃園縣,蘆竹鄉,大華村,748,20,3.546099291,544,96.45390071,564,29,593,0,747,79.38420348
桃園縣,蘆竹鄉,大華村,749,22,3.120567376,683,96.87943262,705,27,732,0,846,86.5248227
桃園縣,蘆竹鄉,蘆竹村,750,526,66.49810367,265,33.50189633,791,44,835,0,1000,83.5
桃園縣,蘆竹鄉,蘆竹村,751,625,76.499388,192,23.500612,817,39,856,0,979,87.43615935
桃園縣,蘆竹鄉,蘆竹村,752,509,65.25641026,271,34.74358974,780,37,817,0,966,84.57556936
桃園縣,蘆竹鄉,南崁村,760,494,54.52538631,412,45.47461369,906,27,933,0,1136,82.13028169
桃園縣,蘆竹鄉,南崁村,761,554,48.38427948,591,51.61572052,1145,31,1176,0,1571,74.85677912
桃園縣,蘆竹鄉,錦興村,762,612,53.40314136,534,46.59685864,1146,42,1188,0,1399,84.91779843
桃園縣,蘆竹鄉,錦興村,763,662,46.2613557,769,53.7386443,1431,28,1459,0,1781,81.92026951
桃園縣,蘆竹鄉,五福村,767,808,45.98747866,949,54.01252134,1757,36,1793,0,2178,82.32323232
桃園縣,蘆竹鄉,五福村,768,740,41.20267261,1056,58.79732739,1796,26,1822,0,2280,79.9122807
桃園縣,蘆竹鄉,內厝村,775,414,57.5,306,42.5,720,30,750,0,880,85.22727273
桃園縣,蘆竹鄉,內厝村,776,513,62.94478528,302,37.05521472,815,40,855,0,1037,82.44937319
桃園縣,蘆竹鄉,山鼻村,777,690,60,460,40,1150,55,1205,0,1485,81.14478114
桃園縣,蘆竹鄉,山腳村,778,598,68.49942726,275,31.50057274,873,42,915,0,1121,81.6235504
桃園縣,蘆竹鄉,山腳村,779,518,58.79682179,363,41.20317821,881,32,913,0,1113,82.03054807
桃園縣,蘆竹鄉,山腳村,780,499,64.55368693,274,35.44631307,773,36,809,0,988,81.88259109
桃園縣,蘆竹鄉,外社村,781,699,70.53481332,292,29.46518668,991,58,1049,0,1241,84.52860596
桃園縣,蘆竹鄉,坑子村,782,948,74.76340694,320,25.23659306,1268,66,1334,0,1580,84.43037975
桃園縣,蘆竹鄉,坑口村,783,427,60.82621083,275,39.17378917,702,35,737,0,883,83.46545866
桃園縣,蘆竹鄉,坑口村,784,660,63.76811594,375,36.23188406,1035,67,1102,2,1316,83.73860182
桃園縣,蘆竹鄉,海湖村,785,518,43.82402707,664,56.17597293,1182,41,1223,0,1595,76.67711599
桃園縣,蘆竹鄉,海湖村,786,507,51.68195719,474,48.31804281,981,52,1033,0,1300,79.46153846
桃園縣,蘆竹鄉,海湖村,787,485,50.67920585,472,49.32079415,957,44,1001,0,1273,78.63315004
桃園縣,蘆竹鄉,南榮村,758,404,53.15789474,356,46.84210526,760,21,781,0,1000,78.1
桃園縣,蘆竹鄉,南榮村,759,677,44.24836601,853,55.75163399,1530,34,1564,0,1906,82.05666317
桃園縣,蘆竹鄉,南興村,753,673,65.27643065,358,34.72356935,1031,43,1074,0,1246,86.19582665
桃園縣,蘆竹鄉,南興村,754,687,40.41176471,1013,59.58823529,1700,31,1731,0,2118,81.72804533
桃園縣,蘆竹鄉,南興村,755,487,41.83848797,677,58.16151203,1164,26,1190,0,1472,80.8423913
桃園縣,蘆竹鄉,南興村,756,847,43.30265849,1109,56.69734151,1956,36,1992,0,2528,78.79746835
桃園縣,蘆竹鄉,南興村,757,951,41.61925602,1334,58.38074398,2285,31,2316,1,2868,80.75313808
桃園縣,蘆竹鄉,長興村,766,748,54.2422045,631,45.7577955,1379,33,1412,0,1787,79.01510912
桃園縣,蘆竹鄉,錦中村,764,398,55.43175487,320,44.56824513,718,18,736,0,883,83.35220838
桃園縣,蘆竹鄉,錦中村,765,439,57.53604194,324,42.46395806,763,27,790,0,967,81.69596691
桃園縣,蘆竹鄉,富竹村,747,683,72.89220918,254,27.10779082,937,40,977,0,1150,84.95652174
桃園縣,蘆竹鄉,上竹村,741,513,52.40040858,466,47.59959142,979,20,999,0,1201,83.18068276
桃園縣,蘆竹鄉,上竹村,742,414,49.69987995,419,50.30012005,833,18,851,0,1001,85.01498501
桃園縣,蘆竹鄉,宏竹村,743,523,60.18411968,346,39.81588032,869,46,915,0,1074,85.19553073
桃園縣,蘆竹鄉,宏竹村,744,624,66.24203822,318,33.75796178,942,36,978,0,1157,84.52895419
桃園縣,蘆竹鄉,瓦窯村,774,530,41.05344694,761,58.94655306,1291,39,1330,0,1782,74.6352413
桃園縣,蘆竹鄉,營盤村,772,570,40.86021505,825,59.13978495,1395,20,1415,0,1793,78.9180145
桃園縣,蘆竹鄉,營盤村,773,727,43.95405079,927,56.04594921,1654,37,1691,0,2104,80.37072243
桃園縣,蘆竹鄉,羊稠村,769,715,47.47675963,791,52.52324037,1506,47,1553,0,1855,83.71967655
桃園縣,蘆竹鄉,羊稠村,770,428,36.30195081,751,63.69804919,1179,17,1196,0,1431,83.57791754
桃園縣,蘆竹鄉,羊稠村,771,679,36.80216802,1166,63.19783198,1845,23,1868,0,2299,81.25271857
桃園縣,大園鄉,大園村,788,869,59.11564626,601,40.88435374,1470,57,1527,0,1835,83.21525886
桃園縣,大園鄉,大園村,789,624,49.64200477,633,50.35799523,1257,57,1314,0,1578,83.26996198
桃園縣,大園鄉,大園村,790,745,53.02491103,660,46.97508897,1405,57,1462,0,1851,78.98433279
桃園縣,大園鄉,田心村,791,624,60.58252427,406,39.41747573,1030,40,1070,0,1302,82.1812596
桃園縣,大園鄉,田心村,792,565,51.03884372,542,48.96115628,1107,32,1139,0,1439,79.15218902
桃園縣,大園鄉,田心村,793,743,58.2745098,532,41.7254902,1275,55,1330,0,1678,79.26102503
桃園縣,大園鄉,溪海村,794,676,55.09372453,551,44.90627547,1227,66,1293,1,1616,80.01237624
桃園縣,大園鄉,溪海村,795,758,59.45098039,517,40.54901961,1275,80,1355,0,1767,76.6836446
桃園縣,大園鄉,和平村,796,744,67.39130435,360,32.60869565,1104,68,1172,0,1428,82.07282913
桃園縣,大園鄉,橫峰村,797,760,55.51497443,609,44.48502557,1369,53,1422,0,1802,78.91231964
桃園縣,大園鄉,橫峰村,798,746,51.44827586,704,48.55172414,1450,79,1529,0,1935,79.01808786
桃園縣,大園鄉,橫峰村,799,605,53.35097002,529,46.64902998,1134,37,1171,0,1461,80.15058179
桃園縣,大園鄉,五權村,800,593,66.85456595,294,33.14543405,887,49,936,0,1102,84.93647913
桃園縣,大園鄉,五權村,801,707,65.22140221,377,34.77859779,1084,44,1128,0,1381,81.67994207
桃園縣,大園鄉,五權村,802,628,60.85271318,404,39.14728682,1032,45,1077,0,1315,81.90114068
桃園縣,大園鄉,埔心村,803,704,68.8172043,319,31.1827957,1023,46,1069,0,1265,84.50592885
桃園縣,大園鄉,埔心村,804,604,52.24913495,552,47.75086505,1156,46,1202,0,1493,80.5090422
桃園縣,大園鄉,埔心村,805,722,54.65556397,599,45.34443603,1321,64,1385,0,1682,82.34244946
桃園縣,大園鄉,大海村,806,458,41.78832117,638,58.21167883,1096,45,1141,0,1371,83.22392414
桃園縣,大園鄉,建華村,807,19,3.236797274,568,96.76320273,587,29,616,1,721,85.4368932
桃園縣,大園鄉,三石村,808,546,61.76470588,338,38.23529412,884,49,933,0,1129,82.63950399
桃園縣,大園鄉,三石村,809,552,46.62162162,632,53.37837838,1184,63,1247,0,1453,85.82243634
桃園縣,大園鄉,果林村,810,771,54.2575651,650,45.7424349,1421,16,1437,0,1782,80.63973064
桃園縣,大園鄉,果林村,811,494,49.35064935,507,50.64935065,1001,42,1043,0,1329,78.4800602
桃園縣,大園鄉,果林村,812,591,54.62107209,491,45.37892791,1082,48,1130,0,1448,78.03867403
桃園縣,大園鄉,竹圍村,813,328,48.66468843,346,51.33531157,674,29,703,0,824,85.31553398
桃園縣,大園鄉,竹圍村,814,554,48.09027778,598,51.90972222,1152,40,1192,0,1517,78.57613711
桃園縣,大園鄉,海口村,815,543,49.14027149,562,50.85972851,1105,59,1164,0,1437,81.00208768
桃園縣,大園鄉,沙崙村,816,424,48.07256236,458,51.92743764,882,57,939,0,1200,78.25
桃園縣,大園鄉,沙崙村,817,545,54.22885572,460,45.77114428,1005,56,1061,0,1370,77.44525547
桃園縣,大園鄉,後厝村,818,785,55.39872971,632,44.60127029,1417,12,1429,0,1759,81.23934053
桃園縣,大園鄉,圳頭村,819,364,53.2942899,319,46.7057101,683,28,711,0,900,79
桃園縣,大園鄉,圳頭村,820,568,65.89327146,294,34.10672854,862,34,896,0,1125,79.64444444
桃園縣,大園鄉,內海村,821,733,53.66032211,633,46.33967789,1366,73,1439,0,1785,80.6162465
桃園縣,大園鄉,北港村,822,560,60.02143623,373,39.97856377,933,45,978,0,1224,79.90196078
桃園縣,大園鄉,北港村,823,417,50.42321644,410,49.57678356,827,49,876,0,1128,77.65957447
桃園縣,大園鄉,南港村,824,574,53.64485981,496,46.35514019,1070,40,1110,0,1456,76.23626374
桃園縣,大園鄉,南港村,825,438,48.02631579,474,51.97368421,912,28,940,0,1244,75.56270096
桃園縣,大溪鎮,興和里,615,421,62.27810651,255,37.72189349,676,23,699,0,817,85.55691554
桃園縣,大溪鎮,興和里,616,413,60.64610866,268,39.35389134,681,24,705,0,853,82.64947245
桃園縣,大溪鎮,福仁里,617,610,70.35755479,257,29.64244521,867,24,891,0,1079,82.57645968
桃園縣,大溪鎮,一心里,621,517,56.68859649,395,43.31140351,912,35,947,1,1165,81.28755365
桃園縣,大溪鎮,一心里,622,560,54.58089669,466,45.41910331,1026,22,1048,0,1268,82.64984227
桃園縣,大溪鎮,一心里,623,488,56.54692932,375,43.45307068,863,27,890,0,1064,83.64661654
桃園縣,大溪鎮,一德里,624,647,51.96787149,598,48.03212851,1245,30,1275,0,1595,79.93730408
桃園縣,大溪鎮,一德里,625,653,65.16966068,349,34.83033932,1002,29,1031,0,1212,85.0660066
桃園縣,大溪鎮,一德里,626,596,56.76190476,454,43.23809524,1050,41,1091,0,1353,80.63562454
桃園縣,大溪鎮,月眉里,627,585,67.31875719,284,32.68124281,869,29,898,0,1065,84.31924883
桃園縣,大溪鎮,永福里,628,492,67.76859504,234,32.23140496,726,27,753,0,947,79.51425554
桃園縣,大溪鎮,美華里,632,549,64.58823529,301,35.41176471,850,31,881,0,1043,84.46788111
桃園縣,大溪鎮,美華里,633,542,65.14423077,290,34.85576923,832,39,871,0,1032,84.39922481
桃園縣,大溪鎮,美華里,634,388,66.78141136,193,33.21858864,581,27,608,0,737,82.49660787
桃園縣,大溪鎮,福安里,635,615,66.7752443,306,33.2247557,921,46,967,0,1214,79.65403624
桃園縣,大溪鎮,福安里,636,554,73.67021277,198,26.32978723,752,38,790,0,941,83.95324123
桃園縣,大溪鎮,復興里,637,491,66.62143826,246,33.37856174,737,53,790,0,969,81.52734778
桃園縣,大溪鎮,新峰里,638,307,60.19607843,203,39.80392157,510,3,513,0,636,80.66037736
桃園縣,大溪鎮,新峰里,639,144,68.57142857,66,31.42857143,210,11,221,0,282,78.36879433
桃園縣,大溪鎮,康安里,629,598,69.61583236,261,30.38416764,859,24,883,0,1069,82.60056127
桃園縣,大溪鎮,義和里,630,541,69.00510204,243,30.99489796,784,43,827,0,976,84.73360656
桃園縣,大溪鎮,義和里,631,294,68.53146853,135,31.46853147,429,36,465,0,607,76.6062603
桃園縣,大溪鎮,瑞興里,642,718,66.35859519,364,33.64140481,1082,56,1138,0,1379,82.5235678
桃園縣,大溪鎮,瑞興里,643,382,48.66242038,403,51.33757962,785,29,814,0,1094,74.40585009
桃園縣,大溪鎮,中新里,640,464,69.46107784,204,30.53892216,668,35,703,0,820,85.73170732
桃園縣,大溪鎮,中新里,641,353,60.23890785,233,39.76109215,586,24,610,0,765,79.73856209
桃園縣,大溪鎮,仁義里,648,185,23.03860523,618,76.96139477,803,49,852,0,1050,81.14285714
桃園縣,大溪鎮,仁義里,649,79,12.32449298,562,87.67550702,641,49,690,0,824,83.73786408
桃園縣,大溪鎮,仁義里,650,90,13.23529412,590,86.76470588,680,11,691,0,836,82.65550239
桃園縣,大溪鎮,僑愛里,647,115,8.013937282,1320,91.98606272,1435,64,1499,0,1765,84.92917847
桃園縣,大溪鎮,仁善里,644,522,63.19612591,304,36.80387409,826,38,864,0,1022,84.54011742
桃園縣,大溪鎮,仁善里,645,252,40.64516129,368,59.35483871,620,19,639,0,796,80.27638191
桃園縣,大溪鎮,仁善里,646,243,33.24213406,488,66.75786594,731,27,758,0,937,80.89647812
桃園縣,大溪鎮,仁愛里,653,569,54.65898175,472,45.34101825,1041,37,1078,0,1275,84.54901961
桃園縣,大溪鎮,仁愛里,654,300,37.59398496,498,62.40601504,798,23,821,0,1016,80.80708661
桃園縣,大溪鎮,仁武里,655,217,28.5151117,544,71.4848883,761,21,782,0,990,78.98989899
桃園縣,大溪鎮,仁武里,656,408,42.7672956,546,57.2327044,954,36,990,0,1196,82.77591973
桃園縣,大溪鎮,員林里,663,396,42.21748401,542,57.78251599,938,35,973,0,1173,82.94970162
桃園縣,大溪鎮,南興里,660,579,56.21359223,451,43.78640777,1030,41,1071,0,1352,79.21597633
桃園縣,大溪鎮,南興里,661,739,62.3628692,446,37.6371308,1185,57,1242,0,1502,82.689747
桃園縣,大溪鎮,南興里,662,504,46.79665738,573,53.20334262,1077,51,1128,0,1389,81.20950324
桃園縣,大溪鎮,瑞源里,666,280,39.10614525,436,60.89385475,716,16,732,0,854,85.71428571
桃園縣,大溪鎮,瑞源里,667,414,52.0754717,381,47.9245283,795,23,818,0,1033,79.18683446
桃園縣,大溪鎮,瑞源里,668,553,60.63596491,359,39.36403509,912,46,958,0,1159,82.65746333
桃園縣,大溪鎮,光明里,664,231,33.0472103,468,66.9527897,699,25,724,0,909,79.6479648
桃園縣,大溪鎮,光明里,665,214,26.12942613,605,73.87057387,819,21,840,0,1069,78.57811038
桃園縣,大溪鎮,三元里,669,300,36.10108303,531,63.89891697,831,26,857,0,1039,82.48315688
桃園縣,大溪鎮,三元里,670,191,22.41784038,661,77.58215962,852,29,881,0,1048,84.0648855
桃園縣,大溪鎮,三元里,671,49,13.8028169,306,86.1971831,355,7,362,0,440,82.27272727
桃園縣,大溪鎮,田心里,618,676,58.88501742,472,41.11498258,1148,31,1179,1,1404,83.97435897
桃園縣,大溪鎮,田心里,619,596,65.78366446,310,34.21633554,906,26,932,0,1149,81.11401218
桃園縣,大溪鎮,田心里,620,573,55.25554484,464,44.74445516,1037,30,1067,0,1274,83.75196232
桃園縣,大溪鎮,仁文里,657,406,41.2601626,578,58.7398374,984,35,1019,0,1270,80.23622047
桃園縣,大溪鎮,仁文里,658,274,38.05555556,446,61.94444444,720,36,756,0,958,78.91440501
桃園縣,大溪鎮,仁文里,659,291,44.97681607,356,55.02318393,647,26,673,0,816,82.4754902
桃園縣,大溪鎮,仁和里,651,342,39.76744186,518,60.23255814,860,23,883,0,1128,78.28014184
桃園縣,大溪鎮,仁和里,652,473,44.04096834,601,55.95903166,1074,40,1114,0,1386,80.37518038
桃園縣,復興鄉,三民村,940,584,45.27131783,706,54.72868217,1290,72,1362,0,1742,78.18599311
桃園縣,復興鄉,澤仁村,941,223,26.14302462,630,73.85697538,853,46,899,0,1190,75.54621849
桃園縣,復興鄉,義盛村,943,31,7.416267943,387,92.58373206,418,28,446,0,580,76.89655172
桃園縣,復興鄉,霞雲村,942,24,7.407407407,300,92.59259259,324,11,335,0,452,74.11504425
桃園縣,復興鄉,長興村,945,77,20.42440318,300,79.57559682,377,24,401,0,532,75.37593985
桃園縣,復興鄉,三光村,948,32,8.791208791,332,91.20879121,364,21,385,0,512,75.1953125
桃園縣,復興鄉,奎輝村,946,37,10.51136364,315,89.48863636,352,22,374,0,514,72.76264591
桃園縣,復興鄉,華陵村,949,188,27.81065089,488,72.18934911,676,28,704,0,1028,68.48249027
桃園縣,復興鄉,羅浮村,944,125,21.22241087,464,78.77758913,589,39,628,0,860,73.02325581
桃園縣,復興鄉,高義村,947,64,15.49636804,349,84.50363196,413,17,430,0,639,67.29264476
桃園縣,中壢市,龍平里,193,142,12.73542601,973,87.26457399,1115,37,1152,0,1333,86.4216054
桃園縣,中壢市,龍平里,194,257,21.61480235,932,78.38519765,1189,46,1235,0,1480,83.44594595
桃園縣,中壢市,龍昌里,190,332,29.45874002,795,70.54125998,1127,39,1166,0,1429,81.59552134
桃園縣,中壢市,龍昌里,191,347,30.30567686,798,69.69432314,1145,41,1186,0,1430,82.93706294
桃園縣,中壢市,龍昌里,192,385,28.79581152,952,71.20418848,1337,46,1383,0,1680,82.32142857
桃園縣,中壢市,仁德里,207,252,26.3322884,705,73.6677116,957,51,1008,0,1188,84.84848485
桃園縣,中壢市,仁德里,208,245,24.32969215,762,75.67030785,1007,28,1035,0,1283,80.67030398
桃園縣,中壢市,永興里,318,407,49.93865031,408,50.06134969,815,32,847,0,1040,81.44230769
桃園縣,中壢市,內壢里,257,282,30.32258065,648,69.67741935,930,34,964,0,1196,80.60200669
桃園縣,中壢市,內壢里,258,293,31.60733549,634,68.39266451,927,37,964,1,1170,82.39316239
桃園縣,中壢市,成功里,259,348,35.1160444,643,64.8839556,991,33,1024,0,1257,81.4638027
桃園縣,中壢市,成功里,260,493,37.46200608,823,62.53799392,1316,35,1351,0,1684,80.22565321
桃園縣,中壢市,光明里,327,437,42.26305609,597,57.73694391,1034,29,1063,0,1361,78.10433505
桃園縣,中壢市,光明里,328,536,46.85314685,608,53.14685315,1144,44,1188,0,1449,81.98757764
桃園縣,中壢市,光明里,329,501,36.89248895,857,63.10751105,1358,31,1389,0,1662,83.57400722
桃園縣,中壢市,自立里,247,17,4.696132597,345,95.3038674,362,11,373,0,411,90.75425791
桃園縣,中壢市,自立里,248,8,8.080808081,91,91.91919192,99,2,101,0,124,81.4516129
桃園縣,中壢市,自立里,249,244,24.89795918,736,75.10204082,980,25,1005,0,1212,82.92079208
桃園縣,中壢市,自立里,250,371,28.04232804,952,71.95767196,1323,22,1345,0,1616,83.23019802
桃園縣,中壢市,自強里,251,357,33.9031339,696,66.0968661,1053,27,1080,1,1315,82.12927757
桃園縣,中壢市,自強里,252,279,24.88849242,842,75.11150758,1121,11,1132,0,1358,83.35787923
桃園縣,中壢市,中堅里,215,124,12.9707113,832,87.0292887,956,43,999,0,1201,83.18068276
桃園縣,中壢市,中堅里,216,158,18.2448037,708,81.7551963,866,35,901,0,1115,80.80717489
桃園縣,中壢市,中堅里,217,127,19.18429003,535,80.81570997,662,24,686,0,827,82.95042322
桃園縣,中壢市,中堅里,218,16,2.413273002,647,97.586727,663,21,684,0,829,82.50904704
桃園縣,中壢市,龍興里,179,459,43.30188679,601,56.69811321,1060,29,1089,0,1307,83.32058148
桃園縣,中壢市,龍興里,180,341,44.5751634,424,55.4248366,765,27,792,0,985,80.40609137
桃園縣,中壢市,龍興里,181,356,37.08333333,604,62.91666667,960,12,972,0,1161,83.72093023
桃園縣,中壢市,仁美里,197,355,34.29951691,680,65.70048309,1035,22,1057,0,1260,83.88888889
桃園縣,中壢市,仁美里,198,402,36.02150538,714,63.97849462,1116,19,1135,0,1404,80.84045584
桃園縣,中壢市,仁美里,199,229,33.62701909,452,66.37298091,681,24,705,0,841,83.82877527
桃園縣,中壢市,仁愛里,203,300,43.35260116,392,56.64739884,692,26,718,0,854,84.07494145
桃園縣,中壢市,仁愛里,204,375,37.27634195,631,62.72365805,1006,22,1028,0,1260,81.58730159
桃園縣,中壢市,新街里,311,644,43.80952381,826,56.19047619,1470,48,1518,0,1950,77.84615385
桃園縣,中壢市,中央里,282,360,38.01478353,587,61.98521647,947,25,972,0,1164,83.50515464
桃園縣,中壢市,中央里,283,349,45.38361508,420,54.61638492,769,22,791,0,1009,78.39444995
桃園縣,中壢市,中央里,284,440,50.98493627,423,49.01506373,863,27,890,0,1074,82.86778399
桃園縣,中壢市,普仁里,219,366,43.31360947,479,56.68639053,845,32,877,2,1085,80.82949309
桃園縣,中壢市,普仁里,220,375,42.75940707,502,57.24059293,877,24,901,0,1113,80.95238095
桃園縣,中壢市,普仁里,221,381,40.31746032,564,59.68253968,945,27,972,2,1226,79.2822186
桃園縣,中壢市,普義里,232,346,43.90862944,442,56.09137056,788,12,800,0,981,81.54943935
桃園縣,中壢市,普義里,233,229,32.57467994,474,67.42532006,703,17,720,0,888,81.08108108
桃園縣,中壢市,忠義里,238,534,44.35215947,670,55.64784053,1204,32,1236,0,1515,81.58415842
桃園縣,中壢市,中正里,241,358,26.01744186,1018,73.98255814,1376,35,1411,0,1710,82.51461988
桃園縣,中壢市,中正里,242,453,30.8793456,1014,69.1206544,1467,35,1502,0,1847,81.32106118
桃園縣,中壢市,興仁里,239,314,30.01912046,732,69.98087954,1046,48,1094,2,1408,77.69886364
桃園縣,中壢市,興仁里,240,379,30.78797725,852,69.21202275,1231,30,1261,0,1558,80.93709884
桃園縣,中壢市,東興里,292,474,45.31548757,572,54.68451243,1046,31,1077,0,1364,78.95894428
桃園縣,中壢市,東興里,293,492,50.0508647,491,49.9491353,983,26,1009,0,1255,80.39840637
桃園縣,中壢市,洽溪里,341,648,65.98778004,334,34.01221996,982,53,1035,0,1285,80.54474708
桃園縣,中壢市,篤行里,246,262,18.72766262,1137,81.27233738,1399,67,1466,0,1840,79.67391304
桃園縣,中壢市,新明里,324,452,54.92102066,371,45.07897934,823,27,850,0,1021,83.25171401
桃園縣,中壢市,新明里,325,466,52.71493213,418,47.28506787,884,16,900,0,1079,83.41056534
桃園縣,中壢市,新明里,326,509,43.28231293,667,56.71768707,1176,27,1203,1,1472,81.72554348
桃園縣,中壢市,新興里,285,597,44.85349361,734,55.14650639,1331,33,1364,2,1637,83.32315211
桃園縣,中壢市,新興里,286,511,42.44186047,693,57.55813953,1204,25,1229,0,1525,80.59016393
桃園縣,中壢市,新興里,287,490,40.19688269,729,59.80311731,1219,29,1248,0,1513,82.48512888
桃園縣,中壢市,新興里,288,477,41.22731201,680,58.77268799,1157,23,1180,0,1447,81.54803041
桃園縣,中壢市,中原里,263,457,51.87287174,424,48.12712826,881,18,899,0,1049,85.7006673
桃園縣,中壢市,中原里,264,386,41.41630901,546,58.58369099,932,32,964,0,1156,83.39100346
桃園縣,中壢市,中原里,265,372,33.72620127,731,66.27379873,1103,27,1130,0,1402,80.59914408
桃園縣,中壢市,內定里,278,890,59.53177258,605,40.46822742,1495,53,1548,0,1847,83.81158636
桃園縣,中壢市,內定里,279,734,54.98127341,601,45.01872659,1335,57,1392,0,1675,83.10447761
桃園縣,中壢市,中壢里,319,359,53.58208955,311,46.41791045,670,26,696,0,836,83.25358852
桃園縣,中壢市,龍岡里,184,337,29.71781305,797,70.28218695,1134,30,1164,0,1399,83.20228735
桃園縣,中壢市,龍岡里,185,220,23.45415778,718,76.54584222,938,35,973,0,1162,83.73493976
桃園縣,中壢市,龍岡里,186,272,25.23191095,806,74.76808905,1078,37,1115,0,1329,83.89766742
桃園縣,中壢市,仁祥里,211,251,24.13461538,789,75.86538462,1040,32,1072,0,1338,80.11958146
桃園縣,中壢市,仁祥里,212,285,26.14678899,805,73.85321101,1090,38,1128,0,1335,84.49438202
桃園縣,中壢市,水尾里,296,613,57.66698024,450,42.33301976,1063,36,1099,0,1332,82.50750751
桃園縣,中壢市,水尾里,297,678,48.42857143,722,51.57142857,1400,38,1438,0,1742,82.54879449
桃園縣,中壢市,水尾里,298,254,31.71036205,547,68.28963795,801,7,808,0,973,83.04213772
桃園縣,中壢市,水尾里,299,257,28.24175824,653,71.75824176,910,12,922,0,1061,86.89915174
桃園縣,中壢市,青埔里,310,466,51.9509476,431,48.0490524,897,20,917,0,1098,83.5154827
桃園縣,中壢市,復興里,268,359,38.76889849,567,61.23110151,926,28,954,0,1169,81.60821215
桃園縣,中壢市,復興里,269,343,37.7753304,565,62.2246696,908,14,922,0,1149,80.24369017
桃園縣,中壢市,復興里,270,669,40.79268293,971,59.20731707,1640,53,1693,0,2122,79.78322337
桃園縣,中壢市,文化里,273,606,43.50323044,787,56.49676956,1393,36,1429,0,1740,82.12643678
桃園縣,中壢市,文化里,274,544,40.56674124,797,59.43325876,1341,28,1369,0,1722,79.50058072
桃園縣,中壢市,文化里,275,563,45.66098946,670,54.33901054,1233,30,1263,0,1572,80.34351145
桃園縣,中壢市,興國里,313,538,52.13178295,494,47.86821705,1032,17,1049,0,1325,79.16981132
桃園縣,中壢市,興國里,314,623,51.61557581,584,48.38442419,1207,30,1237,0,1466,84.3792633
桃園縣,中壢市,興國里,315,713,53.36826347,623,46.63173653,1336,37,1373,0,1670,82.21556886
桃園縣,中壢市,忠福里,300,552,58.97435897,384,41.02564103,936,24,960,0,1152,83.33333333
桃園縣,中壢市,忠福里,301,314,34.16757345,605,65.83242655,919,25,944,0,1122,84.13547237
桃園縣,中壢市,忠福里,302,608,57.25047081,454,42.74952919,1062,46,1108,1,1364,81.23167155
桃園縣,中壢市,忠福里,303,566,40.25604552,840,59.74395448,1406,19,1425,0,1720,82.84883721
桃園縣,中壢市,信義里,226,521,41.21835443,743,58.78164557,1264,23,1287,0,1519,84.72679394
桃園縣,中壢市,信義里,227,517,39.04833837,807,60.95166163,1324,34,1358,0,1642,82.70401949
桃園縣,中壢市,石頭里,280,392,52.54691689,354,47.45308311,746,27,773,0,1018,75.93320236
桃園縣,中壢市,石頭里,281,309,46.53614458,355,53.46385542,664,16,680,0,1325,51.32075472
桃園縣,中壢市,龍東里,187,245,22.94007491,823,77.05992509,1068,39,1107,0,1353,81.81818182
桃園縣,中壢市,龍東里,188,210,17.72151899,975,82.27848101,1185,29,1214,0,1438,84.42280946
桃園縣,中壢市,龍東里,189,155,13.71681416,975,86.28318584,1130,38,1168,1,1349,86.58265382
桃園縣,中壢市,中建里,321,462,56.272838,359,43.727162,821,11,832,0,1064,78.19548872
桃園縣,中壢市,興南里,312,699,43.74217772,899,56.25782228,1598,17,1615,0,2063,78.28405235
桃園縣,中壢市,後寮里,172,507,40.46288907,746,59.53711093,1253,31,1284,0,1612,79.65260546
桃園縣,中壢市,後寮里,173,469,34.28362573,899,65.71637427,1368,43,1411,0,1771,79.67250141
桃園縣,中壢市,過嶺里,348,616,57.57009346,454,42.42990654,1070,30,1100,0,1299,84.68052348
桃園縣,中壢市,過嶺里,349,539,56.67718191,412,43.32281809,951,36,987,4,1201,82.1815154
桃園縣,中壢市,五權里,334,471,50.42826552,463,49.57173448,934,31,965,0,1210,79.75206612
桃園縣,中壢市,五權里,335,540,53.30700888,473,46.69299112,1013,18,1031,0,1303,79.12509593
桃園縣,中壢市,五權里,336,703,53.78729916,604,46.21270084,1307,38,1345,0,1613,83.3849969
桃園縣,中壢市,舊明里,322,259,30.25700935,597,69.74299065,856,28,884,0,1042,84.83685221
桃園縣,中壢市,舊明里,323,424,49.76525822,428,50.23474178,852,32,884,0,1077,82.07985144
桃園縣,中壢市,芝芭里,339,456,68.46846847,210,31.53153153,666,39,705,0,834,84.5323741
桃園縣,中壢市,芝芭里,340,640,67.86850477,303,32.13149523,943,34,977,0,1172,83.36177474
桃園縣,中壢市,月眉里,344,823,67.23856209,401,32.76143791,1224,48,1272,0,1532,83.02872063
桃園縣,中壢市,月眉里,345,1042,77.35708983,305,22.64291017,1347,45,1392,1,1614,86.24535316
桃園縣,中壢市,三民里,332,727,65.7918552,378,34.2081448,1105,45,1150,0,1383,83.15256688
桃園縣,中壢市,三民里,333,520,51.68986083,486,48.31013917,1006,33,1039,0,1263,82.26444972
桃園縣,中壢市,山東里,346,664,63.47992352,382,36.52007648,1046,64,1110,0,1353,82.03991131
桃園縣,中壢市,山東里,347,892,72.93540474,331,27.06459526,1223,54,1277,0,1506,84.79415671
桃園縣,中壢市,中榮里,320,384,52.67489712,345,47.32510288,729,21,750,0,979,76.60878447
桃園縣,中壢市,內厝里,342,841,59.60311836,570,40.39688164,1411,78,1489,0,1828,81.45514223
桃園縣,中壢市,內厝里,343,870,64.49221646,479,35.50778354,1349,40,1389,0,1691,82.14074512
桃園縣,中壢市,振興里,289,392,45.58139535,468,54.41860465,860,16,876,0,1050,83.42857143
桃園縣,中壢市,振興里,290,437,34.57278481,827,65.42721519,1264,32,1296,1,1613,80.34717917
桃園縣,中壢市,振興里,291,509,44.76693052,628,55.23306948,1137,26,1163,1,1387,83.85003605
桃園縣,中壢市,普慶里,230,384,44.9122807,471,55.0877193,855,25,880,0,1073,82.01304753
桃園縣,中壢市,普慶里,231,383,38.45381526,613,61.54618474,996,26,1022,0,1222,83.63338789
桃園縣,中壢市,興和里,316,588,64.26229508,327,35.73770492,915,32,947,0,1098,86.24772313
桃園縣,中壢市,興和里,317,599,53.05580159,530,46.94419841,1129,28,1157,0,1405,82.34875445
桃園縣,中壢市,永光里,330,642,58.3106267,459,41.6893733,1101,33,1134,0,1380,82.17391304
桃園縣,中壢市,永光里,331,650,42.90429043,865,57.09570957,1515,35,1550,0,1931,80.26929052
桃園縣,中壢市,復華里,271,556,39.37677054,856,60.62322946,1412,41,1453,0,1733,83.84304674
桃園縣,中壢市,復華里,272,498,37.1641791,842,62.8358209,1340,34,1374,0,1661,82.72125226
桃園縣,中壢市,忠孝里,266,369,39.93506494,555,60.06493506,924,31,955,0,1145,83.40611354
桃園縣,中壢市,忠孝里,267,293,36.48816936,510,63.51183064,803,22,825,0,1030,80.09708738
桃園縣,中壢市,福德里,261,422,40.49904031,620,59.50095969,1042,29,1071,0,1291,82.95894655
桃園縣,中壢市,福德里,262,347,35.2284264,638,64.7715736,985,22,1007,0,1218,82.67651888
桃園縣,中壢市,和平里,276,308,40.41994751,454,59.58005249,762,22,784,0,949,82.61327713
桃園縣,中壢市,和平里,277,339,39.92932862,510,60.07067138,849,26,875,0,1032,84.78682171
桃園縣,中壢市,普忠里,222,423,41.10787172,606,58.89212828,1029,31,1060,1,1313,80.73115004
桃園縣,中壢市,普忠里,223,329,34.55882353,623,65.44117647,952,23,975,0,1208,80.71192053
桃園縣,中壢市,普強里,224,432,36.03002502,767,63.96997498,1199,19,1218,0,1408,86.50568182
桃園縣,中壢市,普強里,225,405,33.52649007,803,66.47350993,1208,24,1232,0,1505,81.86046512
桃園縣,中壢市,明德里,174,610,44.0433213,775,55.9566787,1385,37,1422,0,1749,81.30360206
桃園縣,中壢市,明德里,175,659,45.70041609,783,54.29958391,1442,20,1462,0,1759,83.11540648
桃園縣,中壢市,至善里,176,418,30.73529412,942,69.26470588,1360,34,1394,0,1760,79.20454545
桃園縣,中壢市,至善里,177,356,24.7566064,1082,75.2433936,1438,22,1460,0,1749,83.47627216
桃園縣,中壢市,至善里,178,425,27.68729642,1110,72.31270358,1535,49,1584,0,2012,78.72763419
桃園縣,中壢市,五福里,337,810,56.05536332,635,43.94463668,1445,52,1497,0,1834,81.62486369
桃園縣,中壢市,五福里,338,555,48.8556338,581,51.1443662,1136,33,1169,0,1447,80.7878369
桃園縣,中壢市,龍德里,182,196,25.48764629,573,74.51235371,769,22,791,0,983,80.46795524
桃園縣,中壢市,龍德里,183,425,35.09496284,786,64.90503716,1211,37,1248,0,1509,82.70377734
桃園縣,中壢市,正義里,228,666,44.81830417,820,55.18169583,1486,32,1518,0,1910,79.47643979
桃園縣,中壢市,正義里,229,507,41.35399674,719,58.64600326,1226,24,1250,0,1522,82.12877792
桃園縣,中壢市,龍安里,195,112,12.61261261,776,87.38738739,888,26,914,0,1077,84.86536676
桃園縣,中壢市,龍安里,196,189,16.92032229,928,83.07967771,1117,39,1156,0,1346,85.88410104
桃園縣,中壢市,中山里,243,366,29.30344275,883,70.69655725,1249,30,1279,0,1533,83.43118069
桃園縣,中壢市,中山里,244,373,28.19349962,950,71.80650038,1323,32,1355,0,1677,80.79904592
桃園縣,中壢市,中山里,245,520,30.76923077,1170,69.23076923,1690,32,1722,0,2126,80.9971778
桃園縣,中壢市,德義里,234,423,53.47661188,368,46.52338812,791,27,818,0,997,82.04613842
桃園縣,中壢市,德義里,235,399,38.92682927,626,61.07317073,1025,25,1050,0,1258,83.46581876
桃園縣,中壢市,仁義里,236,516,45.38258575,621,54.61741425,1137,27,1164,0,1438,80.945758
桃園縣,中壢市,仁義里,237,358,47.60638298,394,52.39361702,752,14,766,0,979,78.24310521
桃園縣,中壢市,華勛里,213,261,20.99758648,982,79.00241352,1243,38,1281,2,1486,86.20457604
桃園縣,中壢市,華勛里,214,193,17.62557078,902,82.37442922,1095,52,1147,0,1362,84.2143906
桃園縣,中壢市,仁福里,200,321,33.12693498,648,66.87306502,969,25,994,0,1223,81.27555192
桃園縣,中壢市,仁福里,201,195,20.4616999,758,79.5383001,953,33,986,0,1199,82.235196
桃園縣,中壢市,仁福里,202,302,30.44354839,690,69.55645161,992,29,1021,0,1301,78.47809377
桃園縣,中壢市,幸福里,304,551,53.18532819,485,46.81467181,1036,22,1058,0,1308,80.88685015
桃園縣,中壢市,幸福里,305,473,41.31004367,672,58.68995633,1145,18,1163,0,1429,81.38558432
桃園縣,中壢市,幸福里,306,487,41.13175676,697,58.86824324,1184,28,1212,0,1494,81.12449799
桃園縣,中壢市,永福里,307,350,54.17956656,296,45.82043344,646,23,669,0,835,80.11976048
桃園縣,中壢市,永福里,308,632,50,632,50,1264,22,1286,1,1564,82.22506394
桃園縣,中壢市,永福里,309,660,44.44444444,825,55.55555556,1485,34,1519,0,1840,82.55434783
桃園縣,中壢市,仁和里,209,278,29.92465016,651,70.07534984,929,27,956,0,1195,80
桃園縣,中壢市,仁和里,210,243,28.06004619,623,71.93995381,866,19,885,0,1084,81.64206642
桃園縣,中壢市,華愛里,205,208,23.93555811,661,76.06444189,869,28,897,0,1095,81.91780822
桃園縣,中壢市,華愛里,206,259,30.50647821,590,69.49352179,849,12,861,0,1057,81.45695364
桃園縣,中壢市,莊敬里,255,51,8.388157895,557,91.61184211,608,19,627,0,714,87.81512605
桃園縣,中壢市,莊敬里,256,223,24.64088398,682,75.35911602,905,26,931,0,1157,80.46672429
桃園縣,中壢市,自治里,253,172,15.12752858,965,84.87247142,1137,26,1163,0,1378,84.39767779
桃園縣,中壢市,自治里,254,114,10.39197812,983,89.60802188,1097,22,1119,0,1314,85.15981735
桃園縣,中壢市,健行里,294,451,40.88848595,652,59.11151405,1103,26,1129,0,1367,82.58961229
桃園縣,中壢市,健行里,295,672,41.48148148,948,58.51851852,1620,32,1652,0,2096,78.81679389
桃園縣,平鎮市,雙連里,407,471,41.42480211,666,58.57519789,1137,47,1184,0,1428,82.91316527
桃園縣,平鎮市,雙連里,408,426,41.43968872,602,58.56031128,1028,31,1059,0,1259,84.11437649
桃園縣,平鎮市,雙連里,409,283,33.33333333,566,66.66666667,849,48,897,0,1122,79.94652406
桃園縣,平鎮市,高雙里,410,659,68.36099585,305,31.63900415,964,39,1003,0,1212,82.75577558
桃園縣,平鎮市,高雙里,411,631,48.6882716,665,51.3117284,1296,26,1322,0,1579,83.72387587
桃園縣,平鎮市,復旦里,394,336,37.92325056,550,62.07674944,886,13,899,0,1053,85.37511871
桃園縣,平鎮市,復旦里,395,349,38.39383938,560,61.60616062,909,11,920,0,1138,80.84358524
桃園縣,平鎮市,復旦里,396,350,39.10614525,545,60.89385475,895,15,910,0,1121,81.17752007
桃園縣,平鎮市,廣興里,385,588,55.05617978,480,44.94382022,1068,10,1078,0,1296,83.17901235
桃園縣,平鎮市,廣興里,386,492,45.81005587,582,54.18994413,1074,25,1099,0,1338,82.13751868
桃園縣,平鎮市,廣興里,387,525,44.22914912,662,55.77085088,1187,21,1208,1,1499,80.58705804
桃園縣,平鎮市,義民里,400,386,43.71460929,497,56.28539071,883,31,914,0,1121,81.53434434
桃園縣,平鎮市,義民里,401,368,42.00913242,508,57.99086758,876,18,894,0,1048,85.30534351
桃園縣,平鎮市,義民里,402,384,41.29032258,546,58.70967742,930,6,936,0,1174,79.7274276
桃園縣,平鎮市,宋屋里,381,507,47.07520891,570,52.92479109,1077,46,1123,0,1397,80.38654259
桃園縣,平鎮市,宋屋里,382,552,43.32810047,722,56.67189953,1274,25,1299,0,1600,81.1875
桃園縣,平鎮市,新勢里,416,642,50.15625,638,49.84375,1280,41,1321,0,1645,80.30395137
桃園縣,平鎮市,新勢里,417,644,44.01913876,819,55.98086124,1463,28,1491,0,1828,81.56455142
桃園縣,平鎮市,新富里,423,462,46.85598377,524,53.14401623,986,29,1015,0,1459,69.5681974
桃園縣,平鎮市,新富里,424,482,34.01552576,935,65.98447424,1417,19,1436,0,1741,82.48133257
桃園縣,平鎮市,北勢里,412,420,43.38842975,548,56.61157025,968,18,986,0,1195,82.51046025
桃園縣,平鎮市,北勢里,413,479,52.52192982,433,47.47807018,912,15,927,0,1096,84.58029197
桃園縣,平鎮市,北興里,427,401,39.54635108,613,60.45364892,1014,26,1040,0,1270,81.88976378
桃園縣,平鎮市,北興里,428,478,44.21831637,603,55.78168363,1081,31,1112,0,1388,80.11527378
桃園縣,平鎮市,北興里,429,430,56.65349144,329,43.34650856,759,14,773,1,939,82.32161874
桃園縣,平鎮市,北貴里,448,580,50.43478261,570,49.56521739,1150,24,1174,0,1433,81.92602931
桃園縣,平鎮市,北貴里,449,549,40.42709867,809,59.57290133,1358,34,1392,0,1692,82.26950355
桃園縣,平鎮市,平鎮里,350,426,55.10996119,347,44.89003881,773,28,801,0,985,81.31979695
桃園縣,平鎮市,平鎮里,351,520,54.22314911,439,45.77685089,959,54,1013,0,1257,80.58870326
桃園縣,平鎮市,平鎮里,352,336,42,464,58,800,35,835,0,1007,82.91956306
桃園縣,平鎮市,南勢里,355,511,52.03665988,471,47.96334012,982,33,1015,0,1245,81.52610442
桃園縣,平鎮市,南勢里,356,501,49.26253687,516,50.73746313,1017,33,1050,0,1264,83.06962025
桃園縣,平鎮市,南勢里,357,429,41.65048544,601,58.34951456,1030,21,1051,1,1326,79.26093514
桃園縣,平鎮市,莊敬里,373,217,25.98802395,618,74.01197605,835,45,880,0,1037,84.86017358
桃園縣,平鎮市,莊敬里,374,245,32.11009174,518,67.88990826,763,16,779,0,959,81.23044838
桃園縣,平鎮市,莊敬里,375,100,12.36093943,709,87.63906057,809,35,844,0,1007,83.81330685
桃園縣,平鎮市,莊敬里,376,297,37.88265306,487,62.11734694,784,16,800,0,956,83.68200837
桃園縣,平鎮市,山峰里,364,305,33.59030837,603,66.40969163,908,23,931,0,1132,82.24381625
桃園縣,平鎮市,山峰里,365,325,34.6112886,614,65.3887114,939,32,971,0,1170,82.99145299
桃園縣,平鎮市,湧光里,368,378,46.09756098,442,53.90243902,820,35,855,0,1018,83.98821218
桃園縣,平鎮市,湧光里,369,283,34.26150121,543,65.73849879,826,36,862,0,1047,82.330468
桃園縣,平鎮市,湧光里,370,195,26.42276423,543,73.57723577,738,19,757,0,945,80.10582011
桃園縣,平鎮市,湧光里,371,202,30.79268293,454,69.20731707,656,7,663,0,792,83.71212121
桃園縣,平鎮市,湧光里,372,250,42.30118443,341,57.69881557,591,21,612,0,744,82.25806452
桃園縣,平鎮市,龍恩里,453,277,22.63071895,947,77.36928105,1224,22,1246,0,1544,80.69948187
桃園縣,平鎮市,龍恩里,454,225,26.4084507,627,73.5915493,852,9,861,0,1087,79.20883165
桃園縣,平鎮市,東社里,455,467,39.57627119,713,60.42372881,1180,45,1225,0,1453,84.3083276
桃園縣,平鎮市,東社里,456,358,27.45398773,946,72.54601227,1304,48,1352,0,1657,81.5932408
桃園縣,平鎮市,龍興里,460,242,27.65714286,633,72.34285714,875,33,908,0,1109,81.87556357
桃園縣,平鎮市,龍興里,461,186,19.82942431,752,80.17057569,938,41,979,0,1186,82.54637437
桃園縣,平鎮市,貿易里,458,34,3.310613437,993,96.68938656,1027,45,1072,0,1265,84.743083
桃園縣,平鎮市,貿易里,459,38,5.270457698,683,94.7295423,721,23,744,0,906,82.1192053
桃園縣,平鎮市,忠貞里,457,33,3.455497382,922,96.54450262,955,37,992,0,1258,78.85532591
桃園縣,平鎮市,中正里,462,68,6.232813932,1023,93.76718607,1091,46,1137,0,1347,84.40979955
桃園縣,平鎮市,建安里,434,437,43.18181818,575,56.81818182,1012,28,1040,0,1276,81.50470219
桃園縣,平鎮市,建安里,435,411,43.49206349,534,56.50793651,945,38,983,0,1188,82.74410774
桃園縣,平鎮市,建安里,436,504,59.22444183,347,40.77555817,851,24,875,0,1059,82.62511804
桃園縣,平鎮市,東勢里,444,467,72.62830482,176,27.37169518,643,27,670,0,817,82.00734394
桃園縣,平鎮市,東勢里,445,476,57.76699029,348,42.23300971,824,17,841,0,1015,82.85714286
桃園縣,平鎮市,東勢里,446,527,57.65864333,387,42.34135667,914,23,937,0,1118,83.81037567
桃園縣,平鎮市,東勢里,447,303,31.79433368,650,68.20566632,953,36,989,0,1244,79.50160772
桃園縣,平鎮市,東安里,440,270,30.78677309,607,69.21322691,877,43,920,0,1099,83.71246588
桃園縣,平鎮市,東安里,441,265,28.52529602,664,71.47470398,929,26,955,0,1179,81.00084818
桃園縣,平鎮市,新安里,442,409,32.74619696,840,67.25380304,1249,37,1286,0,1612,79.77667494
桃園縣,平鎮市,新安里,443,415,34.04429861,804,65.95570139,1219,42,1261,0,1521,82.90598291
桃園縣,平鎮市,鎮興里,353,540,55.95854922,425,44.04145078,965,33,998,0,1208,82.61589404
桃園縣,平鎮市,鎮興里,354,491,50.77559462,476,49.22440538,967,43,1010,0,1239,81.5173527
桃園縣,平鎮市,義興里,403,522,48.7394958,549,51.2605042,1071,22,1093,0,1258,86.88394277
桃園縣,平鎮市,義興里,404,502,52.56544503,453,47.43455497,955,34,989,0,1165,84.89270386
桃園縣,平鎮市,義興里,405,426,48.79725086,447,51.20274914,873,29,902,1,1086,83.05709024
桃園縣,平鎮市,義興里,406,451,42.62759924,607,57.37240076,1058,23,1081,0,1355,79.77859779
桃園縣,平鎮市,湧豐里,377,477,41.47826087,673,58.52173913,1150,38,1188,0,1440,82.5
桃園縣,平鎮市,湧安里,378,266,40.67278287,388,59.32721713,654,24,678,0,853,79.48417351
桃園縣,平鎮市,湧安里,379,345,41.07142857,495,58.92857143,840,27,867,0,1073,80.80149115
桃園縣,平鎮市,湧安里,380,348,42.02898551,480,57.97101449,828,21,849,0,1062,79.94350282
桃園縣,平鎮市,廣達里,388,413,52.7458493,370,47.2541507,783,18,801,0,966,82.91925466
桃園縣,平鎮市,廣達里,389,445,52.97619048,395,47.02380952,840,17,857,0,1029,83.28474247
桃園縣,平鎮市,廣達里,390,449,53.13609467,396,46.86390533,845,30,875,0,1058,82.70321361
桃園縣,平鎮市,福林里,366,459,72.85714286,171,27.14285714,630,32,662,1,789,83.90367554
桃園縣,平鎮市,福林里,367,390,37.35632184,654,62.64367816,1044,34,1078,0,1275,84.54901961
桃園縣,平鎮市,金星里,358,386,44.72769409,477,55.27230591,863,21,884,0,1114,79.35368043
桃園縣,平鎮市,金星里,359,431,46.7462039,491,53.2537961,922,16,938,0,1152,81.42361111
桃園縣,平鎮市,廣仁里,391,432,48.3762598,461,51.6237402,893,25,918,0,1147,80.03487358
桃園縣,平鎮市,廣仁里,392,380,43.57798165,492,56.42201835,872,26,898,0,1140,78.77192982
桃園縣,平鎮市,廣仁里,393,422,43.46035015,549,56.53964985,971,35,1006,0,1282,78.47113885
桃園縣,平鎮市,新貴里,432,541,47.79151943,591,52.20848057,1132,28,1160,0,1425,81.40350877
桃園縣,平鎮市,新貴里,433,523,50.77669903,507,49.22330097,1030,39,1069,0,1282,83.38533541
桃園縣,平鎮市,北富里,450,368,49.32975871,378,50.67024129,746,20,766,0,939,81.57614483
桃園縣,平鎮市,北富里,451,374,39.53488372,572,60.46511628,946,22,968,0,1118,86.58318426
桃園縣,平鎮市,北富里,452,498,53.43347639,434,46.56652361,932,23,955,0,1180,80.93220339
桃園縣,平鎮市,新榮里,420,473,40.0508044,708,59.9491956,1181,23,1204,0,1431,84.13696716
桃園縣,平鎮市,新榮里,421,365,39.97809419,548,60.02190581,913,21,934,0,1198,77.96327212
桃園縣,平鎮市,新榮里,422,539,47.99643811,584,52.00356189,1123,30,1153,1,1363,84.59280998
桃園縣,平鎮市,華安里,437,204,21.11801242,762,78.88198758,966,29,995,0,1208,82.36754967
桃園縣,平鎮市,華安里,438,267,28.07570978,684,71.92429022,951,12,963,0,1124,85.67615658
桃園縣,平鎮市,華安里,439,240,25.77873255,691,74.22126745,931,22,953,0,1190,80.08403361
桃園縣,平鎮市,金陵里,430,313,41.51193634,441,58.48806366,754,13,767,0,904,84.84513274
桃園縣,平鎮市,金陵里,431,283,43.74034003,364,56.25965997,647,20,667,0,794,84.00503778
桃園縣,平鎮市,北安里,418,275,45.08196721,335,54.91803279,610,25,635,0,746,85.12064343
桃園縣,平鎮市,北安里,419,363,53.93759287,310,46.06240713,673,18,691,0,822,84.06326034
桃園縣,平鎮市,北華里,414,381,38.95705521,597,61.04294479,978,21,999,0,1226,81.48450245
桃園縣,平鎮市,北華里,415,490,48.22834646,526,51.77165354,1016,20,1036,0,1196,86.62207358
桃園縣,平鎮市,復興里,397,495,47.1877979,554,52.8122021,1049,26,1075,0,1302,82.56528418
桃園縣,平鎮市,復興里,398,342,47.96633941,371,52.03366059,713,24,737,0,916,80.45851528
桃園縣,平鎮市,復興里,399,519,47.09618875,583,52.90381125,1102,27,1129,1,1322,85.40090772
桃園縣,平鎮市,平興里,383,359,37.82929399,590,62.17070601,949,26,975,1,1225,79.59183673
桃園縣,平鎮市,平興里,384,429,39.50276243,657,60.49723757,1086,21,1107,0,1426,77.62973352
桃園縣,平鎮市,新英里,425,321,33.02469136,651,66.97530864,972,22,994,0,1191,83.45927792
桃園縣,平鎮市,新英里,426,253,33.02872063,513,66.97127937,766,5,771,0,942,81.84713376
桃園縣,平鎮市,平安里,360,630,52.85234899,562,47.14765101,1192,37,1229,0,1514,81.17569353
桃園縣,平鎮市,平安里,361,569,45.88709677,671,54.11290323,1240,38,1278,1,1539,83.04093567
桃園縣,平鎮市,平南里,362,524,40.27671022,777,59.72328978,1301,27,1328,0,1621,81.92473782
桃園縣,平鎮市,平南里,363,558,38.14080656,905,61.85919344,1463,26,1489,0,1801,82.67629095
桃園縣,楊梅鎮,楊梅里,574,559,44.79166667,689,55.20833333,1248,47,1295,0,1629,79.4966237
桃園縣,楊梅鎮,楊梅里,575,419,40.83820663,607,59.16179337,1026,37,1063,0,1307,81.33129304
桃園縣,楊梅鎮,楊江里,576,372,41.28745838,529,58.71254162,901,32,933,0,1164,80.15463918
桃園縣,楊梅鎮,紅梅里,578,339,48.91774892,354,51.08225108,693,26,719,0,893,80.51511758
桃園縣,楊梅鎮,紅梅里,579,386,40.58885384,565,59.41114616,951,13,964,0,1138,84.71001757
桃園縣,楊梅鎮,永寧里,580,603,43.88646288,771,56.11353712,1374,46,1420,0,1811,78.40971839
桃園縣,楊梅鎮,永寧里,581,732,47.84313725,798,52.15686275,1530,53,1583,0,1982,79.86881937
桃園縣,楊梅鎮,大平里,582,460,42.55319149,621,57.44680851,1081,58,1139,0,1397,81.53185397
桃園縣,楊梅鎮,大平里,583,532,43.96694215,678,56.03305785,1210,54,1264,0,1564,80.81841432
桃園縣,楊梅鎮,東流里,586,597,51.24463519,568,48.75536481,1165,53,1218,0,1519,80.1843318
桃園縣,楊梅鎮,東流里,587,293,49.07872697,304,50.92127303,597,20,617,0,788,78.29949239
桃園縣,楊梅鎮,水美里,610,330,45.51724138,395,54.48275862,725,31,756,0,979,77.22165475
桃園縣,楊梅鎮,水美里,611,389,47.26609964,434,52.73390036,823,30,853,1,1072,79.57089552
桃園縣,楊梅鎮,水美里,612,415,47.70114943,455,52.29885057,870,19,889,0,1125,79.02222222
桃園縣,楊梅鎮,上田里,599,512,56.26373626,398,43.73626374,910,35,945,0,1121,84.29973238
桃園縣,楊梅鎮,上田里,600,490,53.20304017,431,46.79695983,921,9,930,1,1143,81.3648294
桃園縣,楊梅鎮,梅新里,577,465,39.10849453,724,60.89150547,1189,52,1241,0,1579,78.59404687
桃園縣,楊梅鎮,大同里,570,431,39.07524932,672,60.92475068,1103,39,1142,0,1358,84.09425626
桃園縣,楊梅鎮,大同里,571,493,40.37674038,728,59.62325962,1221,41,1262,0,1533,82.32224397
桃園縣,楊梅鎮,埔心里,549,642,53.54462052,557,46.45537948,1199,27,1226,0,1494,82.06157965
桃園縣,楊梅鎮,金龍里,552,50,4.359197908,1097,95.64080209,1147,52,1199,0,1401,85.58172734
桃園縣,楊梅鎮,瑞塘里,556,492,52.11864407,452,47.88135593,944,45,989,0,1236,80.01618123
桃園縣,楊梅鎮,瑞塘里,557,345,38.24833703,557,61.75166297,902,32,934,0,1185,78.8185654
桃園縣,楊梅鎮,瑞塘里,558,465,41.18689105,664,58.81310895,1129,23,1152,0,1451,79.39352171
桃園縣,楊梅鎮,四維里,553,54,10.88709677,442,89.11290323,496,24,520,0,609,85.38587849
桃園縣,楊梅鎮,四維里,554,231,32.08333333,489,67.91666667,720,15,735,0,916,80.24017467
桃園縣,楊梅鎮,梅溪里,561,587,44.80916031,723,55.19083969,1310,43,1353,0,1690,80.0591716
桃園縣,楊梅鎮,梅溪里,562,439,36.28099174,771,63.71900826,1210,24,1234,0,1590,77.61006289
桃園縣,楊梅鎮,高山里,601,420,47.72727273,460,52.27272727,880,43,923,0,1194,77.30318258
桃園縣,楊梅鎮,高山里,602,402,39.8019802,608,60.1980198,1010,31,1041,0,1316,79.10334347
桃園縣,楊梅鎮,高山里,603,477,46.40077821,551,53.59922179,1028,37,1065,0,1281,83.1381733
桃園縣,楊梅鎮,高榮里,605,604,58.812074,423,41.187926,1027,18,1045,0,1263,82.73950911
桃園縣,楊梅鎮,高榮里,606,295,44.09566517,374,55.90433483,669,18,687,0,870,78.96551724
桃園縣,楊梅鎮,仁美里,546,387,43.92735528,494,56.07264472,881,30,911,0,1138,80.05272408
桃園縣,楊梅鎮,仁美里,547,477,39.6179402,727,60.3820598,1204,41,1245,0,1547,80.47834518
桃園縣,楊梅鎮,仁美里,548,334,35.68376068,602,64.31623932,936,23,959,0,1152,83.24652778
桃園縣,楊梅鎮,光華里,550,433,35.72607261,779,64.27392739,1212,60,1272,0,1503,84.63073852
桃園縣,楊梅鎮,光華里,551,433,35.72607261,779,64.27392739,1212,31,1243,0,1501,82.81145903
桃園縣,楊梅鎮,富岡里,590,502,50.3006012,496,49.6993988,998,60,1058,0,1327,79.72871138
桃園縣,楊梅鎮,富岡里,591,480,48.48484848,510,51.51515152,990,39,1029,1,1260,81.66666667
桃園縣,楊梅鎮,富岡里,592,536,47.94275492,582,52.05724508,1118,55,1173,0,1472,79.6875
桃園縣,楊梅鎮,豐野里,588,556,42.05748865,766,57.94251135,1322,48,1370,0,1700,80.58823529
桃園縣,楊梅鎮,豐野里,589,525,52.08333333,483,47.91666667,1008,42,1050,0,1308,80.27522936
桃園縣,楊梅鎮,員本里,593,409,52.91073739,364,47.08926261,773,37,810,0,993,81.57099698
桃園縣,楊梅鎮,員本里,594,350,53.1107739,309,46.8892261,659,34,693,0,867,79.93079585
桃園縣,楊梅鎮,瑞原里,613,567,50.04413063,566,49.95586937,1133,62,1195,0,1456,82.07417582
桃園縣,楊梅鎮,瑞原里,614,569,45.70281124,676,54.29718876,1245,48,1293,2,1697,76.19328226
桃園縣,楊梅鎮,三湖里,595,579,40.63157895,846,59.36842105,1425,25,1450,0,1919,75.5601876
桃園縣,楊梅鎮,三湖里,596,543,52.01149425,501,47.98850575,1044,55,1099,0,1382,79.52243126
桃園縣,楊梅鎮,上湖里,597,579,46.28297362,672,53.71702638,1251,73,1324,0,1710,77.42690058
桃園縣,楊梅鎮,上湖里,598,508,43.16057774,669,56.83942226,1177,53,1230,0,1575,78.0952381
桃園縣,楊梅鎮,中山里,572,342,40.04683841,512,59.95316159,854,13,867,0,1045,82.96650718
桃園縣,楊梅鎮,中山里,573,342,37.21436344,577,62.78563656,919,14,933,0,1161,80.36175711
桃園縣,楊梅鎮,楊明里,566,364,38.84738527,573,61.15261473,937,26,963,0,1208,79.71854305
桃園縣,楊梅鎮,楊明里,567,431,36.7120954,743,63.2879046,1174,18,1192,0,1455,81.92439863
桃園縣,楊梅鎮,金溪里,563,367,35.49323017,667,64.50676983,1034,31,1065,0,1320,80.68181818
桃園縣,楊梅鎮,金溪里,564,266,33.88535032,519,66.11464968,785,13,798,1,1056,75.56818182
桃園縣,楊梅鎮,金溪里,565,349,31.32854578,765,68.67145422,1114,17,1131,0,1380,81.95652174
桃園縣,楊梅鎮,裕成里,568,533,30.84490741,1195,69.15509259,1728,30,1758,0,2196,80.05464481
桃園縣,楊梅鎮,裕成里,569,331,32.16715258,698,67.83284742,1029,25,1054,0,1480,71.21621622
桃園縣,楊梅鎮,秀才里,584,553,52.268431,505,47.731569,1058,58,1116,0,1366,81.69838946
桃園縣,楊梅鎮,秀才里,585,450,41.20879121,642,58.79120879,1092,41,1133,0,1397,81.1023622
桃園縣,楊梅鎮,青山里,604,448,34.01670463,869,65.98329537,1317,35,1352,0,1807,74.82014388
桃園縣,楊梅鎮,新榮里,608,488,50.36119711,481,49.63880289,969,16,985,0,1186,83.05227656
桃園縣,楊梅鎮,新榮里,609,443,45.4825462,531,54.5174538,974,20,994,0,1223,81.27555192
桃園縣,楊梅鎮,雙榮里,607,678,47.44576627,751,52.55423373,1429,36,1465,0,1819,80.53875756
桃園縣,楊梅鎮,瑞坪里,559,228,24.4111349,706,75.5888651,934,15,949,0,1174,80.83475298
桃園縣,楊梅鎮,瑞坪里,560,392,37.0510397,666,62.9489603,1058,25,1083,0,1398,77.46781116
桃園縣,楊梅鎮,永平里,555,421,38.3424408,677,61.6575592,1098,28,1126,0,1429,78.79636109
桃園縣,龍潭鄉,黃唐村,826,330,34.26791277,633,65.73208723,963,28,991,0,1274,77.78649922
桃園縣,龍潭鄉,黃唐村,827,469,47.42163802,520,52.57836198,989,22,1011,0,1232,82.06168831
桃園縣,龍潭鄉,黃唐村,828,380,44.08352668,482,55.91647332,862,27,889,0,1094,81.26142596
桃園縣,龍潭鄉,中山村,831,437,46.29237288,507,53.70762712,944,38,982,0,1196,82.10702341
桃園縣,龍潭鄉,中山村,832,588,47.96084829,638,52.03915171,1226,42,1268,0,1508,84.08488064
桃園縣,龍潭鄉,中山村,833,347,37.88209607,569,62.11790393,916,28,944,0,1133,83.31862312
桃園縣,龍潭鄉,烏林村,835,510,43.14720812,672,56.85279188,1182,39,1221,0,1546,78.97800776
桃園縣,龍潭鄉,烏林村,836,362,28.39215686,913,71.60784314,1275,59,1334,0,1656,80.55555556
桃園縣,龍潭鄉,高平村,879,495,49.30278884,509,50.69721116,1004,29,1033,0,1247,82.83881315
桃園縣,龍潭鄉,高平村,880,524,50.48169557,514,49.51830443,1038,28,1066,0,1305,81.68582375
桃園縣,龍潭鄉,干城村,838,13,2.826086957,447,97.17391304,460,29,489,0,598,81.77257525
桃園縣,龍潭鄉,凌雲村,839,366,35.22617902,673,64.77382098,1039,55,1094,0,1372,79.73760933
桃園縣,龍潭鄉,凌雲村,840,468,39.29471033,723,60.70528967,1191,51,1242,0,1548,80.23255814
桃園縣,龍潭鄉,八德村,843,407,47.3806752,452,52.6193248,859,29,888,0,1096,81.02189781
桃園縣,龍潭鄉,八德村,844,297,36.84863524,509,63.15136476,806,34,840,0,1093,76.85269899
桃園縣,龍潭鄉,八德村,845,366,45.2970297,442,54.7029703,808,27,835,0,1029,81.14674441
桃園縣,龍潭鄉,三水村,884,370,71.42857143,148,28.57142857,518,47,565,0,681,82.96622614
桃園縣,龍潭鄉,上林村,848,509,54.14893617,431,45.85106383,940,18,958,0,1217,78.71815941
桃園縣,龍潭鄉,上林村,849,575,42.59259259,775,57.40740741,1350,61,1411,0,1738,81.18527043
桃園縣,龍潭鄉,中正村,854,422,37.41134752,706,62.58865248,1128,32,1160,1,1389,83.51331893
桃園縣,龍潭鄉,中正村,855,428,38.04444444,697,61.95555556,1125,29,1154,0,1447,79.7512094
桃園縣,龍潭鄉,龍潭村,850,456,52.71676301,409,47.28323699,865,23,888,0,1058,83.93194707
桃園縣,龍潭鄉,龍潭村,851,373,51.44827586,352,48.55172414,725,22,747,0,898,83.18485523
桃園縣,龍潭鄉,高原村,881,569,50.57777778,556,49.42222222,1125,30,1155,0,1411,81.85683912
桃園縣,龍潭鄉,高原村,882,581,50.04306632,580,49.95693368,1161,22,1183,0,1478,80.0405954
桃園縣,龍潭鄉,九龍村,858,284,30.40685225,650,69.59314775,934,27,961,0,1183,81.23415046
桃園縣,龍潭鄉,九龍村,859,525,38.88888889,825,61.11111111,1350,9,1359,0,1684,80.70071259
桃園縣,龍潭鄉,中興村,864,436,33.51268255,865,66.48731745,1301,52,1353,0,1652,81.90072639
桃園縣,龍潭鄉,中興村,865,415,30.97014925,925,69.02985075,1340,57,1397,0,1702,82.07990599
桃園縣,龍潭鄉,佳安村,868,380,44.653349,471,55.346651,851,38,889,0,1068,83.23970037
桃園縣,龍潭鄉,佳安村,869,148,15.91397849,782,84.08602151,930,20,950,0,1148,82.75261324
桃園縣,龍潭鄉,佳安村,870,168,20.14388489,666,79.85611511,834,12,846,0,967,87.48707342
桃園縣,龍潭鄉,三和村,883,585,55.45023697,470,44.54976303,1055,25,1080,0,1294,83.46213292
桃園縣,龍潭鄉,三坑村,871,619,62.84263959,366,37.15736041,985,44,1029,0,1301,79.09300538
桃園縣,龍潭鄉,大平村,872,500,56.17977528,390,43.82022472,890,29,919,0,1126,81.61634103
桃園縣,龍潭鄉,三林村,873,353,33.58705994,698,66.41294006,1051,28,1079,0,1320,81.74242424
桃園縣,龍潭鄉,三林村,874,212,30.76923077,477,69.23076923,689,6,695,0,816,85.17156863
桃園縣,龍潭鄉,永興村,829,440,41.35338346,624,58.64661654,1064,43,1107,0,1346,82.24368499
桃園縣,龍潭鄉,永興村,830,378,40.38461538,558,59.61538462,936,39,975,0,1169,83.40461933
桃園縣,龍潭鄉,烏樹林村,834,740,50.20352782,734,49.79647218,1474,48,1522,0,1936,78.61570248
桃園縣,龍潭鄉,百年村,837,502,26.56084656,1388,73.43915344,1890,34,1924,0,2334,82.4335904
桃園縣,龍潭鄉,龍祥村,841,309,34.68013468,582,65.31986532,891,28,919,0,1157,79.4295592
桃園縣,龍潭鄉,龍祥村,842,326,31.86705767,697,68.13294233,1023,45,1068,0,1282,83.30733229
桃園縣,龍潭鄉,聖德村,846,430,49.59630911,437,50.40369089,867,32,899,0,1161,77.4332472
桃園縣,龍潭鄉,聖德村,847,345,38.20598007,558,61.79401993,903,22,925,0,1200,77.08333333
桃園縣,龍潭鄉,龍星村,852,422,38.85819521,664,61.14180479,1086,20,1106,0,1320,83.78787879
桃園縣,龍潭鄉,龍星村,853,537,47.22955145,600,52.77044855,1137,30,1167,0,1518,76.87747036
桃園縣,龍潭鄉,上華村,856,355,39.44444444,545,60.55555556,900,19,919,0,1110,82.79279279
桃園縣,龍潭鄉,上華村,857,197,23.23113208,651,76.76886792,848,33,881,0,1085,81.19815668
桃園縣,龍潭鄉,武漢村,860,293,34.67455621,552,65.32544379,845,21,866,0,1063,81.46754468
桃園縣,龍潭鄉,武漢村,861,306,41.74624829,427,58.25375171,733,21,754,0,963,78.29698858
桃園縣,龍潭鄉,東興村,862,324,23.41040462,1060,76.58959538,1384,21,1405,0,1710,82.16374269
桃園縣,龍潭鄉,東興村,863,260,20.71713147,995,79.28286853,1255,65,1320,0,1654,79.80652963
桃園縣,龍潭鄉,北興村,866,277,31.72966781,596,68.27033219,873,17,890,0,1120,79.46428571
桃園縣,龍潭鄉,北興村,867,137,21.10939908,512,78.89060092,649,22,671,1,858,78.20512821
桃園縣,龍潭鄉,建林村,875,304,24.26177175,949,75.73822825,1253,18,1271,0,1502,84.62050599
桃園縣,龍潭鄉,建林村,876,343,25.53983619,1000,74.46016381,1343,16,1359,0,1634,83.17013464
桃園縣,龍潭鄉,富林村,877,305,24.20634921,955,75.79365079,1260,26,1286,0,1561,82.38308776
桃園縣,龍潭鄉,富林村,878,296,29.5114656,707,70.4885344,1003,23,1026,0,1218,84.2364532
桃園縣,新屋鄉,新屋村,912,473,49.94720169,474,50.05279831,947,35,982,0,1181,83.14987299
桃園縣,新屋鄉,新屋村,913,489,49.89795918,491,50.10204082,980,6,986,0,1227,80.35859821
桃園縣,新屋鄉,新生村,914,566,50.26642984,560,49.73357016,1126,47,1173,0,1383,84.81561822
桃園縣,新屋鄉,新生村,915,561,44.48850119,700,55.51149881,1261,44,1305,0,1574,82.90978399
桃園縣,新屋鄉,後湖村,916,540,55.67010309,430,44.32989691,970,45,1015,0,1242,81.72302738
桃園縣,新屋鄉,清華村,917,631,51.89144737,585,48.10855263,1216,58,1274,0,1580,80.63291139
桃園縣,新屋鄉,清華村,918,695,56.96721311,525,43.03278689,1220,11,1231,3,1516,81.2005277
桃園縣,新屋鄉,頭洲村,924,625,54.77651183,516,45.22348817,1141,17,1158,0,1407,82.30277186
桃園縣,新屋鄉,頭洲村,925,724,61.66950596,450,38.33049404,1174,46,1220,0,1468,83.10626703
桃園縣,新屋鄉,埔頂村,922,866,53.55596784,751,46.44403216,1617,68,1685,0,2075,81.20481928
桃園縣,新屋鄉,九斗村,923,827,58.86120996,578,41.13879004,1405,87,1492,0,1841,81.04291146
桃園縣,新屋鄉,社子村,921,703,62.93643688,414,37.06356312,1117,12,1129,1,1325,85.20754717
桃園縣,新屋鄉,東明村,920,529,57.37527115,393,42.62472885,922,57,979,0,1186,82.54637437
桃園縣,新屋鄉,石磊村,919,787,59.8934551,527,40.1065449,1314,81,1395,0,1690,82.5443787
桃園縣,新屋鄉,下埔村,936,314,61.08949416,200,38.91050584,514,31,545,0,688,79.21511628
桃園縣,新屋鄉,下田村,938,720,59.50413223,490,40.49586777,1210,72,1282,0,1591,80.57825267
桃園縣,新屋鄉,石牌村,937,396,60.2739726,261,39.7260274,657,17,674,0,804,83.83084577
桃園縣,新屋鄉,赤欄村,939,478,56.56804734,367,43.43195266,845,5,850,0,1066,79.73733583
桃園縣,新屋鄉,永興村,935,493,67.34972678,239,32.65027322,732,43,775,0,944,82.09745763
桃園縣,新屋鄉,永安村,933,410,54.88621151,337,45.11378849,747,33,780,0,902,86.47450111
桃園縣,新屋鄉,永安村,934,567,54.0514776,482,45.9485224,1049,46,1095,0,1335,82.02247191
桃園縣,新屋鄉,笨港村,932,412,53.99737877,351,46.00262123,763,65,828,0,1033,80.15488867
桃園縣,新屋鄉,深圳村,930,266,52.88270378,237,47.11729622,503,34,537,0,674,79.6735905
桃園縣,新屋鄉,蚵間村,929,421,62.00294551,258,37.99705449,679,11,690,0,866,79.67667436
桃園縣,新屋鄉,康榔村,931,465,57.76397516,340,42.23602484,805,58,863,0,1050,82.19047619
桃園縣,新屋鄉,後庄村,928,470,51.93370166,435,48.06629834,905,9,914,0,1115,81.97309417
桃園縣,新屋鄉,大坡村,926,657,64.03508772,369,35.96491228,1026,42,1068,0,1328,80.42168675
桃園縣,新屋鄉,望間村,927,749,63.153457,437,36.846543,1186,50,1236,0,1474,83.85345997
桃園縣,觀音鄉,觀音村,885,498,54.42622951,417,45.57377049,915,42,957,0,1197,79.94987469
桃園縣,觀音鄉,觀音村,886,517,55.35331906,417,44.64668094,934,44,978,0,1192,82.04697987
桃園縣,觀音鄉,白玉村,887,453,53.35689046,396,46.64310954,849,58,907,0,1114,81.41831239
桃園縣,觀音鄉,廣興村,888,551,53.33978703,482,46.66021297,1033,61,1094,0,1319,82.94162244
桃園縣,觀音鄉,大潭村,889,545,60.7580825,352,39.2419175,897,34,931,0,1172,79.43686007
桃園縣,觀音鄉,武威村,891,343,63.40110906,198,36.59889094,541,20,561,0,686,81.77842566
桃園縣,觀音鄉,保生村,890,719,58.74183007,505,41.25816993,1224,71,1295,0,1605,80.68535826
桃園縣,觀音鄉,三和村,892,353,62.25749559,214,37.74250441,567,37,604,0,753,80.2124834
桃園縣,觀音鄉,新興村,893,319,63.29365079,185,36.70634921,504,31,535,0,662,80.81570997
桃園縣,觀音鄉,坑尾村,894,547,59.0712743,379,40.9287257,926,64,990,0,1230,80.48780488
桃園縣,觀音鄉,金湖村,895,894,60.2020202,591,39.7979798,1485,68,1553,0,1916,81.05427975
桃園縣,觀音鄉,藍埔村,896,941,62.81708945,557,37.18291055,1498,64,1562,0,1928,81.01659751
桃園縣,觀音鄉,大同村,897,963,66.82859126,478,33.17140874,1441,54,1495,0,1824,81.9627193
桃園縣,觀音鄉,大堀村,898,570,69.68215159,248,30.31784841,818,40,858,0,1050,81.71428571
桃園縣,觀音鄉,崙坪村,899,814,60.5204461,531,39.4795539,1345,62,1407,0,1745,80.63037249
桃園縣,觀音鄉,崙坪村,900,871,59.9862259,581,40.0137741,1452,82,1534,0,1860,82.47311828
桃園縣,觀音鄉,富源村,901,842,55.57755776,673,44.42244224,1515,69,1584,0,1975,80.20253165
桃園縣,觀音鄉,上大村,902,806,61.62079511,502,38.37920489,1308,69,1377,0,1729,79.64141122
桃園縣,觀音鄉,新坡村,903,633,59.82986767,425,40.17013233,1058,38,1096,0,1304,84.04907975
桃園縣,觀音鄉,新坡村,904,730,72.85429142,272,27.14570858,1002,54,1056,0,1286,82.11508554
桃園縣,觀音鄉,廣福村,905,994,69.46191474,437,30.53808526,1431,60,1491,0,1830,81.47540984
桃園縣,觀音鄉,塔腳村,906,445,60.626703,289,39.373297,734,43,777,1,969,80.18575851
桃園縣,觀音鄉,保障村,907,903,62.75191105,536,37.24808895,1439,76,1515,0,1884,80.41401274
桃園縣,觀音鄉,草漯村,908,795,64.32038835,441,35.67961165,1236,46,1282,0,1517,84.50889914
桃園縣,觀音鄉,草漯村,909,820,53.28135153,719,46.71864847,1539,46,1585,0,1990,79.64824121
桃園縣,觀音鄉,樹林村,910,708,57.42092457,525,42.57907543,1233,72,1305,0,1695,76.99115044
桃園縣,觀音鄉,富林村,911,650,60.46511628,425,39.53488372,1075,17,1092,0,1348,81.00890208
新竹縣,竹北市,斗崙里,11,475,35.05535055,880,64.94464945,1355,20,1375,0,1640,83.84146341
新竹縣,竹北市,斗崙里,12,601,38.11033608,976,61.88966392,1577,23,1600,0,1869,85.60727662
新竹縣,竹北市,斗崙里,13,463,38.80972339,730,61.19027661,1193,28,1221,0,1421,85.92540464
新竹縣,竹北市,鹿場里,1,399,39.93993994,600,60.06006006,999,31,1030,0,1230,83.7398374
新竹縣,竹北市,東平里,2,122,60.3960396,80,39.6039604,202,5,207,0,237,87.34177215
新竹縣,竹北市,中興里,3,510,41.73486088,712,58.26513912,1222,24,1246,0,1516,82.18997361
新竹縣,竹北市,隘口里,4,199,44.32071269,250,55.67928731,449,13,462,0,559,82.64758497
新竹縣,竹北市,東海里,5,345,33.52769679,684,66.47230321,1029,35,1064,0,1296,82.09876543
新竹縣,竹北市,東海里,6,359,36.08040201,636,63.91959799,995,41,1036,0,1288,80.43478261
新竹縣,竹北市,竹北里,19,270,29.4438386,647,70.5561614,917,22,939,0,1129,83.17094774
新竹縣,竹北市,竹北里,20,365,38.1400209,592,61.8599791,957,21,978,0,1196,81.77257525
新竹縣,竹北市,竹北里,21,308,33.66120219,607,66.33879781,915,24,939,0,1184,79.30743243
新竹縣,竹北市,竹仁里,22,497,37.25637181,837,62.74362819,1334,32,1366,0,1700,80.35294118
新竹縣,竹北市,竹仁里,23,374,33.27402135,750,66.72597865,1124,21,1145,0,1412,81.09065156
新竹縣,竹北市,竹仁里,24,341,34.1,659,65.9,1000,22,1022,0,1276,80.09404389
新竹縣,竹北市,竹仁里,25,349,34.08203125,675,65.91796875,1024,14,1038,0,1260,82.38095238
新竹縣,竹北市,竹仁里,26,346,36.84771033,593,63.15228967,939,20,959,0,1154,83.10225303
新竹縣,竹北市,竹義里,30,241,39.70345964,366,60.29654036,607,16,623,0,756,82.40740741
新竹縣,竹北市,竹義里,31,209,35.54421769,379,64.45578231,588,9,597,0,734,81.33514986
新竹縣,竹北市,竹義里,32,388,41.05820106,557,58.94179894,945,20,965,0,1190,81.09243697
新竹縣,竹北市,竹義里,33,373,39.59660297,569,60.40339703,942,12,954,0,1200,79.5
新竹縣,竹北市,泰和里,34,476,40.8583691,689,59.1416309,1165,47,1212,0,1487,81.5063887
新竹縣,竹北市,泰和里,35,337,37.5696767,560,62.4303233,897,25,922,0,1158,79.62003454
新竹縣,竹北市,泰和里,36,293,32.66443701,604,67.33556299,897,6,903,0,1088,82.99632353
新竹縣,竹北市,新社里,37,334,33.83991895,653,66.16008105,987,21,1008,0,1262,79.87321712
新竹縣,竹北市,新社里,38,447,39.9463807,672,60.0536193,1119,21,1140,0,1423,80.11243851
新竹縣,竹北市,新社里,39,419,35.53859203,760,64.46140797,1179,11,1190,0,1450,82.06896552
新竹縣,竹北市,新社里,40,408,41.04627767,586,58.95372233,994,19,1013,0,1251,80.97521982
新竹縣,竹北市,聯興里,44,440,43.69414101,567,56.30585899,1007,15,1022,0,1247,81.95669607
新竹縣,竹北市,聯興里,45,379,46.38922889,438,53.61077111,817,21,838,0,1007,83.21747766
新竹縣,竹北市,聯興里,46,308,36.97478992,525,63.02521008,833,18,851,0,1031,82.54122211
新竹縣,竹北市,麻園里,47,532,53.90070922,455,46.09929078,987,40,1027,0,1214,84.59637562
新竹縣,竹北市,溪州里,48,360,51.35520685,341,48.64479315,701,16,717,0,858,83.56643357
新竹縣,竹北市,溪州里,49,353,47.7027027,387,52.2972973,740,18,758,0,967,78.38676319
新竹縣,竹北市,白地里,51,279,48.4375,297,51.5625,576,20,596,0,717,83.12412831
新竹縣,竹北市,白地里,52,486,61.13207547,309,38.86792453,795,24,819,0,984,83.23170732
新竹縣,竹北市,新港里,53,592,64.9122807,320,35.0877193,912,18,930,0,1097,84.77666363
新竹縣,竹北市,大義里,55,398,56.85714286,302,43.14285714,700,15,715,0,851,84.01880141
新竹縣,竹北市,大義里,56,271,60.62639821,176,39.37360179,447,18,465,0,567,82.01058201
新竹縣,竹北市,崇義里,59,379,51.98902606,350,48.01097394,729,21,750,0,897,83.61204013
新竹縣,竹北市,崇義里,60,413,60.11644833,274,39.88355167,687,10,697,0,818,85.20782396
新竹縣,竹北市,大眉里,54,510,44.54148472,635,55.45851528,1145,36,1181,0,1443,81.84338184
新竹縣,竹北市,尚義里,57,329,60.36697248,216,39.63302752,545,19,564,0,669,84.30493274
新竹縣,竹北市,尚義里,58,315,57.69230769,231,42.30769231,546,17,563,0,673,83.65527489
新竹縣,竹北市,十興里,7,340,38.50509626,543,61.49490374,883,25,908,0,1094,82.99817185
新竹縣,竹北市,十興里,8,389,34.95058401,724,65.04941599,1113,43,1156,0,1393,82.98636037
新竹縣,竹北市,十興里,9,530,42.81098546,708,57.18901454,1238,22,1260,1,1548,81.39534884
新竹縣,竹北市,十興里,10,425,32.02712886,902,67.97287114,1327,23,1350,0,1602,84.26966292
新竹縣,竹北市,新國里,41,384,39.91683992,578,60.08316008,962,22,984,0,1200,82
新竹縣,竹北市,新國里,42,434,38.92376682,681,61.07623318,1115,28,1143,0,1379,82.88614938
新竹縣,竹北市,新國里,43,358,44.47204969,447,55.52795031,805,18,823,0,1017,80.92428712
新竹縣,竹北市,新庄里,50,354,49.37238494,363,50.62761506,717,22,739,0,919,80.41349293
新竹縣,竹北市,北崙里,14,354,33.94055609,689,66.05944391,1043,11,1054,0,1214,86.82042834
新竹縣,竹北市,北崙里,15,407,37.16894977,688,62.83105023,1095,18,1113,0,1304,85.35276074
新竹縣,竹北市,新崙里,16,334,39.01869159,522,60.98130841,856,22,878,0,1064,82.51879699
新竹縣,竹北市,新崙里,17,445,39.66131907,677,60.33868093,1122,12,1134,0,1382,82.05499276
新竹縣,竹北市,新崙里,18,476,48.97119342,496,51.02880658,972,27,999,0,1237,80.75990299
新竹縣,竹北市,福德里,27,231,36.492891,402,63.507109,633,9,642,0,782,82.0971867
新竹縣,竹北市,福德里,28,294,33.52337514,583,66.47662486,877,16,893,1,1071,83.38001867
新竹縣,竹北市,福德里,29,337,44.34210526,423,55.65789474,760,13,773,0,1016,76.08267717
新竹縣,竹東鎮,上坪里,61,92,28.2208589,234,71.7791411,326,12,338,0,427,79.15690867
新竹縣,竹東鎮,瑞峰里,62,78,28.26086957,198,71.73913043,276,11,287,0,375,76.53333333
新竹縣,竹東鎮,軟橋里,63,115,39.65517241,175,60.34482759,290,9,299,0,369,81.0298103
新竹縣,竹東鎮,員崠里,64,184,28.30769231,466,71.69230769,650,14,664,0,862,77.03016241
新竹縣,竹東鎮,員崠里,65,235,27.71226415,613,72.28773585,848,15,863,0,1076,80.20446097
新竹縣,竹東鎮,東寧里,71,141,18.03069054,641,81.96930946,782,28,810,0,985,82.23350254
新竹縣,竹東鎮,東寧里,72,209,28.3197832,529,71.6802168,738,5,743,0,909,81.73817382
新竹縣,竹東鎮,東寧里,73,277,35.74193548,498,64.25806452,775,15,790,0,967,81.69596691
新竹縣,竹東鎮,上館里,66,278,25.18115942,826,74.81884058,1104,30,1134,0,1419,79.9154334
新竹縣,竹東鎮,上館里,67,333,26.68269231,915,73.31730769,1248,11,1259,0,1590,79.18238994
新竹縣,竹東鎮,上館里,68,299,26.67261374,822,73.32738626,1121,29,1150,0,1444,79.6398892
新竹縣,竹東鎮,上館里,69,379,34.36083409,724,65.63916591,1103,21,1124,0,1317,85.34548216
新竹縣,竹東鎮,上館里,70,237,25.05285412,709,74.94714588,946,28,974,0,1141,85.36371604
新竹縣,竹東鎮,大鄉里,76,289,30.32528856,664,69.67471144,953,21,974,0,1212,80.3630363
新竹縣,竹東鎮,大鄉里,77,280,32,595,68,875,20,895,0,1110,80.63063063
新竹縣,竹東鎮,大鄉里,78,296,26.95810565,802,73.04189435,1098,29,1127,0,1340,84.10447761
新竹縣,竹東鎮,東華里,82,234,35.08245877,433,64.91754123,667,17,684,0,798,85.71428571
新竹縣,竹東鎮,商華里,83,299,26.69642857,821,73.30357143,1120,27,1147,0,1460,78.56164384
新竹縣,竹東鎮,商華里,84,305,33.33333333,610,66.66666667,915,23,938,1,1137,82.49780123
新竹縣,竹東鎮,竹東里,90,195,37.00189753,332,62.99810247,527,11,538,0,640,84.0625
新竹縣,竹東鎮,竹東里,91,241,36.07784431,427,63.92215569,668,11,679,0,818,83.00733496
新竹縣,竹東鎮,榮樂里,93,202,33.61064892,399,66.38935108,601,13,614,0,740,82.97297297
新竹縣,竹東鎮,榮樂里,94,169,29.18825561,410,70.81174439,579,8,587,0,696,84.33908046
新竹縣,竹東鎮,雞林里,85,211,27.65399738,552,72.34600262,763,13,776,0,998,77.75551102
新竹縣,竹東鎮,雞林里,86,289,27.26415094,771,72.73584906,1060,12,1072,0,1291,83.03640589
新竹縣,竹東鎮,雞林里,87,243,28.4876905,610,71.5123095,853,25,878,0,1041,84.34197887
新竹縣,竹東鎮,仁愛里,88,268,25.67049808,776,74.32950192,1044,31,1075,0,1356,79.27728614
新竹縣,竹東鎮,仁愛里,89,413,34.76430976,775,65.23569024,1188,33,1221,0,1471,83.00475867
新竹縣,竹東鎮,五豐里,100,413,26.78339818,1129,73.21660182,1542,22,1564,0,1978,79.06976744
新竹縣,竹東鎮,五豐里,101,222,26.17924528,626,73.82075472,848,23,871,1,1074,81.09869646
新竹縣,竹東鎮,五豐里,102,188,32.98245614,382,67.01754386,570,16,586,0,701,83.59486448
新竹縣,竹東鎮,五豐里,103,210,21,790,79,1000,17,1017,0,1233,82.48175182
新竹縣,竹東鎮,五豐里,104,167,23.19444444,553,76.80555556,720,27,747,0,918,81.37254902
新竹縣,竹東鎮,三重里,106,332,33.33333333,664,66.66666667,996,25,1021,0,1228,83.14332248
新竹縣,竹東鎮,三重里,107,255,29.89449004,598,70.10550996,853,22,875,0,1088,80.42279412
新竹縣,竹東鎮,三重里,108,255,33.03108808,517,66.96891192,772,19,791,0,945,83.7037037
新竹縣,竹東鎮,三重里,109,150,31.57894737,325,68.42105263,475,10,485,0,578,83.9100346
新竹縣,竹東鎮,三重里,110,249,27.00650759,673,72.99349241,922,12,934,0,1169,79.89734816
新竹縣,竹東鎮,頭重里,116,349,36.89217759,597,63.10782241,946,11,957,0,1180,81.10169492
新竹縣,竹東鎮,頭重里,117,295,32.34649123,617,67.65350877,912,24,936,2,1109,84.40036069
新竹縣,竹東鎮,頭重里,118,287,27.81007752,745,72.18992248,1032,17,1049,1,1289,81.38091544
新竹縣,竹東鎮,員山里,119,377,31.86813187,806,68.13186813,1183,41,1224,0,1480,82.7027027
新竹縣,竹東鎮,柯湖里,120,219,43.19526627,288,56.80473373,507,27,534,0,658,81.1550152
新竹縣,竹東鎮,二重里,111,295,34.7467609,554,65.2532391,849,29,878,0,1074,81.75046555
新竹縣,竹東鎮,二重里,112,365,36.10286845,646,63.89713155,1011,14,1025,0,1262,81.22028526
新竹縣,竹東鎮,二重里,113,441,29.14738929,1072,70.85261071,1513,40,1553,0,2015,77.0719603
新竹縣,竹東鎮,二重里,114,346,30.89285714,774,69.10714286,1120,23,1143,0,1430,79.93006993
新竹縣,竹東鎮,二重里,115,224,27.82608696,581,72.17391304,805,17,822,0,1001,82.11788212
新竹縣,竹東鎮,中山里,79,228,31.10504775,505,68.89495225,733,14,747,0,914,81.72866521
新竹縣,竹東鎮,中山里,80,272,36.36363636,476,63.63636364,748,7,755,0,875,86.28571429
新竹縣,竹東鎮,中正里,74,207,36.83274021,355,63.16725979,562,16,578,0,736,78.5326087
新竹縣,竹東鎮,中正里,75,239,35.04398827,443,64.95601173,682,11,693,0,822,84.30656934
新竹縣,竹東鎮,南華里,81,316,33.4038055,630,66.5961945,946,25,971,1,1155,84.06926407
新竹縣,竹東鎮,榮華里,95,268,28.38983051,676,71.61016949,944,23,967,0,1149,84.16013925
新竹縣,竹東鎮,榮華里,96,248,28.21387941,631,71.78612059,879,22,901,0,1054,85.48387097
新竹縣,竹東鎮,榮華里,97,199,27.79329609,517,72.20670391,716,13,729,0,886,82.27990971
新竹縣,竹東鎮,榮華里,98,301,25.99309154,857,74.00690846,1158,10,1168,0,1390,84.02877698
新竹縣,竹東鎮,榮華里,99,200,24.87562189,604,75.12437811,804,21,825,0,1014,81.36094675
新竹縣,竹東鎮,忠孝里,92,345,30.26315789,795,69.73684211,1140,28,1168,0,1435,81.39372822
新竹縣,竹東鎮,陸豐里,105,125,32.72251309,257,67.27748691,382,12,394,0,509,77.40667976
新竹縣,新埔鎮,內立里,139,415,46.62921348,475,53.37078652,890,27,917,2,1115,82.24215247
新竹縣,新埔鎮,寶石里,140,301,46.16564417,351,53.83435583,652,25,677,1,806,83.99503722
新竹縣,新埔鎮,文山里,141,476,43.62969753,615,56.37030247,1091,39,1130,0,1401,80.6566738
新竹縣,新埔鎮,文山里,142,246,26.73913043,674,73.26086957,920,39,959,0,1152,83.24652778
新竹縣,新埔鎮,文山里,143,424,38.97058824,664,61.02941176,1088,32,1120,0,1393,80.40201005
新竹縣,新埔鎮,五埔里,129,293,41.61931818,411,58.38068182,704,28,732,0,882,82.99319728
新竹縣,新埔鎮,五埔里,130,295,38.16300129,478,61.83699871,773,30,803,0,979,82.02247191
新竹縣,新埔鎮,四座里,131,335,43.84816754,429,56.15183246,764,22,786,0,945,83.17460317
新竹縣,新埔鎮,四座里,132,350,45.10309278,426,54.89690722,776,15,791,0,951,83.17560463
新竹縣,新埔鎮,四座里,133,365,47.65013055,401,52.34986945,766,26,792,0,982,80.65173116
新竹縣,新埔鎮,旱坑里,127,238,33.28671329,477,66.71328671,715,25,740,0,929,79.6555436
新竹縣,新埔鎮,旱坑里,128,289,46.53784219,332,53.46215781,621,25,646,0,816,79.16666667
新竹縣,新埔鎮,田新里,124,222,31.98847262,472,68.01152738,694,28,722,1,871,82.89322618
新竹縣,新埔鎮,田新里,125,179,29.93311037,419,70.06688963,598,10,608,0,736,82.60869565
新竹縣,新埔鎮,田新里,126,278,44.26751592,350,55.73248408,628,9,637,0,757,84.14795244
新竹縣,新埔鎮,新埔里,121,319,37.4853114,532,62.5146886,851,18,869,0,1021,85.11263467
新竹縣,新埔鎮,新生里,122,233,42.75229358,312,57.24770642,545,21,566,0,685,82.62773723
新竹縣,新埔鎮,新民里,123,295,34.02537486,572,65.97462514,867,24,891,0,1070,83.27102804
新竹縣,新埔鎮,上寮里,144,613,45.71215511,728,54.28784489,1341,49,1390,0,1711,81.2390415
新竹縣,新埔鎮,下寮里,145,337,45.35666218,406,54.64333782,743,23,766,0,927,82.63214671
新竹縣,新埔鎮,下寮里,146,279,40.31791908,413,59.68208092,692,24,716,0,881,81.27128263
新竹縣,新埔鎮,南平里,147,330,42.47104247,447,57.52895753,777,43,820,0,999,82.08208208
新竹縣,新埔鎮,北平里,148,277,54.31372549,233,45.68627451,510,28,538,0,664,81.02409639
新竹縣,新埔鎮,巨埔里,138,461,51.27919911,438,48.72080089,899,39,938,0,1086,86.37200737
新竹縣,新埔鎮,照門里,134,530,48.80294659,556,51.19705341,1086,37,1123,0,1390,80.79136691
新竹縣,新埔鎮,清水里,135,203,57.83475783,148,42.16524217,351,15,366,0,446,82.06278027
新竹縣,新埔鎮,鹿鳴里,136,343,57.07154742,258,42.92845258,601,22,623,0,737,84.53188602
新竹縣,新埔鎮,新北里,137,295,60.45081967,193,39.54918033,488,17,505,0,602,83.88704319
新竹縣,關西鎮,東興里,149,166,34.94736842,309,65.05263158,475,6,481,0,552,87.13768116
新竹縣,關西鎮,西安里,150,172,28.95622896,422,71.04377104,594,16,610,0,717,85.07670851
新竹縣,關西鎮,西安里,151,242,28.20512821,616,71.79487179,858,20,878,0,1040,84.42307692
新竹縣,關西鎮,南雄里,152,229,36.93548387,391,63.06451613,620,19,639,0,754,84.74801061
新竹縣,關西鎮,北斗里,153,320,35.20352035,589,64.79647965,909,20,929,0,1118,83.09481216
新竹縣,關西鎮,北斗里,154,358,38.45327605,573,61.54672395,931,15,946,0,1130,83.71681416
新竹縣,關西鎮,北斗里,155,433,40.42950514,638,59.57049486,1071,29,1100,0,1351,81.4211695
新竹縣,關西鎮,仁安里,157,384,43.83561644,492,56.16438356,876,20,896,0,1097,81.67730173
新竹縣,關西鎮,北山里,156,282,46.00326264,331,53.99673736,613,8,621,0,746,83.24396783
新竹縣,關西鎮,南山里,158,356,45.06329114,434,54.93670886,790,35,825,0,1048,78.72137405
新竹縣,關西鎮,東安里,159,414,35.81314879,742,64.18685121,1156,53,1209,0,1487,81.30464022
新竹縣,關西鎮,東安里,160,437,37.51072961,728,62.48927039,1165,39,1204,0,1480,81.35135135
新竹縣,關西鎮,東光里,162,429,43.28960646,562,56.71039354,991,28,1019,0,1217,83.7304848
新竹縣,關西鎮,新富里,164,228,49.35064935,234,50.64935065,462,15,477,0,608,78.45394737
新竹縣,關西鎮,金山里,166,199,40.12096774,297,59.87903226,496,10,506,0,645,78.4496124
新竹縣,關西鎮,錦山里,167,337,38.82488479,531,61.17511521,868,16,884,0,1101,80.29064487
新竹縣,關西鎮,玉山里,165,178,42.99516908,236,57.00483092,414,21,435,0,541,80.40665434
新竹縣,關西鎮,大同里,168,317,53.27731092,278,46.72268908,595,23,618,0,738,83.7398374
新竹縣,關西鎮,石光里,169,259,36.78977273,445,63.21022727,704,31,735,0,899,81.75750834
新竹縣,關西鎮,石光里,170,306,40.6374502,447,59.3625498,753,22,775,0,935,82.88770053
新竹縣,關西鎮,上林里,172,218,33.28244275,437,66.71755725,655,23,678,0,845,80.23668639
新竹縣,關西鎮,新力里,173,200,40.24144869,297,59.75855131,497,28,525,0,620,84.67741935
新竹縣,關西鎮,南和里,174,291,43.04733728,385,56.95266272,676,9,685,0,797,85.94730238
新竹縣,關西鎮,東山里,161,288,45.78696343,341,54.21303657,629,31,660,0,789,83.65019011
新竹縣,關西鎮,南新里,163,295,38.31168831,475,61.68831169,770,38,808,0,983,82.19735504
新竹縣,關西鎮,東平里,171,352,44.50063211,439,55.49936789,791,27,818,0,976,83.81147541
新竹縣,湖口鄉,孝勢村,186,334,32.17726397,704,67.82273603,1038,36,1074,0,1306,82.23583461
新竹縣,湖口鄉,仁勢村,185,255,36.7965368,438,63.2034632,693,10,703,0,856,82.12616822
新竹縣,湖口鄉,愛勢村,182,364,40.57971014,533,59.42028986,897,20,917,0,1121,81.80196253
新竹縣,湖口鄉,愛勢村,183,329,29.93630573,770,70.06369427,1099,28,1127,1,1325,85.05660377
新竹縣,湖口鄉,愛勢村,184,375,32.83712785,767,67.16287215,1142,23,1165,0,1412,82.50708215
新竹縣,湖口鄉,信勢村,191,344,40.85510689,498,59.14489311,842,21,863,0,1012,85.27667984
新竹縣,湖口鄉,信勢村,192,284,33.25526932,570,66.74473068,854,19,873,0,1082,80.68391867
新竹縣,湖口鄉,信勢村,193,392,35.99632691,697,64.00367309,1089,36,1125,0,1406,80.01422475
新竹縣,湖口鄉,中勢村,187,284,32.53150057,589,67.46849943,873,10,883,0,1046,84.416826
新竹縣,湖口鄉,中勢村,188,370,33.72835005,727,66.27164995,1097,31,1128,0,1327,85.0037679
新竹縣,湖口鄉,德盛村,179,415,45.95791805,488,54.04208195,903,22,925,0,1111,83.25832583
新竹縣,湖口鄉,德盛村,180,372,37.57575758,618,62.42424242,990,18,1008,0,1217,82.82662284
新竹縣,湖口鄉,德盛村,181,344,37.31019523,578,62.68980477,922,39,961,0,1203,79.88362427
新竹縣,湖口鄉,和興村,175,436,45.13457557,530,54.86542443,966,46,1012,0,1216,83.22368421
新竹縣,湖口鄉,和興村,176,398,42.56684492,537,57.43315508,935,30,965,0,1163,82.97506449
新竹縣,湖口鄉,長嶺村,197,335,35.82887701,600,64.17112299,935,36,971,0,1177,82.49787596
新竹縣,湖口鄉,長嶺村,198,409,36.61593554,708,63.38406446,1117,36,1153,0,1406,82.0056899
新竹縣,湖口鄉,長安村,199,351,45.11568123,427,54.88431877,778,26,804,0,1005,80
新竹縣,湖口鄉,湖口村,200,379,34.64351005,715,65.35648995,1094,29,1123,0,1330,84.43609023
新竹縣,湖口鄉,湖口村,201,298,36.34146341,522,63.65853659,820,18,838,0,1023,81.91593353
新竹縣,湖口鄉,湖鏡村,202,277,29.28118393,669,70.71881607,946,30,976,0,1188,82.15488215
新竹縣,湖口鄉,湖鏡村,203,194,24.28035044,605,75.71964956,799,25,824,0,973,84.68653649
新竹縣,湖口鄉,湖南村,204,314,30.36750484,720,69.63249516,1034,33,1067,0,1344,79.38988095
新竹縣,湖口鄉,波羅村,196,513,37.41794311,858,62.58205689,1371,30,1401,0,1803,77.70382696
新竹縣,湖口鄉,鳳凰村,208,281,35.125,519,64.875,800,8,808,0,1017,79.44936087
新竹縣,湖口鄉,鳳凰村,209,296,29.6,704,70.4,1000,18,1018,0,1301,78.24750192
新竹縣,湖口鄉,鳳凰村,210,294,35.42168675,536,64.57831325,830,14,844,0,1056,79.92424242
新竹縣,湖口鄉,鳳山村,213,349,30.11216566,810,69.88783434,1159,29,1188,0,1479,80.32454361
新竹縣,湖口鄉,鳳山村,214,151,16.92825112,741,83.07174888,892,21,913,0,1161,78.63910422
新竹縣,湖口鄉,中興村,205,137,14.62113127,800,85.37886873,937,34,971,0,1173,82.77919864
新竹縣,湖口鄉,中興村,206,98,10.79295154,810,89.20704846,908,33,941,1,1124,83.71886121
新竹縣,湖口鄉,中興村,207,325,27.19665272,870,72.80334728,1195,22,1217,0,1509,80.64943671
新竹縣,湖口鄉,信義村,194,323,36.53846154,561,63.46153846,884,26,910,0,1104,82.42753623
新竹縣,湖口鄉,信義村,195,296,33.82857143,579,66.17142857,875,24,899,0,1081,83.16373728
新竹縣,湖口鄉,中正村,189,358,37.56558237,595,62.43441763,953,25,978,0,1143,85.56430446
新竹縣,湖口鄉,中正村,190,283,33.49112426,562,66.50887574,845,17,862,0,1030,83.68932039
新竹縣,湖口鄉,東興村,177,366,35.53398058,664,64.46601942,1030,30,1060,0,1310,80.91603053
新竹縣,湖口鄉,東興村,178,482,35.65088757,870,64.34911243,1352,29,1381,0,1750,78.91428571
新竹縣,湖口鄉,勝利村,211,335,32.52427184,695,67.47572816,1030,21,1051,0,1323,79.44066515
新竹縣,湖口鄉,勝利村,212,102,11.97183099,750,88.02816901,852,30,882,0,1064,82.89473684
新竹縣,新豐鄉,福興村,215,325,43.97834912,414,56.02165088,739,2,741,0,889,83.35208099
新竹縣,新豐鄉,後湖村,216,217,33.85335413,424,66.14664587,641,26,667,0,806,82.75434243
新竹縣,新豐鄉,後湖村,217,322,47.28340675,359,52.71659325,681,24,705,0,870,81.03448276
新竹縣,新豐鄉,青埔村,218,406,36.94267516,693,63.05732484,1099,40,1139,0,1392,81.82471264
新竹縣,新豐鄉,埔和村,219,532,53.36008024,465,46.63991976,997,29,1026,0,1272,80.66037736
新竹縣,新豐鄉,埔和村,220,459,58.99742931,319,41.00257069,778,23,801,0,984,81.40243902
新竹縣,新豐鄉,瑞興村,224,455,42.68292683,611,57.31707317,1066,29,1095,0,1366,80.16105417
新竹縣,新豐鄉,坡頭村,221,345,53.07692308,305,46.92307692,650,23,673,0,805,83.60248447
新竹縣,新豐鄉,中崙村,225,410,40.31465093,607,59.68534907,1017,34,1051,0,1278,82.23787167
新竹縣,新豐鄉,中崙村,226,248,30.06060606,577,69.93939394,825,32,857,0,1094,78.33638026
新竹縣,新豐鄉,重興村,227,328,35.34482759,600,64.65517241,928,17,945,0,1235,76.51821862
新竹縣,新豐鄉,重興村,228,272,30.28953229,626,69.71046771,898,21,919,0,1100,83.54545455
新竹縣,新豐鄉,重興村,229,293,33.83371824,573,66.16628176,866,13,879,0,1135,77.44493392
新竹縣,新豐鄉,重興村,230,347,34.35643564,663,65.64356436,1010,17,1027,0,1284,79.98442368
新竹縣,新豐鄉,重興村,231,269,29.82261641,633,70.17738359,902,19,921,0,1158,79.53367876
新竹縣,新豐鄉,新豐村,222,467,53.37142857,408,46.62857143,875,24,899,0,1063,84.57196613
新竹縣,新豐鄉,新豐村,223,489,61.4321608,307,38.5678392,796,37,833,0,1032,80.71705426
新竹縣,新豐鄉,員山村,234,383,34.38061041,731,65.61938959,1114,26,1140,0,1394,81.77905308
新竹縣,新豐鄉,員山村,235,339,32.88069835,692,67.11930165,1031,34,1065,0,1323,80.49886621
新竹縣,新豐鄉,員山村,236,332,29.02097902,812,70.97902098,1144,11,1155,0,1381,83.63504707
新竹縣,新豐鄉,員山村,237,371,31.36094675,812,68.63905325,1183,31,1214,0,1512,80.29100529
新竹縣,新豐鄉,員山村,238,453,35.78199052,813,64.21800948,1266,25,1291,0,1632,79.10539216
新竹縣,新豐鄉,松林村,239,218,29.74079127,515,70.25920873,733,7,740,0,932,79.39914163
新竹縣,新豐鄉,松林村,240,309,32.59493671,639,67.40506329,948,21,969,0,1239,78.20823245
新竹縣,新豐鄉,松林村,241,230,25.5839822,669,74.4160178,899,29,928,0,1160,80
新竹縣,新豐鄉,松林村,242,235,29.04820766,574,70.95179234,809,20,829,0,1061,78.133836
新竹縣,新豐鄉,上坑村,232,423,38.10810811,687,61.89189189,1110,27,1137,0,1437,79.12317328
新竹縣,新豐鄉,鳳坑村,233,299,38.58064516,476,61.41935484,775,27,802,0,966,83.02277433
新竹縣,芎林鄉,五龍村,244,119,29.89949749,279,70.10050251,398,15,413,0,484,85.33057851
新竹縣,芎林鄉,華龍村,243,129,38.16568047,209,61.83431953,338,12,350,0,424,82.54716981
新竹縣,芎林鄉,秀湖村,245,182,25.96291013,519,74.03708987,701,18,719,0,855,84.09356725
新竹縣,芎林鄉,永興村,246,92,28.04878049,236,71.95121951,328,4,332,0,397,83.62720403
新竹縣,芎林鄉,石潭村,247,193,25.69906791,558,74.30093209,751,9,760,0,947,80.25343189
新竹縣,芎林鄉,石潭村,248,427,37.85460993,701,62.14539007,1128,29,1157,0,1420,81.47887324
新竹縣,芎林鄉,新鳳村,249,410,38.10408922,666,61.89591078,1076,41,1117,1,1389,80.41756659
新竹縣,芎林鄉,中坑村,250,103,23.35600907,338,76.64399093,441,18,459,0,551,83.3030853
新竹縣,芎林鄉,水坑村,251,197,36.21323529,347,63.78676471,544,12,556,0,664,83.73493976
新竹縣,芎林鄉,文林村,252,302,36.03818616,536,63.96181384,838,34,872,0,1040,83.84615385
新竹縣,芎林鄉,文林村,253,291,33.33333333,582,66.66666667,873,21,894,0,1067,83.78631678
新竹縣,芎林鄉,芎林村,254,434,36.16666667,766,63.83333333,1200,32,1232,0,1474,83.58208955
新竹縣,芎林鄉,上山村,255,432,37.82837128,710,62.17162872,1142,34,1176,0,1384,84.97109827
新竹縣,芎林鄉,上山村,256,253,39.04320988,395,60.95679012,648,16,664,0,805,82.48447205
新竹縣,芎林鄉,上山村,257,298,40.76607387,433,59.23392613,731,33,764,0,914,83.58862144
新竹縣,芎林鄉,下山村,258,326,37.47126437,544,62.52873563,870,36,906,0,1068,84.83146067
新竹縣,橫山鄉,橫山村,259,279,28.97196262,684,71.02803738,963,24,987,0,1170,84.35897436
新竹縣,橫山鄉,橫山村,260,227,29.13992298,552,70.86007702,779,11,790,1,1006,78.52882704
新竹縣,橫山鄉,橫山村,261,316,38.48964677,505,61.51035323,821,30,851,1,1072,79.38432836
新竹縣,橫山鄉,田寮村,262,268,38.7283237,424,61.2716763,692,19,711,0,846,84.04255319
新竹縣,橫山鄉,南昌村,263,44,36.06557377,78,63.93442623,122,12,134,0,165,81.21212121
新竹縣,橫山鄉,豐鄉村,264,38,30.64516129,86,69.35483871,124,2,126,0,166,75.90361446
新竹縣,橫山鄉,豐田村,265,113,41.85185185,157,58.14814815,270,12,282,0,332,84.93975904
新竹縣,橫山鄉,內灣村,266,203,25.12376238,605,74.87623762,808,33,841,0,1068,78.74531835
新竹縣,橫山鄉,福興村,269,158,40.51282051,232,59.48717949,390,11,401,0,472,84.95762712
新竹縣,橫山鄉,沙坑村,270,197,31.82552504,422,68.17447496,619,3,622,0,754,82.4933687
新竹縣,橫山鄉,沙坑村,271,154,51.67785235,144,48.32214765,298,6,304,0,344,88.37209302
新竹縣,橫山鄉,新興村,272,185,30.08130081,430,69.91869919,615,15,630,0,740,85.13513514
新竹縣,橫山鄉,新興村,273,191,28.25443787,485,71.74556213,676,15,691,0,811,85.20345253
新竹縣,橫山鄉,大肚村,274,287,25.42072631,842,74.57927369,1129,16,1145,0,1370,83.57664234
新竹縣,橫山鄉,力行村,267,133,27.36625514,353,72.63374486,486,6,492,0,599,82.13689482
新竹縣,橫山鄉,力行村,268,62,28.7037037,154,71.2962963,216,13,229,0,266,86.09022556
新竹縣,北埔鄉,北埔村,275,312,34.09836066,603,65.90163934,915,27,942,0,1163,80.99742046
新竹縣,北埔鄉,南興村,276,298,29.33070866,718,70.66929134,1016,35,1051,0,1268,82.88643533
新竹縣,北埔鄉,埔尾村,278,266,34.77124183,499,65.22875817,765,23,788,0,922,85.46637744
新竹縣,北埔鄉,埔尾村,279,416,37.14285714,704,62.85714286,1120,41,1161,0,1445,80.34602076
新竹縣,北埔鄉,水際村,280,264,44.74576271,326,55.25423729,590,25,615,0,789,77.94676806
新竹縣,北埔鄉,南埔村,281,96,31.47540984,209,68.52459016,305,12,317,0,379,83.64116095
新竹縣,北埔鄉,大林村,282,150,27.88104089,388,72.11895911,538,29,567,0,659,86.03945372
新竹縣,北埔鄉,大湖村,277,125,32.2997416,262,67.7002584,387,18,405,0,508,79.72440945
新竹縣,北埔鄉,南坑村,283,98,35.8974359,175,64.1025641,273,10,283,0,358,79.05027933
新竹縣,北埔鄉,外坪村,284,116,48.13278008,125,51.86721992,241,8,249,0,309,80.58252427
新竹縣,寶山鄉,雙溪村,285,339,34.24242424,651,65.75757576,990,18,1008,0,1227,82.15158924
新竹縣,寶山鄉,雙溪村,286,311,31.13113113,688,68.86886887,999,19,1018,0,1258,80.92209857
新竹縣,寶山鄉,雙溪村,287,306,29.33844679,737,70.66155321,1043,17,1060,0,1268,83.59621451
新竹縣,寶山鄉,大崎村,288,288,39.45205479,442,60.54794521,730,24,754,0,949,79.45205479
新竹縣,寶山鄉,三峰村,289,251,40.94616639,362,59.05383361,613,33,646,0,755,85.56291391
新竹縣,寶山鄉,新城村,290,361,42.22222222,494,57.77777778,855,6,861,0,1066,80.76923077
新竹縣,寶山鄉,深井村,292,200,34.30531732,383,65.69468268,583,5,588,0,713,82.4684432
新竹縣,寶山鄉,寶斗村,291,238,46.21359223,277,53.78640777,515,17,532,0,649,81.97226502
新竹縣,寶山鄉,山湖村,295,161,41.60206718,226,58.39793282,387,5,392,0,488,80.32786885
新竹縣,寶山鄉,寶山村,293,145,28.48722986,364,71.51277014,509,12,521,0,626,83.22683706
新竹縣,寶山鄉,油田村,294,196,43.55555556,254,56.44444444,450,2,452,0,558,81.00358423
新竹縣,峨眉鄉,峨眉村,296,246,34.02489627,477,65.97510373,723,23,746,0,879,84.86916951
新竹縣,峨眉鄉,中盛村,297,302,51.62393162,283,48.37606838,585,26,611,0,724,84.39226519
新竹縣,峨眉鄉,石井村,298,232,45.66929134,276,54.33070866,508,20,528,0,622,84.88745981
新竹縣,峨眉鄉,富興村,301,404,43.58144552,523,56.41855448,927,28,955,0,1232,77.51623377
新竹縣,峨眉鄉,七星村,299,124,46.61654135,142,53.38345865,266,17,283,0,333,84.98498498
新竹縣,峨眉鄉,七星村,300,107,45.53191489,128,54.46808511,235,9,244,0,285,85.61403509
新竹縣,峨眉鄉,湖光村,302,205,54.5212766,171,45.4787234,376,17,393,0,492,79.87804878
新竹縣,峨眉鄉,湖光村,303,175,52.55255255,158,47.44744745,333,17,350,0,410,85.36585366
新竹縣,尖石鄉,義興村,304,132,23.86980108,421,76.13019892,553,19,572,0,717,79.77684798
新竹縣,尖石鄉,義興村,305,40,18.86792453,172,81.13207547,212,8,220,0,270,81.48148148
新竹縣,尖石鄉,嘉樂村,306,42,15.44117647,230,84.55882353,272,11,283,0,351,80.62678063
新竹縣,尖石鄉,新樂村,307,86,11.08247423,690,88.91752577,776,21,797,0,1044,76.34099617
新竹縣,尖石鄉,梅花村,310,70,19.49860724,289,80.50139276,359,13,372,0,492,75.6097561
新竹縣,尖石鄉,錦屏村,308,34,10.55900621,288,89.44099379,322,4,326,0,418,77.99043062
新竹縣,尖石鄉,錦屏村,309,55,13.12649165,364,86.87350835,419,7,426,0,549,77.59562842
新竹縣,尖石鄉,玉峰村,311,36,11.72638436,271,88.27361564,307,7,314,0,385,81.55844156
新竹縣,尖石鄉,玉峰村,312,55,23.30508475,181,76.69491525,236,6,242,0,334,72.45508982
新竹縣,尖石鄉,秀巒村,313,37,17.87439614,170,82.12560386,207,2,209,1,272,76.83823529
新竹縣,尖石鄉,秀巒村,314,101,25,303,75,404,7,411,0,633,64.92890995
新竹縣,尖石鄉,秀巒村,315,73,48.02631579,79,51.97368421,152,4,156,0,198,78.78787879
新竹縣,五峰鄉,大隘村,316,57,10.71428571,475,89.28571429,532,4,536,0,678,79.0560472
新竹縣,五峰鄉,大隘村,317,60,13.24503311,393,86.75496689,453,4,457,1,617,74.06807131
新竹縣,五峰鄉,花園村,318,118,25.76419214,340,74.23580786,458,3,461,0,610,75.57377049
新竹縣,五峰鄉,竹林村,319,35,15.69506726,188,84.30493274,223,2,225,0,289,77.85467128
新竹縣,五峰鄉,桃山村,320,63,15.71072319,338,84.28927681,401,9,410,0,572,71.67832168
新竹縣,五峰鄉,桃山村,321,116,20.9009009,439,79.0990991,555,8,563,0,730,77.12328767
苗栗縣,苗栗市,中苗里,1,252,31.69811321,543,68.30188679,795,15,810,0,1010,80.1980198
苗栗縣,苗栗市,建功里,42,225,32.7510917,462,67.2489083,687,12,699,0,865,80.80924855
苗栗縣,苗栗市,建功里,43,317,30.48076923,723,69.51923077,1040,30,1070,0,1271,84.18568057
苗栗縣,苗栗市,建功里,44,321,27.2264631,858,72.7735369,1179,13,1192,0,1463,81.47641832
苗栗縣,苗栗市,青苗里,2,279,34.96240602,519,65.03759398,798,18,816,0,1046,78.01147228
苗栗縣,苗栗市,玉清里,9,245,27.22222222,655,72.77777778,900,20,920,0,1151,79.93049522
苗栗縣,苗栗市,玉清里,10,311,33.33333333,622,66.66666667,933,24,957,0,1170,81.79487179
苗栗縣,苗栗市,玉華里,11,253,27.77167947,658,72.22832053,911,23,934,0,1152,81.07638889
苗栗縣,苗栗市,玉華里,12,240,29.85074627,564,70.14925373,804,25,829,0,1049,79.02764538
苗栗縣,苗栗市,玉華里,13,263,28.0982906,673,71.9017094,936,31,967,0,1163,83.14703353
苗栗縣,苗栗市,維新里,6,308,32.55813953,638,67.44186047,946,26,972,0,1264,76.89873418
苗栗縣,苗栗市,維新里,7,290,28.01932367,745,71.98067633,1035,28,1063,0,1290,82.40310078
苗栗縣,苗栗市,維新里,8,298,32.63964951,615,67.36035049,913,29,942,0,1218,77.33990148
苗栗縣,苗栗市,維祥里,3,229,27.32696897,609,72.67303103,838,14,852,0,1036,82.23938224
苗栗縣,苗栗市,維祥里,4,247,31.34517766,541,68.65482234,788,19,807,0,1004,80.37848606
苗栗縣,苗栗市,維祥里,5,265,32.4754902,551,67.5245098,816,17,833,0,1037,80.32786885
苗栗縣,苗栗市,綠苗里,14,251,35.95988539,447,64.04011461,698,24,722,0,894,80.7606264
苗栗縣,苗栗市,高苗里,15,318,31.36094675,696,68.63905325,1014,25,1039,0,1288,80.66770186
苗栗縣,苗栗市,高苗里,16,383,35.00914077,711,64.99085923,1094,23,1117,0,1443,77.40817741
苗栗縣,苗栗市,玉苗里,18,276,34.71698113,519,65.28301887,795,25,820,0,1050,78.0952381
苗栗縣,苗栗市,大同里,19,158,31.6,342,68.4,500,15,515,0,642,80.21806854
苗栗縣,苗栗市,新苗里,17,276,36.75099867,475,63.24900133,751,23,774,0,947,81.73178458
苗栗縣,苗栗市,勝利里,23,311,30.70088845,702,69.29911155,1013,31,1044,0,1300,80.30769231
苗栗縣,苗栗市,勝利里,24,349,30.50699301,795,69.49300699,1144,27,1171,1,1419,82.52290345
苗栗縣,苗栗市,勝利里,25,251,38.7345679,397,61.2654321,648,23,671,0,818,82.02933985
苗栗縣,苗栗市,恭敬里,20,363,28.85532591,895,71.14467409,1258,26,1284,0,1580,81.26582278
苗栗縣,苗栗市,上苗里,29,216,34.50479233,410,65.49520767,626,14,640,0,779,82.15661104
苗栗縣,苗栗市,上苗里,30,289,36.30653266,507,63.69346734,796,17,813,0,996,81.62650602
苗栗縣,苗栗市,北苗里,31,357,35.13779528,659,64.86220472,1016,27,1043,1,1254,83.1738437
苗栗縣,苗栗市,北苗里,32,383,29.46153846,917,70.53846154,1300,36,1336,1,1649,81.01879927
苗栗縣,苗栗市,北苗里,33,339,28.80203908,838,71.19796092,1177,13,1190,0,1437,82.81141267
苗栗縣,苗栗市,清華里,26,228,31.97755961,485,68.02244039,713,10,723,0,894,80.87248322
苗栗縣,苗栗市,清華里,27,302,31.13402062,668,68.86597938,970,25,995,0,1209,82.29942101
苗栗縣,苗栗市,清華里,28,264,35.43624161,481,64.56375839,745,12,757,0,925,81.83783784
苗栗縣,苗栗市,嘉盛里,34,451,36.37096774,789,63.62903226,1240,38,1278,0,1603,79.72551466
苗栗縣,苗栗市,嘉盛里,35,349,30.03442341,813,69.96557659,1162,45,1207,1,1525,79.14754098
苗栗縣,苗栗市,福星里,38,394,31.69750603,849,68.30249397,1243,35,1278,0,1599,79.9249531
苗栗縣,苗栗市,福星里,39,441,32.4981577,916,67.5018423,1357,31,1388,0,1726,80.41714948
苗栗縣,苗栗市,新川里,51,280,34.86924035,523,65.13075965,803,41,844,0,1110,76.03603604
苗栗縣,苗栗市,文山里,48,388,30.69620253,876,69.30379747,1264,31,1295,0,1601,80.88694566
苗栗縣,苗栗市,文山里,49,357,30.4088586,817,69.5911414,1174,31,1205,0,1522,79.17214192
苗栗縣,苗栗市,文山里,50,495,36.9955157,843,63.0044843,1338,36,1374,0,1758,78.15699659
苗栗縣,苗栗市,福麗里,45,351,33.05084746,711,66.94915254,1062,17,1079,0,1349,79.9851742
苗栗縣,苗栗市,福麗里,46,327,26.93574959,887,73.06425041,1214,28,1242,1,1527,81.33595285
苗栗縣,苗栗市,福麗里,47,328,31.41762452,716,68.58237548,1044,26,1070,0,1367,78.27359181
苗栗縣,苗栗市,水源里,21,325,30.20446097,751,69.79553903,1076,18,1094,0,1376,79.50581395
苗栗縣,苗栗市,水源里,22,202,24.3373494,628,75.6626506,830,21,851,0,1015,83.84236453
苗栗縣,苗栗市,新英里,52,379,34.64351005,715,65.35648995,1094,46,1140,0,1505,75.74750831
苗栗縣,苗栗市,福安里,40,296,31.25659979,651,68.74340021,947,31,978,0,1216,80.42763158
苗栗縣,苗栗市,福安里,41,355,32.77931671,728,67.22068329,1083,31,1114,0,1437,77.52261656
苗栗縣,苗栗市,嘉新里,36,336,30.76923077,756,69.23076923,1092,26,1118,0,1336,83.68263473
苗栗縣,苗栗市,嘉新里,37,298,29.53419227,711,70.46580773,1009,7,1016,0,1194,85.0921273
苗栗縣,苗栗市,南勢里,53,150,24.42996743,464,75.57003257,614,30,644,0,813,79.21279213
苗栗縣,苗栗市,南勢里,54,292,40.1650619,435,59.8349381,727,23,750,0,965,77.72020725
苗栗縣,苑裡鎮,苑東里,55,281,52.13358071,258,47.86641929,539,15,554,0,684,80.99415205
苗栗縣,苑裡鎮,苑東里,56,496,57.07710012,373,42.92289988,869,31,900,0,1102,81.66969147
苗栗縣,苑裡鎮,苑南里,57,392,51.71503958,366,48.28496042,758,18,776,0,945,82.11640212
苗栗縣,苑裡鎮,苑南里,58,337,60.72072072,218,39.27927928,555,22,577,0,726,79.47658402
苗栗縣,苑裡鎮,苑北里,59,380,54.75504323,314,45.24495677,694,17,711,0,901,78.91231964
苗栗縣,苑裡鎮,西平里,60,620,59.44391179,423,40.55608821,1043,41,1084,0,1321,82.05904618
苗栗縣,苑裡鎮,苑港里,61,598,67.64705882,286,32.35294118,884,50,934,0,1145,81.5720524
苗栗縣,苑裡鎮,西勢里,62,393,54.05777166,334,45.94222834,727,9,736,0,912,80.70175439
苗栗縣,苑裡鎮,西勢里,63,346,57.19008264,259,42.80991736,605,23,628,0,777,80.82368082
苗栗縣,苑裡鎮,海岸里,64,491,62.30964467,297,37.69035533,788,38,826,0,1024,80.6640625
苗栗縣,苑裡鎮,房裡里,65,437,53.42298289,381,46.57701711,818,36,854,0,1055,80.9478673
苗栗縣,苑裡鎮,房裡里,66,503,60.23952096,332,39.76047904,835,33,868,0,1109,78.26871055
苗栗縣,苑裡鎮,客庄里,67,464,53.95348837,396,46.04651163,860,24,884,0,1090,81.10091743
苗栗縣,苑裡鎮,客庄里,68,501,54.81400438,413,45.18599562,914,19,933,0,1131,82.4933687
苗栗縣,苑裡鎮,客庄里,69,451,50.22271715,447,49.77728285,898,18,916,0,1119,81.8588025
苗栗縣,苑裡鎮,中正里,70,467,62.93800539,275,37.06199461,742,20,762,0,916,83.18777293
苗栗縣,苑裡鎮,中正里,71,425,58.70165746,299,41.29834254,724,25,749,0,893,83.87458007
苗栗縣,苑裡鎮,苑坑里,72,529,68.43467012,244,31.56532988,773,45,818,0,1011,80.90999011
苗栗縣,苑裡鎮,水坡里,73,273,63.19444444,159,36.80555556,432,23,455,0,604,75.33112583
苗栗縣,苑裡鎮,新復里,74,478,54.01129944,407,45.98870056,885,37,922,0,1114,82.76481149
苗栗縣,苑裡鎮,山腳里,75,378,61.56351792,236,38.43648208,614,25,639,0,800,79.875
苗栗縣,苑裡鎮,山腳里,76,292,54.88721805,240,45.11278195,532,26,558,0,701,79.60057061
苗栗縣,苑裡鎮,舊社里,77,401,53.25365206,352,46.74634794,753,30,783,0,954,82.0754717
苗栗縣,苑裡鎮,舊社里,78,338,56.61641541,259,43.38358459,597,18,615,0,752,81.78191489
苗栗縣,苑裡鎮,福田里,79,556,61.30099228,351,38.69900772,907,48,955,0,1233,77.45336577
苗栗縣,苑裡鎮,石鎮里,80,275,56.35245902,213,43.64754098,488,24,512,0,618,82.84789644
苗栗縣,苑裡鎮,蕉埔里,81,365,53.05232558,323,46.94767442,688,37,725,0,893,81.18701008
苗栗縣,苑裡鎮,社苓里,87,453,57.34177215,337,42.65822785,790,35,825,0,1022,80.72407045
苗栗縣,苑裡鎮,社苓里,88,509,63.15136476,297,36.84863524,806,44,850,0,1029,82.60447036
苗栗縣,苑裡鎮,泰田里,83,340,54.9273021,279,45.0726979,619,23,642,0,803,79.9501868
苗栗縣,苑裡鎮,泰田里,84,316,60.53639847,206,39.46360153,522,21,543,0,679,79.97054492
苗栗縣,苑裡鎮,上館里,85,646,56.36998255,500,43.63001745,1146,66,1212,0,1539,78.75243665
苗栗縣,苑裡鎮,玉田里,86,707,58.42975207,503,41.57024793,1210,47,1257,0,1623,77.44916821
苗栗縣,苑裡鎮,南勢里,82,341,62.56880734,204,37.43119266,545,29,574,0,727,78.95460798
苗栗縣,苑裡鎮,山柑里,89,540,55.72755418,429,44.27244582,969,34,1003,0,1207,83.09859155
苗栗縣,苑裡鎮,田心里,90,626,58.34109972,447,41.65890028,1073,45,1118,0,1362,82.08516887
苗栗縣,通霄鎮,通東里,91,512,50.74331021,497,49.25668979,1009,27,1036,0,1259,82.28752979
苗栗縣,通霄鎮,通西里,92,393,51.71052632,367,48.28947368,760,13,773,0,952,81.19747899
苗栗縣,通霄鎮,通西里,93,440,46.07329843,515,53.92670157,955,40,995,0,1207,82.43579122
苗栗縣,通霄鎮,平元里,94,514,53.04437564,455,46.95562436,969,25,994,0,1212,82.01320132
苗栗縣,通霄鎮,平元里,95,590,56.03038936,463,43.96961064,1053,32,1085,0,1382,78.50940666
苗栗縣,通霄鎮,平元里,96,463,51.55902004,435,48.44097996,898,36,934,0,1203,77.63923525
苗栗縣,通霄鎮,梅南里,98,327,51.33437991,310,48.66562009,637,16,653,0,827,78.96009674
苗栗縣,通霄鎮,梅南里,99,282,55.29411765,228,44.70588235,510,31,541,0,666,81.23123123
苗栗縣,通霄鎮,圳頭里,97,334,57.19178082,250,42.80821918,584,49,633,0,760,83.28947368
苗栗縣,通霄鎮,通南里,100,470,48.85654886,492,51.14345114,962,24,986,1,1248,79.00641026
苗栗縣,通霄鎮,通南里,101,509,50,509,50,1018,30,1048,0,1343,78.03425168
苗栗縣,通霄鎮,城北里,108,325,60.07393715,216,39.92606285,541,21,562,0,702,80.05698006
苗栗縣,通霄鎮,城南里,109,418,57.57575758,308,42.42424242,726,52,778,0,998,77.95591182
苗栗縣,通霄鎮,南和里,110,373,57.20858896,279,42.79141104,652,28,680,0,834,81.53477218
苗栗縣,通霄鎮,福興里,111,285,61.02783726,182,38.97216274,467,29,496,0,645,76.89922481
苗栗縣,通霄鎮,坪頂里,112,441,48.51485149,468,51.48514851,909,51,960,0,1193,80.46940486
苗栗縣,通霄鎮,五南里,113,511,49.37198068,524,50.62801932,1035,33,1068,0,1336,79.94011976
苗栗縣,通霄鎮,五北里,114,254,47.12430427,285,52.87569573,539,27,566,0,693,81.67388167
苗栗縣,通霄鎮,五北里,115,389,64.51077944,214,35.48922056,603,41,644,0,767,83.96349413
苗栗縣,通霄鎮,內湖里,102,295,52.12014134,271,47.87985866,566,29,595,0,743,80.0807537
苗栗縣,通霄鎮,內湖里,103,379,48.03548796,410,51.96451204,789,44,833,0,1024,81.34765625
苗栗縣,通霄鎮,楓樹里,104,212,53.26633166,186,46.73366834,398,26,424,0,539,78.66419295
苗栗縣,通霄鎮,烏眉里,105,297,42.30769231,405,57.69230769,702,32,734,0,943,77.83669141
苗栗縣,通霄鎮,福龍里,106,139,38.61111111,221,61.38888889,360,8,368,0,478,76.9874477
苗栗縣,通霄鎮,福源里,107,265,45.14480409,322,54.85519591,587,33,620,0,787,78.78017789
苗栗縣,通霄鎮,通灣里,116,416,49.88009592,418,50.11990408,834,38,872,0,1143,76.29046369
苗栗縣,通霄鎮,通灣里,117,377,50.46854083,370,49.53145917,747,28,775,0,1049,73.87988561
苗栗縣,通霄鎮,新埔里,118,586,63.9040349,331,36.0959651,917,55,972,0,1254,77.51196172
苗栗縣,通霄鎮,內島里,119,273,51.02803738,262,48.97196262,535,34,569,0,765,74.37908497
苗栗縣,通霄鎮,白東里,120,239,49.17695473,247,50.82304527,486,32,518,0,665,77.89473684
苗栗縣,通霄鎮,白東里,121,226,45.10978044,275,54.89021956,501,21,522,0,705,74.04255319
苗栗縣,通霄鎮,白西里,122,316,54.57685665,263,45.42314335,579,30,609,0,794,76.70025189
苗栗縣,竹南鎮,竹南里,123,410,48.86769964,429,51.13230036,839,15,854,0,1043,81.87919463
苗栗縣,竹南鎮,竹南里,124,265,37.96561605,433,62.03438395,698,19,717,0,866,82.79445727
苗栗縣,竹南鎮,照南里,125,503,48.78758487,528,51.21241513,1031,31,1062,0,1289,82.38944919
苗栗縣,竹南鎮,照南里,126,441,52.25118483,403,47.74881517,844,23,867,1,1072,80.87686567
苗栗縣,竹南鎮,正南里,127,456,47.35202492,507,52.64797508,963,26,989,0,1223,80.86672118
苗栗縣,竹南鎮,正南里,128,379,45.28076464,458,54.71923536,837,15,852,0,1091,78.09349221
苗栗縣,竹南鎮,新南里,129,282,42.21556886,386,57.78443114,668,13,681,0,835,81.55688623
苗栗縣,竹南鎮,新南里,130,295,43.51032448,383,56.48967552,678,10,688,0,851,80.84606345
苗栗縣,竹南鎮,新南里,131,424,46.85082873,481,53.14917127,905,31,936,0,1141,82.03330412
苗栗縣,竹南鎮,大厝里,132,422,43.01732926,559,56.98267074,981,27,1008,0,1227,82.15158924
苗栗縣,竹南鎮,大厝里,133,401,46.03903559,470,53.96096441,871,24,895,0,1078,83.02411874
苗栗縣,竹南鎮,大厝里,134,344,46.99453552,388,53.00546448,732,18,750,0,882,85.03401361
苗栗縣,竹南鎮,營盤里,135,529,50.71907958,514,49.28092042,1043,27,1070,0,1314,81.43074581
苗栗縣,竹南鎮,營盤里,136,535,48.24165915,574,51.75834085,1109,26,1135,0,1370,82.84671533
苗栗縣,竹南鎮,聖福里,137,346,42.71604938,464,57.28395062,810,30,840,0,1023,82.11143695
苗栗縣,竹南鎮,聖福里,138,376,37.90322581,616,62.09677419,992,28,1020,0,1262,80.82408875
苗栗縣,竹南鎮,竹興里,139,274,41.07946027,393,58.92053973,667,11,678,0,898,75.50111359
苗栗縣,竹南鎮,竹興里,140,343,46.41407307,396,53.58592693,739,21,760,0,1000,76
苗栗縣,竹南鎮,竹興里,141,331,44.91180461,406,55.08819539,737,25,762,0,972,78.39506173
苗栗縣,竹南鎮,龍鳳里,142,302,40.86603518,437,59.13396482,739,17,756,0,910,83.07692308
苗栗縣,竹南鎮,龍鳳里,143,316,49.2211838,326,50.7788162,642,17,659,0,851,77.43830787
苗栗縣,竹南鎮,龍鳳里,144,461,41.16071429,659,58.83928571,1120,28,1148,0,1408,81.53409091
苗栗縣,竹南鎮,龍鳳里,145,466,44.93731919,571,55.06268081,1037,22,1059,0,1308,80.96330275
苗栗縣,竹南鎮,山佳里,146,476,43.11594203,628,56.88405797,1104,41,1145,1,1450,78.96551724
苗栗縣,竹南鎮,山佳里,147,506,41.64609053,709,58.35390947,1215,40,1255,0,1605,78.19314642
苗栗縣,竹南鎮,中港里,150,310,42.64099037,417,57.35900963,727,30,757,0,957,79.10135841
苗栗縣,竹南鎮,中華里,151,337,51.37195122,319,48.62804878,656,23,679,0,825,82.3030303
苗栗縣,竹南鎮,中華里,152,478,40.9948542,688,59.0051458,1166,31,1197,0,1451,82.49483115
苗栗縣,竹南鎮,中英里,153,414,43.80952381,531,56.19047619,945,38,983,0,1245,78.95582329
苗栗縣,竹南鎮,中美里,154,544,42.59984338,733,57.40015662,1277,33,1310,0,1652,79.29782082
苗栗縣,竹南鎮,開元里,155,219,49.65986395,222,50.34013605,441,5,446,0,545,81.83486239
苗栗縣,竹南鎮,海口里,156,483,52.78688525,432,47.21311475,915,34,949,0,1186,80.01686341
苗栗縣,竹南鎮,海口里,157,397,49.74937343,401,50.25062657,798,48,846,0,1080,78.33333333
苗栗縣,竹南鎮,港墘里,158,518,44.46351931,647,55.53648069,1165,44,1209,0,1439,84.01667825
苗栗縣,竹南鎮,公館里,159,312,35.6979405,562,64.3020595,874,9,883,0,1112,79.40647482
苗栗縣,竹南鎮,大埔里,160,299,45.78866769,354,54.21133231,653,22,675,0,817,82.61933905
苗栗縣,竹南鎮,大埔里,161,459,47.41735537,509,52.58264463,968,39,1007,0,1298,77.58089368
苗栗縣,竹南鎮,大埔里,162,407,51.38888889,385,48.61111111,792,35,827,0,1041,79.44284342
苗栗縣,竹南鎮,頂埔里,163,377,42.31200898,514,57.68799102,891,33,924,0,1130,81.7699115
苗栗縣,竹南鎮,頂埔里,164,346,42.19512195,474,57.80487805,820,10,830,0,1015,81.77339901
苗栗縣,竹南鎮,崎頂里,165,505,44.25942156,636,55.74057844,1141,47,1188,0,1517,78.3124588
苗栗縣,竹南鎮,崎頂里,166,473,52.9082774,421,47.0917226,894,46,940,0,1173,80.13640239
苗栗縣,竹南鎮,公義里,167,384,52.03252033,354,47.96747967,738,28,766,0,940,81.4893617
苗栗縣,竹南鎮,佳興里,148,389,45.60375147,464,54.39624853,853,27,880,0,1113,79.0655885
苗栗縣,竹南鎮,佳興里,149,361,44.24019608,455,55.75980392,816,23,839,0,1022,82.09393346
苗栗縣,頭份鎮,流東里,168,187,32.74956217,384,67.25043783,571,21,592,0,744,79.56989247
苗栗縣,頭份鎮,流東里,169,253,26.65964173,696,73.34035827,949,37,986,0,1336,73.80239521
苗栗縣,頭份鎮,珊湖里,170,197,27.78561354,512,72.21438646,709,26,735,0,924,79.54545455
苗栗縣,頭份鎮,珊湖里,171,237,33.85714286,463,66.14285714,700,23,723,0,872,82.91284404
苗栗縣,頭份鎮,斗煥里,172,281,35.88761175,502,64.11238825,783,19,802,0,1019,78.70461237
苗栗縣,頭份鎮,斗煥里,173,195,28.46715328,490,71.53284672,685,21,706,0,857,82.38039673
苗栗縣,頭份鎮,斗煥里,174,218,29.22252011,528,70.77747989,746,18,764,0,973,78.52004111
苗栗縣,頭份鎮,新華里,175,276,33.99014778,536,66.00985222,812,22,834,0,1021,81.68462292
苗栗縣,頭份鎮,新華里,176,268,29.38596491,644,70.61403509,912,24,936,0,1173,79.79539642
苗栗縣,頭份鎮,新華里,177,259,25.59288538,753,74.40711462,1012,36,1048,0,1291,81.17738187
苗栗縣,頭份鎮,興隆里,178,179,26.95783133,485,73.04216867,664,13,677,0,804,84.2039801
苗栗縣,頭份鎮,興隆里,179,290,37.90849673,475,62.09150327,765,30,795,0,1013,78.47976308
苗栗縣,頭份鎮,興隆里,180,251,29.42555686,602,70.57444314,853,28,881,0,1128,78.10283688
苗栗縣,頭份鎮,上埔里,181,302,26.49122807,838,73.50877193,1140,38,1178,0,1389,84.80921526
苗栗縣,頭份鎮,上埔里,182,233,28.55392157,583,71.44607843,816,22,838,0,1042,80.42226488
苗栗縣,頭份鎮,土牛里,183,241,39.7689769,365,60.2310231,606,21,627,0,803,78.08219178
苗栗縣,頭份鎮,頭份里,184,311,26.31133672,871,73.68866328,1182,27,1209,1,1520,79.53947368
苗栗縣,頭份鎮,頭份里,185,313,32.23480947,658,67.76519053,971,36,1007,0,1255,80.23904382
苗栗縣,頭份鎮,忠孝里,186,294,37.12121212,498,62.87878788,792,13,805,0,1007,79.94041708
苗栗縣,頭份鎮,忠孝里,187,227,24.25213675,709,75.74786325,936,13,949,0,1160,81.81034483
苗栗縣,頭份鎮,忠孝里,188,235,27.26218097,627,72.73781903,862,28,890,0,1072,83.02238806
苗栗縣,頭份鎮,忠孝里,189,242,26.30434783,678,73.69565217,920,12,932,0,1129,82.55093003
苗栗縣,頭份鎮,仁愛里,190,216,31.90546529,461,68.09453471,677,11,688,0,872,78.89908257
苗栗縣,頭份鎮,仁愛里,191,220,41.66666667,308,58.33333333,528,12,540,0,693,77.92207792
苗栗縣,頭份鎮,信義里,192,206,33.71522095,405,66.28477905,611,5,616,0,766,80.41775457
苗栗縣,頭份鎮,和平里,193,335,42.13836478,460,57.86163522,795,23,818,0,974,83.9835729
苗栗縣,頭份鎮,民族里,211,166,25.11346445,495,74.88653555,661,12,673,0,859,78.34691502
苗栗縣,頭份鎮,民族里,212,201,33.38870432,401,66.61129568,602,21,623,0,768,81.11979167
苗栗縣,頭份鎮,東庄里,209,248,29.7005988,587,70.2994012,835,24,859,0,1102,77.9491833
苗栗縣,頭份鎮,東庄里,210,307,31.9458897,654,68.0541103,961,27,988,0,1289,76.64856478
苗栗縣,頭份鎮,後庄里,199,328,32.5074331,681,67.4925669,1009,21,1030,0,1242,82.93075684
苗栗縣,頭份鎮,後庄里,200,324,32.59557344,670,67.40442656,994,24,1018,0,1275,79.84313725
苗栗縣,頭份鎮,後庄里,201,295,31.82308522,632,68.17691478,927,21,948,1,1148,82.57839721
苗栗縣,頭份鎮,後庄里,202,442,35.84752636,791,64.15247364,1233,34,1267,0,1550,81.74193548
苗栗縣,頭份鎮,山下里,197,296,26.71480144,812,73.28519856,1108,23,1131,0,1413,80.04246285
苗栗縣,頭份鎮,山下里,198,278,32.97746145,565,67.02253855,843,20,863,0,1059,81.49197356
苗栗縣,頭份鎮,蟠桃里,207,270,28.93890675,663,71.06109325,933,21,954,0,1164,81.95876289
苗栗縣,頭份鎮,蟠桃里,208,288,28.20763957,733,71.79236043,1021,27,1048,0,1349,77.68717569
苗栗縣,頭份鎮,田寮里,217,382,34.19874664,735,65.80125336,1117,32,1149,0,1433,80.18143754
苗栗縣,頭份鎮,田寮里,218,317,31.01761252,705,68.98238748,1022,21,1043,0,1315,79.31558935
苗栗縣,頭份鎮,蘆竹里,219,478,46.09450338,559,53.90549662,1037,46,1083,0,1322,81.92133132
苗栗縣,頭份鎮,上興里,194,316,31.98380567,672,68.01619433,988,16,1004,0,1272,78.93081761
苗栗縣,頭份鎮,下興里,195,290,36.11457036,513,63.88542964,803,33,836,0,1061,78.79359095
苗栗縣,頭份鎮,下興里,196,239,31.3648294,523,68.6351706,762,45,807,0,1036,77.8957529
苗栗縣,頭份鎮,尖山里,220,286,27.21217888,765,72.78782112,1051,37,1088,0,1322,82.29954614
苗栗縣,頭份鎮,尖下里,222,228,27.3381295,606,72.6618705,834,28,862,0,1095,78.72146119
苗栗縣,頭份鎮,尖下里,223,317,31.04799216,704,68.95200784,1021,52,1073,0,1373,78.15003642
苗栗縣,頭份鎮,廣興里,221,186,27.35294118,494,72.64705882,680,29,709,0,848,83.60849057
苗栗縣,頭份鎮,濫坑里,224,185,26.46638054,514,73.53361946,699,19,718,0,913,78.64184009
苗栗縣,頭份鎮,濫坑里,225,251,31.25778331,552,68.74221669,803,29,832,0,1033,80.54211036
苗栗縣,頭份鎮,民權里,213,219,34.76190476,411,65.23809524,630,17,647,0,800,80.875
苗栗縣,頭份鎮,民權里,214,225,34.40366972,429,65.59633028,654,20,674,0,865,77.91907514
苗栗縣,頭份鎮,民生里,215,194,29.04191617,474,70.95808383,668,34,702,0,907,77.39801544
苗栗縣,頭份鎮,民生里,216,272,35.09677419,503,64.90322581,775,20,795,0,1024,77.63671875
苗栗縣,頭份鎮,建國里,203,330,31.97674419,702,68.02325581,1032,26,1058,0,1290,82.01550388
苗栗縣,頭份鎮,建國里,204,363,30.76271186,817,69.23728814,1180,18,1198,0,1444,82.96398892
苗栗縣,頭份鎮,成功里,205,364,30.0330033,848,69.9669967,1212,20,1232,0,1540,80
苗栗縣,頭份鎮,成功里,206,279,27.76119403,726,72.23880597,1005,32,1037,0,1267,81.8468824
苗栗縣,後龍鎮,南龍里,226,231,46.7611336,263,53.2388664,494,25,519,0,644,80.59006211
苗栗縣,後龍鎮,南龍里,227,248,43.05555556,328,56.94444444,576,26,602,0,769,78.28348505
苗栗縣,後龍鎮,中龍里,228,372,47.20812183,416,52.79187817,788,8,796,0,949,83.87776607
苗栗縣,後龍鎮,北龍里,229,570,51.63043478,534,48.36956522,1104,27,1131,0,1416,79.87288136
苗栗縣,後龍鎮,大庄里,230,416,42.19066937,570,57.80933063,986,28,1014,0,1263,80.28503563
苗栗縣,後龍鎮,大庄里,231,392,43.12431243,517,56.87568757,909,37,946,0,1195,79.16317992
苗栗縣,後龍鎮,大庄里,232,346,45.34731324,417,54.65268676,763,19,782,0,970,80.6185567
苗栗縣,後龍鎮,溪洲里,233,356,46.29388817,413,53.70611183,769,41,810,0,1073,75.48928239
苗栗縣,後龍鎮,溪洲里,234,385,44.87179487,473,55.12820513,858,46,904,0,1152,78.47222222
苗栗縣,後龍鎮,豐富里,235,252,25.40322581,740,74.59677419,992,26,1018,0,1285,79.22178988
苗栗縣,後龍鎮,校椅里,236,397,42.68817204,533,57.31182796,930,29,959,0,1188,80.72390572
苗栗縣,後龍鎮,埔頂里,237,379,47.97468354,411,52.02531646,790,42,832,0,1090,76.33027523
苗栗縣,後龍鎮,埔頂里,238,411,43.95721925,524,56.04278075,935,43,978,0,1290,75.81395349
苗栗縣,後龍鎮,新民里,239,383,38.22355289,619,61.77644711,1002,41,1043,0,1318,79.13505311
苗栗縣,後龍鎮,復興里,240,246,48.1409002,265,51.8590998,511,6,517,0,649,79.66101695
苗栗縣,後龍鎮,東明里,241,512,50.54294176,501,49.45705824,1013,70,1083,0,1383,78.30802603
苗栗縣,後龍鎮,大山里,242,274,47.24137931,306,52.75862069,580,29,609,0,765,79.60784314
苗栗縣,後龍鎮,大山里,243,291,50.69686411,283,49.30313589,574,32,606,0,798,75.93984962
苗栗縣,後龍鎮,灣寶里,244,579,58.54398382,410,41.45601618,989,9,998,0,1314,75.95129376
苗栗縣,後龍鎮,海寶里,245,394,53.17139001,347,46.82860999,741,41,782,0,1017,76.89282203
苗栗縣,後龍鎮,外埔里,246,287,36.05527638,509,63.94472362,796,48,844,0,1150,73.39130435
苗栗縣,後龍鎮,海埔里,247,374,53.20056899,329,46.79943101,703,25,728,0,1017,71.58308751
苗栗縣,後龍鎮,秀水里,248,279,50,279,50,558,31,589,1,727,81.01788171
苗栗縣,後龍鎮,水尾里,249,374,46.11590629,437,53.88409371,811,47,858,0,1110,77.2972973
苗栗縣,後龍鎮,龍津里,250,231,45.65217391,275,54.34782609,506,22,528,0,665,79.39849624
苗栗縣,後龍鎮,龍坑里,251,496,50.97636177,477,49.02363823,973,44,1017,0,1296,78.47222222
苗栗縣,後龍鎮,福寧里,252,300,48.7012987,316,51.2987013,616,5,621,0,824,75.36407767
苗栗縣,後龍鎮,中和里,253,394,48.46248462,419,51.53751538,813,74,887,0,1220,72.70491803
苗栗縣,後龍鎮,南港里,254,536,59.09592062,371,40.90407938,907,72,979,0,1282,76.3650546
苗栗縣,卓蘭鎮,中街里,258,344,51.57421289,323,48.42578711,667,28,695,0,816,85.17156863
苗栗縣,卓蘭鎮,新厝里,259,331,49.77443609,334,50.22556391,665,15,680,0,834,81.53477218
苗栗縣,卓蘭鎮,新厝里,260,324,52.42718447,294,47.57281553,618,29,647,0,793,81.5889029
苗栗縣,卓蘭鎮,上新里,264,352,57.79967159,257,42.20032841,609,21,630,0,785,80.25477707
苗栗縣,卓蘭鎮,上新里,265,414,61.9760479,254,38.0239521,668,4,672,0,842,79.80997625
苗栗縣,卓蘭鎮,上新里,266,167,48.68804665,176,51.31195335,343,11,354,0,433,81.7551963
苗栗縣,卓蘭鎮,豐田里,261,426,54.40613027,357,45.59386973,783,46,829,0,1037,79.94214079
苗栗縣,卓蘭鎮,西坪里,262,228,54.54545455,190,45.45454545,418,19,437,0,558,78.31541219
苗栗縣,卓蘭鎮,景山里,272,230,45.63492063,274,54.36507937,504,33,537,1,705,76.17021277
苗栗縣,卓蘭鎮,老庄里,255,443,53.43787696,386,46.56212304,829,38,867,0,1059,81.86968839
苗栗縣,卓蘭鎮,老庄里,256,460,52.15419501,422,47.84580499,882,24,906,0,1096,82.66423358
苗栗縣,卓蘭鎮,新榮里,257,549,57.54716981,405,42.45283019,954,23,977,0,1170,83.5042735
苗栗縣,卓蘭鎮,內灣里,267,287,58.21501014,206,41.78498986,493,19,512,0,687,74.52692868
苗栗縣,卓蘭鎮,內灣里,268,342,60.63829787,222,39.36170213,564,24,588,0,754,77.98408488
苗栗縣,卓蘭鎮,內灣里,269,288,51.70556553,269,48.29443447,557,13,570,0,702,81.1965812
苗栗縣,卓蘭鎮,苗豐里,263,338,54.78119935,279,45.21880065,617,28,645,0,756,85.31746032
苗栗縣,卓蘭鎮,坪林里,270,308,45.29411765,372,54.70588235,680,27,707,0,960,73.64583333
苗栗縣,卓蘭鎮,坪林里,271,114,29.84293194,268,70.15706806,382,22,404,0,481,83.99168399
苗栗縣,大湖鄉,大湖村,273,177,28.13990461,452,71.86009539,629,15,644,0,804,80.09950249
苗栗縣,大湖鄉,大湖村,274,201,27.8779473,520,72.1220527,721,21,742,0,907,81.80815877
苗栗縣,大湖鄉,明湖村,275,129,23.11827957,429,76.88172043,558,18,576,1,694,82.99711816
苗栗縣,大湖鄉,靜湖村,277,168,27.63157895,440,72.36842105,608,25,633,0,859,73.6903376
苗栗縣,大湖鄉,靜湖村,278,217,32.48502994,451,67.51497006,668,16,684,0,850,80.47058824
苗栗縣,大湖鄉,富興村,279,312,32.09876543,660,67.90123457,972,46,1018,0,1369,74.36084733
苗栗縣,大湖鄉,大南村,280,115,26.55889145,318,73.44110855,433,30,463,0,643,72.00622084
苗栗縣,大湖鄉,大寮村,276,297,31.83279743,636,68.16720257,933,31,964,0,1269,75.96532703
苗栗縣,大湖鄉,南湖村,281,204,37.56906077,339,62.43093923,543,36,579,0,749,77.30307076
苗栗縣,大湖鄉,義和村,284,195,38.0859375,317,61.9140625,512,27,539,0,713,75.59607293
苗栗縣,大湖鄉,義和村,285,219,36.25827815,385,63.74172185,604,33,637,0,871,73.13432836
苗栗縣,大湖鄉,東興村,282,172,33.33333333,344,66.66666667,516,32,548,0,723,75.79529737
苗栗縣,大湖鄉,武榮村,283,124,31.95876289,264,68.04123711,388,2,390,0,518,75.28957529
苗栗縣,大湖鄉,栗林村,286,261,39.01345291,408,60.98654709,669,42,711,0,929,76.53390743
苗栗縣,大湖鄉,新開村,287,284,45.00792393,347,54.99207607,631,29,660,0,845,78.10650888
苗栗縣,公館鄉,館中村,288,274,41.14114114,392,58.85885886,666,15,681,0,812,83.86699507
苗栗縣,公館鄉,館中村,289,218,37.78162912,359,62.21837088,577,15,592,0,730,81.09589041
苗栗縣,公館鄉,館東村,290,296,36.3190184,519,63.6809816,815,30,845,0,1024,82.51953125
苗栗縣,公館鄉,館東村,291,374,42.84077892,499,57.15922108,873,35,908,0,1124,80.78291815
苗栗縣,公館鄉,館南村,292,364,34.66666667,686,65.33333333,1050,39,1089,0,1337,81.45100972
苗栗縣,公館鄉,館南村,293,420,36.74540682,723,63.25459318,1143,27,1170,0,1475,79.3220339
苗栗縣,公館鄉,大坑村,298,272,38.0952381,442,61.9047619,714,41,755,0,974,77.51540041
苗栗縣,公館鄉,中義村,294,275,35.9947644,489,64.0052356,764,29,793,0,1031,76.91561591
苗栗縣,公館鄉,中義村,295,340,48.29545455,364,51.70454545,704,30,734,0,951,77.18191377
苗栗縣,公館鄉,玉泉村,296,290,35.71428571,522,64.28571429,812,26,838,0,1067,78.53795689
苗栗縣,公館鄉,玉泉村,297,212,41.8972332,294,58.1027668,506,22,528,0,696,75.86206897
苗栗縣,公館鄉,石墻村,303,194,36.26168224,341,63.73831776,535,33,568,0,737,77.06919946
苗栗縣,公館鄉,石墻村,304,184,35.11450382,340,64.88549618,524,12,536,0,705,76.02836879
苗栗縣,公館鄉,福基村,299,262,30.8598351,587,69.1401649,849,3,852,0,1073,79.40354147
苗栗縣,公館鄉,福星村,301,244,43.49376114,317,56.50623886,561,19,580,0,733,79.12687585
苗栗縣,公館鄉,福星村,302,269,35.48812665,489,64.51187335,758,22,780,0,968,80.5785124
苗栗縣,公館鄉,開礦村,305,93,37.34939759,156,62.65060241,249,10,259,0,320,80.9375
苗栗縣,公館鄉,福德村,300,91,29.93421053,213,70.06578947,304,15,319,0,402,79.35323383
苗栗縣,公館鄉,五穀村,306,283,39.08839779,441,60.91160221,724,22,746,0,920,81.08695652
苗栗縣,公館鄉,五穀村,307,301,44.00584795,383,55.99415205,684,19,703,0,862,81.55452436
苗栗縣,公館鄉,玉穀村,308,339,38.52272727,541,61.47727273,880,14,894,0,1111,80.4680468
苗栗縣,公館鄉,鶴岡村,309,352,32.5323475,730,67.4676525,1082,31,1113,0,1371,81.18161926
苗栗縣,公館鄉,鶴山村,310,372,35.36121673,680,64.63878327,1052,38,1090,0,1370,79.5620438
苗栗縣,公館鄉,仁安村,312,348,39.18918919,540,60.81081081,888,40,928,0,1178,78.77758913
苗栗縣,公館鄉,尖山村,311,358,34.0952381,692,65.9047619,1050,39,1089,0,1394,78.1205165
苗栗縣,公館鄉,南河村,313,55,27.91878173,142,72.08121827,197,7,204,0,264,77.27272727
苗栗縣,公館鄉,北河村,314,82,32.53968254,170,67.46031746,252,14,266,0,315,84.44444444
苗栗縣,銅鑼鄉,福興村,321,172,20.72289157,658,79.27710843,830,25,855,0,1065,80.28169014
苗栗縣,銅鑼鄉,銅鑼村,315,210,29.49438202,502,70.50561798,712,15,727,0,871,83.46727899
苗栗縣,銅鑼鄉,銅鑼村,316,272,32.53588517,564,67.46411483,836,23,859,0,1033,83.15585673
苗栗縣,銅鑼鄉,銅鑼村,317,295,29.9188641,691,70.0811359,986,31,1017,0,1278,79.57746479
苗栗縣,銅鑼鄉,銅鑼村,318,239,31.78191489,513,68.21808511,752,31,783,0,1009,77.60158573
苗栗縣,銅鑼鄉,朝陽村,322,201,27.68595041,525,72.31404959,726,25,751,0,928,80.92672414
苗栗縣,銅鑼鄉,朝陽村,323,206,33.06581059,417,66.93418941,623,23,646,1,803,80.4483188
苗栗縣,銅鑼鄉,樟樹村,319,366,38.77118644,578,61.22881356,944,48,992,0,1263,78.54315123
苗栗縣,銅鑼鄉,九湖村,320,298,30.53278689,678,69.46721311,976,35,1011,0,1278,79.10798122
苗栗縣,銅鑼鄉,竹森村,324,222,27.47524752,586,72.52475248,808,41,849,0,1089,77.96143251
苗栗縣,銅鑼鄉,中平村,325,381,46.63402693,436,53.36597307,817,31,848,0,1045,81.14832536
苗栗縣,銅鑼鄉,中平村,326,262,42.39482201,356,57.60517799,618,37,655,0,823,79.58687728
苗栗縣,銅鑼鄉,中平村,327,269,37.62237762,446,62.37762238,715,18,733,0,968,75.7231405
苗栗縣,銅鑼鄉,興隆村,328,178,36.32653061,312,63.67346939,490,4,494,0,622,79.42122186
苗栗縣,銅鑼鄉,盛隆村,329,145,40.5027933,213,59.4972067,358,22,380,0,500,76
苗栗縣,銅鑼鄉,新隆村,330,151,37.75,249,62.25,400,30,430,0,562,76.51245552
苗栗縣,南庄鄉,東  村,331,108,27.69230769,282,72.30769231,390,10,400,0,501,79.84031936
苗栗縣,南庄鄉,東  村,332,179,31.85053381,383,68.14946619,562,20,582,0,763,76.27785059
苗栗縣,南庄鄉,西  村,333,146,27.91586998,377,72.08413002,523,29,552,0,709,77.8561354
苗栗縣,南庄鄉,南江村,334,122,21.86379928,436,78.13620072,558,7,565,0,768,73.56770833
苗栗縣,南庄鄉,南江村,335,124,29.45368171,297,70.54631829,421,31,452,0,634,71.29337539
苗栗縣,南庄鄉,田美村,336,226,34.08748115,437,65.91251885,663,25,688,0,878,78.35990888
苗栗縣,南庄鄉,獅山村,337,241,32.52361673,500,67.47638327,741,32,773,0,990,78.08080808
苗栗縣,南庄鄉,南富村,338,239,29.32515337,576,70.67484663,815,40,855,0,1069,79.98129093
苗栗縣,南庄鄉,員林村,339,316,40.10152284,472,59.89847716,788,39,827,0,1043,79.29050815
苗栗縣,南庄鄉,蓬萊村,340,125,20.22653722,493,79.77346278,618,31,649,0,893,72.67637178
苗栗縣,南庄鄉,東河村,341,62,9.553158706,587,90.44684129,649,19,668,0,958,69.72860125
苗栗縣,頭屋鄉,頭屋村,342,274,25.97156398,781,74.02843602,1055,34,1089,0,1328,82.00301205
苗栗縣,頭屋鄉,頭屋村,343,257,28.49223947,645,71.50776053,902,18,920,0,1116,82.43727599
苗栗縣,頭屋鄉,象山村,349,232,34.83483483,434,65.16516517,666,7,673,0,877,76.73888255
苗栗縣,頭屋鄉,象山村,350,256,32.98969072,520,67.01030928,776,7,783,0,971,80.63851699
苗栗縣,頭屋鄉,北坑村,346,144,28.45849802,362,71.54150198,506,32,538,0,673,79.94056464
苗栗縣,頭屋鄉,獅潭村,344,170,29.41176471,408,70.58823529,578,19,597,0,796,75
苗栗縣,頭屋鄉,獅潭村,345,210,32.71028037,432,67.28971963,642,16,658,0,800,82.25
苗栗縣,頭屋鄉,曲洞村,347,276,37.91208791,452,62.08791209,728,23,751,0,888,84.57207207
苗栗縣,頭屋鄉,飛鳳村,348,113,39.92932862,170,60.07067138,283,11,294,0,358,82.12290503
苗栗縣,頭屋鄉,明德村,351,213,30.78034682,479,69.21965318,692,27,719,0,913,78.75136911
苗栗縣,頭屋鄉,明德村,352,51,32.27848101,107,67.72151899,158,8,166,0,201,82.58706468
苗栗縣,頭屋鄉,鳴鳳村,353,99,36.94029851,169,63.05970149,268,10,278,0,352,78.97727273
苗栗縣,三義鄉,廣盛村,354,198,25.25510204,586,74.74489796,784,32,816,0,990,82.42424242
苗栗縣,三義鄉,廣盛村,355,304,39.07455013,474,60.92544987,778,20,798,0,959,83.21167883
苗栗縣,三義鄉,廣盛村,356,247,31.03015075,549,68.96984925,796,34,830,0,1048,79.19847328
苗栗縣,三義鄉,廣盛村,357,232,28.78411911,574,71.21588089,806,22,828,0,996,83.13253012
苗栗縣,三義鄉,雙湖村,361,241,33.56545961,477,66.43454039,718,19,737,0,937,78.65528282
苗栗縣,三義鄉,雙湖村,362,199,32.30519481,417,67.69480519,616,16,632,0,754,83.81962865
苗栗縣,三義鄉,雙潭村,363,190,34.29602888,364,65.70397112,554,16,570,0,693,82.25108225
苗栗縣,三義鄉,雙潭村,364,179,33.58348968,354,66.41651032,533,19,552,0,690,80
苗栗縣,三義鄉,勝興村,358,223,29.26509186,539,70.73490814,762,31,793,0,964,82.26141079
苗栗縣,三義鄉,勝興村,359,292,37.00887199,497,62.99112801,789,26,815,0,1055,77.25118483
苗栗縣,三義鄉,勝興村,360,283,37.93565684,463,62.06434316,746,25,771,0,990,77.87878788
苗栗縣,三義鄉,西湖村,365,97,21.04121475,364,78.95878525,461,22,483,0,567,85.18518519
苗栗縣,三義鄉,西湖村,366,214,35.13957307,395,64.86042693,609,23,632,0,777,81.33848134
苗栗縣,三義鄉,龍騰村,367,89,27.98742138,229,72.01257862,318,15,333,0,399,83.45864662
苗栗縣,三義鄉,鯉魚潭村,368,350,58.62646566,247,41.37353434,597,30,627,1,739,84.8443843
苗栗縣,三義鄉,鯉魚潭村,369,194,53.88888889,166,46.11111111,360,14,374,0,434,86.17511521
苗栗縣,西湖鄉,高埔村,370,124,26.43923241,345,73.56076759,469,7,476,0,607,78.4184514
苗栗縣,西湖鄉,下埔村,371,112,25.57077626,326,74.42922374,438,23,461,0,561,82.17468806
苗栗縣,西湖鄉,五湖村,372,169,24.63556851,517,75.36443149,686,28,714,0,895,79.77653631
苗栗縣,西湖鄉,四湖村,373,100,20.36659878,391,79.63340122,491,21,512,0,652,78.52760736
苗栗縣,西湖鄉,金獅村,376,124,29.95169082,290,70.04830918,414,3,417,0,524,79.58015267
苗栗縣,西湖鄉,龍洞村,375,120,32.17158177,253,67.82841823,373,25,398,0,517,76.98259188
苗栗縣,西湖鄉,三湖村,374,233,33.42898135,464,66.57101865,697,22,719,0,956,75.20920502
苗栗縣,西湖鄉,湖東村,377,281,33.09776207,568,66.90223793,849,41,890,0,1139,78.13871817
苗栗縣,西湖鄉,二湖村,378,172,35.83333333,308,64.16666667,480,29,509,0,694,73.34293948
苗栗縣,造橋鄉,造橋村,379,343,25.07309942,1025,74.92690058,1368,45,1413,0,1759,80.3297328
苗栗縣,造橋鄉,平興村,380,95,25.88555858,272,74.11444142,367,20,387,0,487,79.4661191
苗栗縣,造橋鄉,豐湖村,381,239,31.99464525,508,68.00535475,747,27,774,0,982,78.81873727
苗栗縣,造橋鄉,大西村,382,416,31.70731707,896,68.29268293,1312,45,1357,0,1673,81.11177525
苗栗縣,造橋鄉,大西村,383,290,26.70349908,796,73.29650092,1086,42,1128,2,1404,80.34188034
苗栗縣,造橋鄉,錦水村,384,139,32.3255814,291,67.6744186,430,9,439,0,537,81.75046555
苗栗縣,造橋鄉,大龍村,385,112,28,288,72,400,5,405,0,505,80.1980198
苗栗縣,造橋鄉,朝陽村,386,471,44.26691729,593,55.73308271,1064,55,1119,0,1387,80.6777217
苗栗縣,造橋鄉,談文村,387,240,43.24324324,315,56.75675676,555,39,594,0,720,82.5
苗栗縣,造橋鄉,龍昇村,388,348,48,377,52,725,55,780,0,1017,76.69616519
苗栗縣,三灣鄉,三灣村,389,275,32.42924528,573,67.57075472,848,26,874,0,1031,84.77206596
苗栗縣,三灣鄉,三灣村,390,308,36.40661939,538,63.59338061,846,36,882,0,1121,78.67975022
苗栗縣,三灣鄉,內灣村,391,134,29.004329,328,70.995671,462,24,486,0,576,84.375
苗栗縣,三灣鄉,銅鏡村,392,230,35.71428571,414,64.28571429,644,24,668,0,842,79.33491686
苗栗縣,三灣鄉,頂寮村,393,48,26.96629213,130,73.03370787,178,9,187,0,231,80.95238095
苗栗縣,三灣鄉,北埔村,394,161,39.65517241,245,60.34482759,406,20,426,0,522,81.6091954
苗栗縣,三灣鄉,大河村,395,169,35.13513514,312,64.86486486,481,29,510,0,620,82.25806452
苗栗縣,三灣鄉,大坪村,396,144,42.47787611,195,57.52212389,339,27,366,0,467,78.37259101
苗栗縣,三灣鄉,永和村,397,89,32.48175182,185,67.51824818,274,17,291,0,366,79.50819672
苗栗縣,獅潭鄉,百壽村,398,45,16.48351648,228,83.51648352,273,18,291,0,389,74.80719794
苗栗縣,獅潭鄉,永興村,399,167,37.36017897,280,62.63982103,447,33,480,0,634,75.70977918
苗栗縣,獅潭鄉,新店村,400,225,32.05128205,477,67.94871795,702,49,751,0,945,79.47089947
苗栗縣,獅潭鄉,和興村,401,152,32.68817204,313,67.31182796,465,23,488,0,616,79.22077922
苗栗縣,獅潭鄉,豐林村,402,127,27.60869565,333,72.39130435,460,28,488,0,644,75.77639752
苗栗縣,獅潭鄉,新豐村,403,89,35.03937008,165,64.96062992,254,14,268,0,368,72.82608696
苗栗縣,獅潭鄉,竹木村,404,170,30.03533569,396,69.96466431,566,28,594,0,761,78.05519054
苗栗縣,泰安鄉,八卦村,405,30,16.04278075,157,83.95721925,187,10,197,0,270,72.96296296
苗栗縣,泰安鄉,錦水村,406,98,14.51851852,577,85.48148148,675,24,699,0,930,75.16129032
苗栗縣,泰安鄉,清安村,407,55,27.09359606,148,72.90640394,203,7,210,0,288,72.91666667
苗栗縣,泰安鄉,清安村,408,84,20.79207921,320,79.20792079,404,18,422,0,541,78.00369686
苗栗縣,泰安鄉,大興村,409,29,8.923076923,296,91.07692308,325,8,333,0,421,79.09738717
苗栗縣,泰安鄉,中興村,410,70,21.94357367,249,78.05642633,319,13,332,0,411,80.77858881
苗栗縣,泰安鄉,梅園村,411,38,13.42756184,245,86.57243816,283,6,289,0,372,77.68817204
苗栗縣,泰安鄉,象鼻村,412,113,24.30107527,352,75.69892473,465,8,473,0,569,83.12829525
苗栗縣,泰安鄉,士林村,413,9,2.23325062,394,97.76674938,403,2,405,0,465,87.09677419
臺中縣,豐原市,豐原里,1,343,50.0729927,342,49.9270073,685,24,709,0,896,79.12946429
臺中縣,豐原市,豐原里,2,355,41.08796296,509,58.91203704,864,20,884,0,1029,85.90864917
臺中縣,豐原市,頂街里,4,445,60.875513,286,39.124487,731,12,743,0,904,82.19026549
臺中縣,豐原市,中山里,5,441,58.1027668,318,41.8972332,759,11,770,0,924,83.33333333
臺中縣,豐原市,豐榮里,3,495,60.43956044,324,39.56043956,819,9,828,0,1028,80.54474708
臺中縣,豐原市,下街里,6,366,54.87256372,301,45.12743628,667,14,681,0,824,82.64563107
臺中縣,豐原市,富春里,26,392,54.59610028,326,45.40389972,718,9,727,0,833,87.27490996
臺中縣,豐原市,葫蘆里,27,331,49.62518741,336,50.37481259,667,15,682,0,810,84.19753086
臺中縣,豐原市,豐西里,22,694,49.64234621,704,50.35765379,1398,31,1429,0,1746,81.84421535
臺中縣,豐原市,西安里,28,662,53.95273024,565,46.04726976,1227,23,1250,0,1488,84.00537634
臺中縣,豐原市,西安里,29,754,54.63768116,626,45.36231884,1380,19,1399,1,1699,82.34255444
臺中縣,豐原市,西安里,30,713,53.20895522,627,46.79104478,1340,28,1368,0,1613,84.81091135
臺中縣,豐原市,西勢里,31,486,51.81236674,452,48.18763326,938,11,949,0,1279,74.19859265
臺中縣,豐原市,西勢里,32,408,49.2159228,421,50.7840772,829,16,845,0,990,85.35353535
臺中縣,豐原市,東勢里,43,681,59.0633131,472,40.9366869,1153,23,1176,0,1403,83.82038489
臺中縣,豐原市,民生里,44,508,59.34579439,348,40.65420561,856,13,869,0,1044,83.23754789
臺中縣,豐原市,大湳里,10,548,60.15367728,363,39.84632272,911,26,937,0,1115,84.03587444
臺中縣,豐原市,大湳里,11,532,55.12953368,433,44.87046632,965,11,976,0,1142,85.46409807
臺中縣,豐原市,北湳里,12,538,49.81481481,542,50.18518519,1080,4,1084,0,1326,81.74962293
臺中縣,豐原市,北湳里,13,501,52.79241307,448,47.20758693,949,35,984,1,1189,82.75862069
臺中縣,豐原市,東湳里,14,698,66.47619048,352,33.52380952,1050,34,1084,0,1267,85.55643252
臺中縣,豐原市,東湳里,15,662,61.81139122,409,38.18860878,1071,14,1085,0,1349,80.42994811
臺中縣,豐原市,東湳里,16,565,61.54684096,353,38.45315904,918,31,949,0,1119,84.80786416
臺中縣,豐原市,西湳里,17,679,59.82378855,456,40.17621145,1135,23,1158,0,1404,82.47863248
臺中縣,豐原市,西湳里,18,708,61.51172893,443,38.48827107,1151,26,1177,0,1430,82.30769231
臺中縣,豐原市,西湳里,19,606,61.58536585,378,38.41463415,984,19,1003,0,1201,83.51373855
臺中縣,豐原市,西湳里,20,601,62.34439834,363,37.65560166,964,23,987,0,1187,83.15080034
臺中縣,豐原市,西湳里,21,692,58.34738617,494,41.65261383,1186,21,1207,0,1431,84.34661076
臺中縣,豐原市,圳寮里,23,547,58.44017094,389,41.55982906,936,25,961,0,1140,84.29824561
臺中縣,豐原市,豐圳里,24,484,46.89922481,548,53.10077519,1032,20,1052,0,1256,83.75796178
臺中縣,豐原市,豐圳里,25,611,52.08866155,562,47.91133845,1173,26,1199,0,1483,80.84962913
臺中縣,豐原市,社皮里,35,688,57.96124684,499,42.03875316,1187,39,1226,0,1494,82.06157965
臺中縣,豐原市,社皮里,36,494,42.73356401,662,57.26643599,1156,39,1195,0,1452,82.30027548
臺中縣,豐原市,社皮里,37,656,53.68248773,566,46.31751227,1222,16,1238,0,1511,81.93249504
臺中縣,豐原市,社皮里,38,552,49.81949458,556,50.18050542,1108,9,1117,0,1403,79.61511048
臺中縣,豐原市,社皮里,39,780,53.35157319,682,46.64842681,1462,24,1486,0,1792,82.92410714
臺中縣,豐原市,三村里,40,693,53.38983051,605,46.61016949,1298,41,1339,0,1630,82.14723926
臺中縣,豐原市,三村里,41,656,55.59322034,524,44.40677966,1180,31,1211,0,1488,81.3844086
臺中縣,豐原市,三村里,42,900,61.4334471,565,38.5665529,1465,24,1489,0,1802,82.63041065
臺中縣,豐原市,中興里,33,500,51.17707267,477,48.82292733,977,17,994,0,1240,80.16129032
臺中縣,豐原市,中興里,34,508,42.36864053,691,57.63135947,1199,29,1228,0,1510,81.32450331
臺中縣,豐原市,田心里,45,774,51.80722892,720,48.19277108,1494,25,1519,0,1831,82.96013108
臺中縣,豐原市,田心里,46,596,50.94017094,574,49.05982906,1170,19,1189,0,1450,82
臺中縣,豐原市,田心里,47,677,59.59507042,459,40.40492958,1136,29,1165,0,1403,83.03635068
臺中縣,豐原市,豐田里,48,779,53.57634113,675,46.42365887,1454,21,1475,0,1787,82.54057079
臺中縣,豐原市,豐田里,49,836,61.24542125,529,38.75457875,1365,42,1407,1,1737,81.00172712
臺中縣,豐原市,豐田里,50,866,62.7991298,513,37.2008702,1379,50,1429,0,1737,82.26827864
臺中縣,豐原市,豐田里,51,791,56.54038599,608,43.45961401,1399,46,1445,0,1730,83.52601156
臺中縣,豐原市,豐田里,52,809,56.6130161,620,43.3869839,1429,42,1471,0,1800,81.72222222
臺中縣,豐原市,鎌村里,53,509,55.50708833,408,44.49291167,917,27,944,0,1140,82.80701754
臺中縣,豐原市,鎌村里,54,488,53.15904139,430,46.84095861,918,26,944,0,1143,82.58967629
臺中縣,豐原市,鎌村里,55,515,51.86304129,478,48.13695871,993,31,1024,0,1242,82.44766506
臺中縣,豐原市,南陽里,58,662,54.62046205,550,45.37953795,1212,25,1237,0,1517,81.54251813
臺中縣,豐原市,南陽里,59,758,53.75886525,652,46.24113475,1410,32,1442,0,1778,81.1023622
臺中縣,豐原市,南陽里,60,530,47.53363229,585,52.46636771,1115,20,1135,0,1357,83.6403832
臺中縣,豐原市,南陽里,61,691,56.73234811,527,43.26765189,1218,19,1237,0,1456,84.95879121
臺中縣,豐原市,南陽里,62,542,49.86200552,545,50.13799448,1087,23,1110,0,1382,80.31837916
臺中縣,豐原市,陽明里,56,503,51.37895812,476,48.62104188,979,19,998,0,1223,81.60261652
臺中縣,豐原市,陽明里,57,498,50.05025126,497,49.94974874,995,15,1010,0,1230,82.11382114
臺中縣,豐原市,北陽里,63,662,53.17269076,583,46.82730924,1245,13,1258,0,1541,81.63530175
臺中縣,豐原市,北陽里,64,785,57.50915751,580,42.49084249,1365,31,1396,0,1660,84.09638554
臺中縣,豐原市,北陽里,65,809,50.2484472,801,49.7515528,1610,22,1632,0,1962,83.18042813
臺中縣,豐原市,北陽里,66,687,53.00925926,609,46.99074074,1296,23,1319,0,1553,84.93238892
臺中縣,豐原市,北陽里,67,677,54.99593826,554,45.00406174,1231,25,1256,0,1518,82.74044796
臺中縣,豐原市,北陽里,68,743,54.83394834,612,45.16605166,1355,26,1381,0,1645,83.95136778
臺中縣,豐原市,中陽里,7,680,56.80868839,517,43.19131161,1197,17,1214,0,1484,81.80592992
臺中縣,豐原市,中陽里,8,606,54.7920434,500,45.2079566,1106,26,1132,0,1347,84.03860431
臺中縣,豐原市,中陽里,9,771,55.30846485,623,44.69153515,1394,31,1425,1,1716,83.04195804
臺中縣,豐原市,東陽里,69,827,65.37549407,438,34.62450593,1265,36,1301,0,1509,86.21603711
臺中縣,豐原市,南村里,70,628,64.27840328,349,35.72159672,977,27,1004,0,1204,83.38870432
臺中縣,豐原市,南村里,71,616,59.4021215,421,40.5978785,1037,26,1063,0,1296,82.02160494
臺中縣,豐原市,南村里,72,611,50.66334992,595,49.33665008,1206,15,1221,0,1495,81.6722408
臺中縣,豐原市,南田里,73,734,57.29898517,547,42.70101483,1281,27,1308,0,1585,82.52365931
臺中縣,豐原市,南田里,74,691,60.29668412,455,39.70331588,1146,36,1182,0,1396,84.67048711
臺中縣,豐原市,南嵩里,75,813,65.56451613,427,34.43548387,1240,26,1266,0,1523,83.12541037
臺中縣,豐原市,南嵩里,76,608,59.14396887,420,40.85603113,1028,42,1070,0,1314,81.43074581
臺中縣,豐原市,翁明里,77,769,54.34628975,646,45.65371025,1415,34,1449,0,1727,83.90272148
臺中縣,豐原市,翁子里,78,645,64.69408225,352,35.30591775,997,28,1025,0,1220,84.01639344
臺中縣,豐原市,翁子里,79,531,55.1975052,431,44.8024948,962,30,992,0,1168,84.93150685
臺中縣,豐原市,翁社里,80,395,63.30128205,229,36.69871795,624,20,644,0,756,85.18518519
臺中縣,豐原市,翁社里,81,517,58.08988764,373,41.91011236,890,21,911,0,1078,84.50834879
臺中縣,豐原市,朴子里,82,535,66.29491945,272,33.70508055,807,18,825,0,1002,82.33532934
臺中縣,豐原市,朴子里,83,540,65.53398058,284,34.46601942,824,16,840,0,1012,83.00395257
臺中縣,豐原市,朴子里,84,489,63.92156863,276,36.07843137,765,22,787,0,933,84.35155413
臺中縣,大里市,大里里,85,692,54.44531865,579,45.55468135,1271,30,1301,0,1564,83.18414322
臺中縣,大里市,大里里,86,612,55.58583106,489,44.41416894,1101,43,1144,0,1395,82.00716846
臺中縣,大里市,新里里,87,687,57.73109244,503,42.26890756,1190,23,1213,0,1487,81.5736382
臺中縣,大里市,新里里,88,797,54.25459496,672,45.74540504,1469,31,1500,0,2094,71.63323782
臺中縣,大里市,新里里,89,649,48.2527881,696,51.7472119,1345,14,1359,0,1602,84.83146067
臺中縣,大里市,新里里,90,616,52.38095238,560,47.61904762,1176,17,1193,0,1458,81.82441701
臺中縣,大里市,樹王里,93,705,61.4646905,442,38.5353095,1147,26,1173,0,1408,83.30965909
臺中縣,大里市,樹王里,94,729,63.50174216,419,36.49825784,1148,18,1166,0,1410,82.69503546
臺中縣,大里市,東興里,133,594,50.55319149,581,49.44680851,1175,26,1201,0,1459,82.31665524
臺中縣,大里市,東興里,134,511,48.89952153,534,51.10047847,1045,24,1069,0,1292,82.73993808
臺中縣,大里市,東興里,135,741,53.34773218,648,46.65226782,1389,20,1409,0,1663,84.72639808
臺中縣,大里市,東興里,136,574,53.54477612,498,46.45522388,1072,12,1084,0,1311,82.6849733
臺中縣,大里市,祥興里,95,389,52.14477212,357,47.85522788,746,15,761,0,964,78.94190871
臺中縣,大里市,祥興里,96,501,56.29213483,389,43.70786517,890,22,912,0,1154,79.02946274
臺中縣,大里市,祥興里,97,541,53.88446215,463,46.11553785,1004,14,1018,0,1266,80.4107425
臺中縣,大里市,祥興里,98,489,50.46439628,480,49.53560372,969,17,986,0,1227,80.35859821
臺中縣,大里市,祥興里,99,411,54.15019763,348,45.84980237,759,14,773,0,930,83.11827957
臺中縣,大里市,日新里,142,690,48.55735398,731,51.44264602,1421,27,1448,0,1762,82.17934166
臺中縣,大里市,日新里,143,667,54.94233937,547,45.05766063,1214,31,1245,0,1504,82.77925532
臺中縣,大里市,西榮里,144,670,52.01863354,618,47.98136646,1288,34,1322,0,1694,78.04014168
臺中縣,大里市,西榮里,145,537,44.16118421,679,55.83881579,1216,6,1222,0,1467,83.29925017
臺中縣,大里市,西榮里,146,651,54.75189235,538,45.24810765,1189,30,1219,0,1492,81.70241287
臺中縣,大里市,內新里,100,559,43.70602033,720,56.29397967,1279,27,1306,0,1640,79.63414634
臺中縣,大里市,內新里,101,425,52.08333333,391,47.91666667,816,23,839,0,1043,80.44103547
臺中縣,大里市,內新里,102,476,43.11594203,628,56.88405797,1104,25,1129,0,1399,80.70050036
臺中縣,大里市,內新里,103,437,42.84313725,583,57.15686275,1020,19,1039,0,1298,80.04622496
臺中縣,大里市,東昇里,107,565,61.47986942,354,38.52013058,919,35,954,0,1179,80.91603053
臺中縣,大里市,東昇里,108,578,48.16666667,622,51.83333333,1200,17,1217,0,1455,83.64261168
臺中縣,大里市,立仁里,156,529,57.56256801,390,42.43743199,919,16,935,0,1133,82.52427184
臺中縣,大里市,立仁里,157,510,50.84745763,493,49.15254237,1003,21,1024,0,1276,80.2507837
臺中縣,大里市,立仁里,158,621,56.19909502,484,43.80090498,1105,32,1137,0,1450,78.4137931
臺中縣,大里市,新仁里,162,623,52.57383966,562,47.42616034,1185,19,1204,0,1454,82.80605227
臺中縣,大里市,新仁里,163,701,52.86576169,625,47.13423831,1326,30,1356,0,1712,79.20560748
臺中縣,大里市,新仁里,164,722,56.40625,558,43.59375,1280,23,1303,0,1551,84.01031593
臺中縣,大里市,新仁里,165,597,52.23097113,546,47.76902887,1143,17,1160,0,1427,81.28941836
臺中縣,大里市,大元里,109,386,54.44287729,323,45.55712271,709,16,725,0,839,86.41239571
臺中縣,大里市,大元里,110,749,63.153457,437,36.846543,1186,14,1200,0,1429,83.97480756
臺中縣,大里市,大元里,111,464,51.32743363,440,48.67256637,904,19,923,0,1106,83.45388788
臺中縣,大里市,夏田里,114,475,62.5,285,37.5,760,21,781,0,929,84.06889128
臺中縣,大里市,仁化里,115,766,55.26695527,620,44.73304473,1386,19,1405,0,1750,80.28571429
臺中縣,大里市,仁化里,116,909,59.29549902,624,40.70450098,1533,18,1551,2,1908,81.28930818
臺中縣,大里市,仁化里,117,805,55.74792244,639,44.25207756,1444,15,1459,0,1827,79.8576902
臺中縣,大里市,健民里,121,626,54.10544512,531,45.89455488,1157,27,1184,0,1490,79.46308725
臺中縣,大里市,健民里,122,412,35.88850174,736,64.11149826,1148,23,1171,0,1466,79.87721692
臺中縣,大里市,健民里,123,501,48.54651163,531,51.45348837,1032,28,1060,0,1350,78.51851852
臺中縣,大里市,塗城里,124,709,51.97947214,655,48.02052786,1364,29,1393,0,1762,79.05788876
臺中縣,大里市,塗城里,125,714,57.72029103,523,42.27970897,1237,19,1256,0,1529,82.14519294
臺中縣,大里市,塗城里,126,725,55.51301685,581,44.48698315,1306,22,1328,0,1675,79.28358209
臺中縣,大里市,塗城里,127,737,55.28882221,596,44.71117779,1333,44,1377,0,1723,79.91874637
臺中縣,大里市,瑞城里,166,682,53.82794002,585,46.17205998,1267,27,1294,0,1630,79.38650307
臺中縣,大里市,瑞城里,167,587,52.0851819,540,47.9148181,1127,24,1151,0,1392,82.68678161
臺中縣,大里市,瑞城里,168,628,51.64473684,588,48.35526316,1216,16,1232,0,1499,82.18812542
臺中縣,大里市,瑞城里,169,542,50,542,50,1084,16,1100,0,1371,80.23340627
臺中縣,大里市,瑞城里,170,624,51.91347754,578,48.08652246,1202,7,1209,0,1515,79.8019802
臺中縣,大里市,瑞城里,171,618,53.00171527,548,46.99828473,1166,7,1173,0,1450,80.89655172
臺中縣,大里市,金城里,151,645,48.56927711,683,51.43072289,1328,20,1348,0,1677,80.38163387
臺中縣,大里市,金城里,152,545,49.50045413,556,50.49954587,1101,12,1113,0,1453,76.60013765
臺中縣,大里市,金城里,153,679,51.01427498,652,48.98572502,1331,20,1351,0,1640,82.37804878
臺中縣,大里市,金城里,154,611,49.31396287,628,50.68603713,1239,19,1258,0,1602,78.52684145
臺中縣,大里市,金城里,155,632,52.14521452,580,47.85478548,1212,22,1234,0,1550,79.61290323
臺中縣,大里市,東湖里,128,585,52.27882038,534,47.72117962,1119,23,1142,0,1469,77.73995916
臺中縣,大里市,東湖里,129,536,50.04668534,535,49.95331466,1071,21,1092,0,1361,80.23512123
臺中縣,大里市,東湖里,130,476,48.47250509,506,51.52749491,982,15,997,0,1234,80.79416532
臺中縣,大里市,東湖里,131,401,48.72417983,422,51.27582017,823,21,844,0,1052,80.22813688
臺中縣,大里市,東湖里,132,505,53.72340426,435,46.27659574,940,25,965,0,1218,79.22824302
臺中縣,大里市,西湖里,112,522,58.06451613,377,41.93548387,899,22,921,0,1088,84.65073529
臺中縣,大里市,西湖里,113,502,56.85164213,381,43.14835787,883,13,896,0,1069,83.81665108
臺中縣,大里市,國光里,91,731,46.9492614,826,53.0507386,1557,25,1582,0,1906,83.00104932
臺中縣,大里市,國光里,92,773,52.72851296,693,47.27148704,1466,22,1488,0,1821,81.71334432
臺中縣,大里市,大明里,137,481,52.74122807,431,47.25877193,912,18,930,0,1117,83.25872874
臺中縣,大里市,大明里,138,459,57.80856423,335,42.19143577,794,12,806,0,984,81.91056911
臺中縣,大里市,大明里,139,485,51.54091392,456,48.45908608,941,25,966,0,1203,80.29925187
臺中縣,大里市,永隆里,140,859,48.83456509,900,51.16543491,1759,16,1775,0,2118,83.80547686
臺中縣,大里市,永隆里,141,782,45.86510264,923,54.13489736,1705,15,1720,0,1990,86.4321608
臺中縣,大里市,長榮里,147,561,49.86666667,564,50.13333333,1125,20,1145,0,1423,80.46380885
臺中縣,大里市,長榮里,148,553,47.10391823,621,52.89608177,1174,17,1191,0,1476,80.69105691
臺中縣,大里市,長榮里,149,616,46.63133989,705,53.36866011,1321,15,1336,0,1608,83.08457711
臺中縣,大里市,長榮里,150,501,46.04779412,587,53.95220588,1088,19,1107,0,1324,83.6102719
臺中縣,大里市,中新里,104,413,48.93364929,431,51.06635071,844,29,873,0,1093,79.87191217
臺中縣,大里市,中新里,105,427,48.68871152,450,51.31128848,877,23,900,0,1090,82.56880734
臺中縣,大里市,中新里,106,505,44.45422535,631,55.54577465,1136,9,1145,0,1416,80.86158192
臺中縣,大里市,立德里,159,644,55.37403267,519,44.62596733,1163,18,1181,0,1444,81.7867036
臺中縣,大里市,立德里,160,536,53.70741483,462,46.29258517,998,26,1024,0,1241,82.51410153
臺中縣,大里市,立德里,161,576,53.03867403,510,46.96132597,1086,20,1106,0,1379,80.20304569
臺中縣,大里市,仁德里,118,672,52.62333594,605,47.37666406,1277,10,1287,0,1557,82.65895954
臺中縣,大里市,仁德里,119,740,54.41176471,620,45.58823529,1360,19,1379,0,1687,81.74273859
臺中縣,大里市,仁德里,120,646,53.25638912,567,46.74361088,1213,26,1239,0,1512,81.94444444
臺中縣,太平市,太平里,172,962,59.64042157,651,40.35957843,1613,40,1653,0,1967,84.03660397
臺中縣,太平市,太平里,173,726,57.34597156,540,42.65402844,1266,32,1298,1,1589,81.68659534
臺中縣,太平市,太平里,174,774,59.40138143,529,40.59861857,1303,56,1359,0,1658,81.96622437
臺中縣,太平市,長億里,175,757,57.21844293,566,42.78155707,1323,30,1353,0,1674,80.82437276
臺中縣,太平市,長億里,176,495,45.37121907,596,54.62878093,1091,28,1119,0,1430,78.25174825
臺中縣,太平市,長億里,177,420,46.97986577,474,53.02013423,894,10,904,0,1150,78.60869565
臺中縣,太平市,長億里,178,823,51.85885318,764,48.14114682,1587,20,1607,0,1961,81.94798572
臺中縣,太平市,長億里,179,728,50.87351502,703,49.12648498,1431,33,1464,0,1766,82.89920725
臺中縣,太平市,中平里,180,669,55.0617284,546,44.9382716,1215,25,1240,0,1537,80.67664281
臺中縣,太平市,中平里,181,693,60,462,40,1155,17,1172,0,1429,82.01539538
臺中縣,太平市,中平里,182,668,52.433281,606,47.566719,1274,28,1302,0,1624,80.17241379
臺中縣,太平市,中平里,183,616,51.20532003,587,48.79467997,1203,33,1236,0,1574,78.52604828
臺中縣,太平市,中興里,184,881,49.60585586,895,50.39414414,1776,31,1807,0,2604,69.39324117
臺中縣,太平市,中興里,185,584,49.78687127,589,50.21312873,1173,26,1199,0,1474,81.34328358
臺中縣,太平市,中興里,186,677,57.17905405,507,42.82094595,1184,28,1212,0,1516,79.94722955
臺中縣,太平市,中興里,187,761,56.8334578,578,43.1665422,1339,23,1362,0,1639,83.09945088
臺中縣,太平市,建國里,193,566,45.49839228,678,54.50160772,1244,31,1275,0,1612,79.0942928
臺中縣,太平市,建國里,194,416,36.39545057,727,63.60454943,1143,32,1175,0,1487,79.01815736
臺中縣,太平市,建國里,195,800,50.34612964,789,49.65387036,1589,35,1624,0,1975,82.2278481
臺中縣,太平市,東平里,188,812,55.08819539,662,44.91180461,1474,42,1516,0,1846,82.12351029
臺中縣,太平市,東平里,189,764,53.27754533,670,46.72245467,1434,30,1464,0,1813,80.75013789
臺中縣,太平市,東平里,190,785,55.91168091,619,44.08831909,1404,15,1419,0,1751,81.03940605
臺中縣,太平市,東平里,191,763,55.24981897,618,44.75018103,1381,35,1416,0,1750,80.91428571
臺中縣,太平市,東平里,192,833,52.09505941,766,47.90494059,1599,42,1641,0,2054,79.89289192
臺中縣,太平市,宜欣里,210,525,46.05263158,615,53.94736842,1140,22,1162,0,1491,77.9342723
臺中縣,太平市,宜欣里,211,789,54.7536433,652,45.2463567,1441,41,1482,1,1855,79.89218329
臺中縣,太平市,宜欣里,212,817,49.27623643,841,50.72376357,1658,41,1699,0,2183,77.82867613
臺中縣,太平市,宜欣里,213,618,40.31311155,915,59.68688845,1533,13,1546,0,1905,81.15485564
臺中縣,太平市,宜欣里,214,762,49.54486346,776,50.45513654,1538,26,1564,0,1908,81.9706499
臺中縣,太平市,宜欣里,215,666,55.08684864,543,44.91315136,1209,33,1242,0,1525,81.44262295
臺中縣,太平市,宜欣里,216,641,49.30769231,659,50.69230769,1300,24,1324,1,1668,79.3764988
臺中縣,太平市,中山里,206,560,44.19889503,707,55.80110497,1267,23,1290,0,1566,82.37547893
臺中縣,太平市,中山里,207,243,25.60590095,706,74.39409905,949,22,971,0,1209,80.31430935
臺中縣,太平市,中山里,208,558,43.42412451,727,56.57587549,1285,29,1314,0,1548,84.88372093
臺中縣,太平市,中山里,209,623,40.66579634,909,59.33420366,1532,42,1574,0,1930,81.55440415
臺中縣,太平市,坪林里,196,541,59.5814978,367,40.4185022,908,25,933,0,1127,82.78615794
臺中縣,太平市,坪林里,197,310,44.47632712,387,55.52367288,697,8,705,0,859,82.07217695
臺中縣,太平市,坪林里,198,429,42.55952381,579,57.44047619,1008,22,1030,0,1239,83.13155771
臺中縣,太平市,坪林里,199,361,35.53149606,655,64.46850394,1016,19,1035,0,1242,83.33333333
臺中縣,太平市,坪林里,200,259,26.48261759,719,73.51738241,978,24,1002,0,1173,85.42199488
臺中縣,太平市,坪林里,201,538,37.23183391,907,62.76816609,1445,34,1479,0,1820,81.26373626
臺中縣,太平市,光華里,202,227,18.76033058,983,81.23966942,1210,37,1247,0,1535,81.23778502
臺中縣,太平市,光華里,203,617,38.08641975,1003,61.91358025,1620,33,1653,0,2024,81.66996047
臺中縣,太平市,光華里,204,673,45.41160594,809,54.58839406,1482,40,1522,0,1854,82.09277238
臺中縣,太平市,光華里,205,800,50.40957782,787,49.59042218,1587,36,1623,0,1975,82.17721519
臺中縣,太平市,新坪里,217,447,46.32124352,518,53.67875648,965,12,977,0,1239,78.85391445
臺中縣,太平市,新坪里,218,601,52.53496503,543,47.46503497,1144,21,1165,0,1435,81.18466899
臺中縣,太平市,新坪里,219,462,47.19101124,517,52.80898876,979,17,996,0,1246,79.93579454
臺中縣,太平市,新坪里,220,394,46.8489893,447,53.1510107,841,33,874,0,1080,80.92592593
臺中縣,太平市,新坪里,221,551,46.77419355,627,53.22580645,1178,25,1203,0,1515,79.40594059
臺中縣,太平市,新坪里,222,356,40.96662831,513,59.03337169,869,16,885,0,1101,80.38147139
臺中縣,太平市,新坪里,223,391,44.23076923,493,55.76923077,884,14,898,0,1245,72.12851406
臺中縣,太平市,新坪里,224,423,41.187926,604,58.812074,1027,21,1048,0,1342,78.0923994
臺中縣,太平市,新坪里,225,483,44.43422263,604,55.56577737,1087,13,1100,0,1368,80.40935673
臺中縣,太平市,新光里,226,984,62.43654822,592,37.56345178,1576,53,1629,0,1955,83.32480818
臺中縣,太平市,新光里,227,883,58.16864295,635,41.83135705,1518,33,1551,0,1968,78.81097561
臺中縣,太平市,新光里,228,783,51.31061599,743,48.68938401,1526,29,1555,0,1886,82.44962884
臺中縣,太平市,新光里,229,695,48.06362379,751,51.93637621,1446,16,1462,0,1808,80.86283186
臺中縣,太平市,新光里,230,558,44.04104183,709,55.95895817,1267,27,1294,0,1611,80.32278088
臺中縣,太平市,新福里,231,715,48.60639021,756,51.39360979,1471,25,1496,0,1748,85.58352403
臺中縣,太平市,新福里,232,405,47.92899408,440,52.07100592,845,17,862,0,1050,82.0952381
臺中縣,太平市,新福里,233,518,44.5399828,645,55.4600172,1163,25,1188,0,1475,80.54237288
臺中縣,太平市,頭汴里,234,528,60.96997691,338,39.03002309,866,35,901,0,1102,81.76043557
臺中縣,太平市,頭汴里,235,479,56.08899297,375,43.91100703,854,36,890,0,1124,79.18149466
臺中縣,太平市,頭汴里,236,462,56.61764706,354,43.38235294,816,42,858,0,1069,80.26192703
臺中縣,太平市,東汴里,237,529,60.45714286,346,39.54285714,875,41,916,1,1198,76.46076795
臺中縣,太平市,興隆里,238,768,58.80551302,538,41.19448698,1306,41,1347,0,1617,83.30241187
臺中縣,太平市,興隆里,239,500,41.25412541,712,58.74587459,1212,27,1239,0,1579,78.46738442
臺中縣,太平市,興隆里,240,606,50.12406948,603,49.87593052,1209,8,1217,0,1485,81.95286195
臺中縣,太平市,興隆里,241,494,51.08583247,473,48.91416753,967,17,984,0,1190,82.68907563
臺中縣,太平市,光隆里,243,710,57.58313058,523,42.41686942,1233,40,1273,0,1586,80.26481715
臺中縣,太平市,光隆里,244,832,57.22145805,622,42.77854195,1454,32,1486,2,1813,81.96359625
臺中縣,太平市,光隆里,245,523,50.62923524,510,49.37076476,1033,19,1052,0,1325,79.39622642
臺中縣,太平市,德隆里,246,801,54.15821501,678,45.84178499,1479,34,1513,0,1862,81.25671321
臺中縣,太平市,德隆里,247,759,57.32628399,565,42.67371601,1324,44,1368,0,1733,78.93825736
臺中縣,太平市,黃竹里,242,368,56.79012346,280,43.20987654,648,22,670,0,822,81.50851582
臺中縣,東勢鎮,北興里,248,343,36.92142088,586,63.07857912,929,22,951,0,1190,79.91596639
臺中縣,東勢鎮,中寧里,249,259,38.48439822,414,61.51560178,673,13,686,0,825,83.15151515
臺中縣,東勢鎮,東安里,250,403,40.42126379,594,59.57873621,997,24,1021,0,1286,79.39346812
臺中縣,東勢鎮,南平里,251,246,38.74015748,389,61.25984252,635,17,652,0,794,82.11586902
臺中縣,東勢鎮,南平里,252,333,40.90909091,481,59.09090909,814,25,839,0,1059,79.22568461
臺中縣,東勢鎮,延平里,253,451,51.60183066,423,48.39816934,874,20,894,0,1115,80.1793722
臺中縣,東勢鎮,延平里,254,377,44.30082256,474,55.69917744,851,25,876,0,1087,80.58877645
臺中縣,東勢鎮,上新里,255,298,39.0052356,466,60.9947644,764,30,794,0,954,83.22851153
臺中縣,東勢鎮,廣興里,256,481,41.04095563,691,58.95904437,1172,36,1208,0,1515,79.7359736
臺中縣,東勢鎮,泰昌里,257,515,46.43823264,594,53.56176736,1109,29,1138,0,1401,81.2276945
臺中縣,東勢鎮,泰昌里,258,300,35.41912633,547,64.58087367,847,14,861,0,1037,83.02796528
臺中縣,東勢鎮,泰昌里,259,212,35.21594684,390,64.78405316,602,20,622,0,794,78.33753149
臺中縣,東勢鎮,中嵙里,260,360,49.72375691,364,50.27624309,724,26,750,0,926,80.99352052
臺中縣,東勢鎮,中嵙里,261,305,43.82183908,391,56.17816092,696,34,730,0,918,79.52069717
臺中縣,東勢鎮,福隆里,262,435,44.20731707,549,55.79268293,984,45,1029,0,1294,79.52086553
臺中縣,東勢鎮,福隆里,263,639,42.74247492,856,57.25752508,1495,34,1529,0,1884,81.15711253
臺中縣,東勢鎮,隆興里,264,544,52.20729367,498,47.79270633,1042,40,1082,0,1426,75.87657784
臺中縣,東勢鎮,新盛里,265,587,54.10138249,498,45.89861751,1085,42,1127,0,1397,80.67287044
臺中縣,東勢鎮,新盛里,266,573,45.73024741,680,54.26975259,1253,42,1295,0,1641,78.91529555
臺中縣,東勢鎮,新盛里,267,646,50.07751938,644,49.92248062,1290,54,1344,0,1593,84.36911488
臺中縣,東勢鎮,詒福里,268,648,57.19329214,485,42.80670786,1133,47,1180,0,1448,81.49171271
臺中縣,東勢鎮,上城里,269,426,56.12648221,333,43.87351779,759,32,791,0,975,81.12820513
臺中縣,東勢鎮,下城里,270,388,57.05882353,292,42.94117647,680,38,718,0,898,79.95545657
臺中縣,東勢鎮,慶東里,271,481,60.20025031,318,39.79974969,799,33,832,0,1047,79.46513849
臺中縣,東勢鎮,慶東里,272,372,54.62555066,309,45.37444934,681,19,700,0,881,79.45516459
臺中縣,東勢鎮,慶福里,273,593,60.63394683,385,39.36605317,978,48,1026,0,1389,73.86609071
臺中縣,東勢鎮,東新里,274,313,44.20903955,395,55.79096045,708,14,722,0,875,82.51428571
臺中縣,東勢鎮,東新里,275,310,38.55721393,494,61.44278607,804,27,831,0,1061,78.32233742
臺中縣,東勢鎮,粵寧里,276,482,54.58663647,401,45.41336353,883,30,913,0,1116,81.81003584
臺中縣,東勢鎮,粵寧里,277,216,43.90243902,276,56.09756098,492,13,505,0,644,78.41614907
臺中縣,東勢鎮,下新里,278,762,57.29323308,568,42.70676692,1330,24,1354,0,1647,82.21007893
臺中縣,東勢鎮,興隆里,279,596,61.06557377,380,38.93442623,976,43,1019,0,1240,82.17741935
臺中縣,東勢鎮,茂興里,280,690,51.14899926,659,48.85100074,1349,61,1410,0,1750,80.57142857
臺中縣,東勢鎮,泰興里,281,340,58.62068966,240,41.37931034,580,24,604,0,755,80
臺中縣,東勢鎮,埤頭里,282,307,55.31531532,248,44.68468468,555,25,580,0,663,87.4811463
臺中縣,東勢鎮,明正里,283,593,60.02024291,395,39.97975709,988,70,1058,1,1395,75.84229391
臺中縣,大甲鎮,朝陽里,284,559,55.34653465,451,44.65346535,1010,22,1032,1,1271,81.19590873
臺中縣,大甲鎮,大甲里,285,478,53.28874025,419,46.71125975,897,23,920,0,1177,78.16482583
臺中縣,大甲鎮,順天里,286,365,56.7651633,278,43.2348367,643,14,657,0,799,82.22778473
臺中縣,大甲鎮,順天里,287,331,50.07564297,330,49.92435703,661,15,676,0,860,78.60465116
臺中縣,大甲鎮,孔門里,288,306,48.41772152,326,51.58227848,632,16,648,0,786,82.44274809
臺中縣,大甲鎮,平安里,289,382,55.12265512,311,44.87734488,693,19,712,0,870,81.83908046
臺中縣,大甲鎮,平安里,290,473,54.11899314,401,45.88100686,874,12,886,0,1090,81.28440367
臺中縣,大甲鎮,庄美里,291,419,57.39726027,311,42.60273973,730,19,749,0,928,80.7112069
臺中縣,大甲鎮,庄美里,292,439,52.5748503,396,47.4251497,835,25,860,0,1038,82.85163776
臺中縣,大甲鎮,新美里,293,375,48.7012987,395,51.2987013,770,31,801,0,1014,78.99408284
臺中縣,大甲鎮,新美里,294,436,51.1137163,417,48.8862837,853,22,875,0,1051,83.25404377
臺中縣,大甲鎮,新美里,295,444,53.42960289,387,46.57039711,831,24,855,0,1037,82.44937319
臺中縣,大甲鎮,岷山里,296,370,50.20352782,367,49.79647218,737,6,743,0,896,82.92410714
臺中縣,大甲鎮,岷山里,297,358,48.24797844,384,51.75202156,742,17,759,0,967,78.4901758
臺中縣,大甲鎮,中山里,298,428,50.11709602,426,49.88290398,854,26,880,0,1086,81.03130755
臺中縣,大甲鎮,中山里,299,394,42.27467811,538,57.72532189,932,33,965,0,1189,81.16063919
臺中縣,大甲鎮,中山里,300,433,47.1164309,486,52.8835691,919,28,947,0,1164,81.35738832
臺中縣,大甲鎮,南陽里,301,346,50.73313783,336,49.26686217,682,17,699,0,880,79.43181818
臺中縣,大甲鎮,薰風里,302,387,51.8766756,359,48.1233244,746,17,763,0,934,81.69164882
臺中縣,大甲鎮,義和里,303,506,51.79119754,471,48.20880246,977,33,1010,0,1297,77.87201234
臺中縣,大甲鎮,義和里,304,514,48.67424242,542,51.32575758,1056,31,1087,0,1352,80.39940828
臺中縣,大甲鎮,武陵里,305,375,44.16961131,474,55.83038869,849,36,885,0,1106,80.01808318
臺中縣,大甲鎮,文曲里,306,438,54.61346633,364,45.38653367,802,37,839,0,1095,76.62100457
臺中縣,大甲鎮,武曲里,307,315,48.31288344,337,51.68711656,652,26,678,0,812,83.49753695
臺中縣,大甲鎮,武曲里,308,306,53.125,270,46.875,576,28,604,0,748,80.7486631
臺中縣,大甲鎮,文武里,309,452,48.65446717,477,51.34553283,929,21,950,0,1158,82.03799655
臺中縣,大甲鎮,文武里,310,446,51.44175317,421,48.55824683,867,28,895,0,1090,82.11009174
臺中縣,大甲鎮,文武里,311,476,52.71317829,427,47.28682171,903,9,912,0,1115,81.79372197
臺中縣,大甲鎮,文武里,312,446,49.06490649,463,50.93509351,909,25,934,0,1189,78.55340622
臺中縣,大甲鎮,奉化里,313,525,47.04301075,591,52.95698925,1116,32,1148,0,1445,79.44636678
臺中縣,大甲鎮,德化里,314,414,67.86885246,196,32.13114754,610,15,625,0,801,78.02746567
臺中縣,大甲鎮,德化里,315,368,57.86163522,268,42.13836478,636,17,653,0,806,81.01736973
臺中縣,大甲鎮,江南里,316,461,55.54216867,369,44.45783133,830,12,842,0,1028,81.90661479
臺中縣,大甲鎮,頂店里,317,444,56.85019206,337,43.14980794,781,23,804,0,1021,78.74632713
臺中縣,大甲鎮,頂店里,318,465,56.84596577,353,43.15403423,818,29,847,0,1069,79.23292797
臺中縣,大甲鎮,頂店里,319,543,53.39233038,474,46.60766962,1017,28,1045,0,1286,81.25972006
臺中縣,大甲鎮,太白里,320,554,58.19327731,398,41.80672269,952,31,983,0,1246,78.89245586
臺中縣,大甲鎮,孟春里,321,451,49.94462901,452,50.05537099,903,25,928,0,1145,81.04803493
臺中縣,大甲鎮,孟春里,322,509,60.45130641,333,39.54869359,842,21,863,0,1063,81.18532455
臺中縣,大甲鎮,孟春里,323,433,57.4270557,321,42.5729443,754,21,775,0,998,77.65531062
臺中縣,大甲鎮,幸福里,324,575,67.33021077,279,32.66978923,854,42,896,0,1097,81.67730173
臺中縣,大甲鎮,幸福里,325,551,58.492569,391,41.507431,942,41,983,0,1243,79.08286404
臺中縣,大甲鎮,日南里,326,405,51.39593909,383,48.60406091,788,16,804,0,1018,78.978389
臺中縣,大甲鎮,日南里,327,376,52.58741259,339,47.41258741,715,17,732,0,936,78.20512821
臺中縣,大甲鎮,日南里,328,451,56.65829146,345,43.34170854,796,26,822,0,1037,79.26711668
臺中縣,大甲鎮,日南里,329,429,47.87946429,467,52.12053571,896,18,914,0,1109,82.41659152
臺中縣,大甲鎮,龍泉里,330,200,42.82655246,267,57.17344754,467,23,490,0,609,80.45977011
臺中縣,大甲鎮,龍泉里,331,370,60.6557377,240,39.3442623,610,30,640,0,783,81.73690932
臺中縣,大甲鎮,西岐里,332,302,49.18566775,312,50.81433225,614,21,635,0,781,81.30601793
臺中縣,大甲鎮,西岐里,333,276,50.0907441,275,49.9092559,551,19,570,0,713,79.94389902
臺中縣,大甲鎮,銅安里,334,517,54.13612565,438,45.86387435,955,45,1000,0,1242,80.51529791
臺中縣,大甲鎮,福德里,335,389,45.12761021,473,54.87238979,862,21,883,0,1067,82.75538894
臺中縣,大甲鎮,建興里,336,599,57.48560461,443,42.51439539,1042,45,1087,0,1329,81.79082017
臺中縣,清水鎮,鰲峰里,337,494,51.78197065,460,48.21802935,954,17,971,0,1200,80.91666667
臺中縣,清水鎮,靈泉里,338,420,48.16513761,452,51.83486239,872,14,886,0,1071,82.7264239
臺中縣,清水鎮,清水里,339,471,61.81102362,291,38.18897638,762,11,773,0,968,79.8553719
臺中縣,清水鎮,清水里,340,495,57.62514552,364,42.37485448,859,16,875,0,1058,82.70321361
臺中縣,清水鎮,文昌里,341,342,57.67284992,251,42.32715008,593,8,601,0,730,82.32876712
臺中縣,清水鎮,南寧里,342,331,48.53372434,351,51.46627566,682,18,700,0,842,83.13539192
臺中縣,清水鎮,南寧里,343,421,55.39473684,339,44.60526316,760,3,763,0,936,81.51709402
臺中縣,清水鎮,西寧里,344,707,60.68669528,458,39.31330472,1165,36,1201,0,1466,81.92360164
臺中縣,清水鎮,北寧里,345,355,59.06821963,246,40.93178037,601,20,621,0,744,83.46774194
臺中縣,清水鎮,中興里,346,219,58.24468085,157,41.75531915,376,11,387,0,459,84.31372549
臺中縣,清水鎮,西社里,347,666,56.48854962,513,43.51145038,1179,13,1192,0,1426,83.59046283
臺中縣,清水鎮,西社里,348,228,28.78787879,564,71.21212121,792,18,810,0,988,81.98380567
臺中縣,清水鎮,南社里,349,522,57.17415115,391,42.82584885,913,17,930,0,1154,80.58925477
臺中縣,清水鎮,南社里,350,676,60.35714286,444,39.64285714,1120,26,1146,1,1437,79.74947808
臺中縣,清水鎮,南社里,351,630,58.49582173,447,41.50417827,1077,33,1110,0,1368,81.14035088
臺中縣,清水鎮,南社里,352,598,52.13600697,549,47.86399303,1147,31,1178,0,1400,84.14285714
臺中縣,清水鎮,裕嘉里,353,544,55.79487179,431,44.20512821,975,25,1000,0,1272,78.6163522
臺中縣,清水鎮,臨江里,354,556,48.85764499,582,51.14235501,1138,47,1185,1,1484,79.85175202
臺中縣,清水鎮,秀水里,355,533,59.22222222,367,40.77777778,900,25,925,0,1231,75.14216084
臺中縣,清水鎮,秀水里,356,502,53.46112886,437,46.53887114,939,23,962,0,1181,81.45639289
臺中縣,清水鎮,秀水里,357,489,53.03687636,433,46.96312364,922,19,941,0,1147,82.04010462
臺中縣,清水鎮,武鹿里,358,606,58.3253128,433,41.6746872,1039,37,1076,0,1372,78.42565598
臺中縣,清水鎮,武鹿里,359,620,57.24838412,463,42.75161588,1083,33,1116,0,1397,79.88546886
臺中縣,清水鎮,海濱里,360,452,53.68171021,390,46.31828979,842,33,875,0,1092,80.12820513
臺中縣,清水鎮,海濱里,361,321,52.62295082,289,47.37704918,610,11,621,0,770,80.64935065
臺中縣,清水鎮,康榔里,362,646,59.53917051,439,40.46082949,1085,23,1108,0,1349,82.13491475
臺中縣,清水鎮,康榔里,363,515,65.35532995,273,34.64467005,788,17,805,0,1015,79.31034483
臺中縣,清水鎮,康榔里,364,578,60.33402923,380,39.66597077,958,24,982,1,1234,79.57860616
臺中縣,清水鎮,中社里,365,54,9.168081494,535,90.83191851,589,13,602,0,723,83.26417704
臺中縣,清水鎮,中社里,366,213,33.80952381,417,66.19047619,630,14,644,0,804,80.09950249
臺中縣,清水鎮,高西里,367,419,42.11055276,576,57.88944724,995,53,1048,0,1325,79.09433962
臺中縣,清水鎮,高南里,368,581,54.96688742,476,45.03311258,1057,33,1090,0,1305,83.52490421
臺中縣,清水鎮,高東里,369,653,67.11202467,320,32.88797533,973,47,1020,0,1285,79.37743191
臺中縣,清水鎮,高北里,370,335,40.50785973,492,59.49214027,827,28,855,0,1101,77.65667575
臺中縣,清水鎮,高美里,371,488,49.29292929,502,50.70707071,990,26,1016,0,1270,80
臺中縣,清水鎮,國姓里,372,524,64.37346437,290,35.62653563,814,26,840,0,1099,76.43312102
臺中縣,清水鎮,國姓里,373,486,66.75824176,242,33.24175824,728,24,752,0,909,82.72827283
臺中縣,清水鎮,菁埔里,374,463,57.23114957,346,42.76885043,809,27,836,0,1047,79.84718243
臺中縣,清水鎮,菁埔里,375,518,61.74016687,321,38.25983313,839,28,867,0,1136,76.32042254
臺中縣,清水鎮,頂湳里,376,334,51.54320988,314,48.45679012,648,24,672,0,842,79.80997625
臺中縣,清水鎮,頂湳里,377,438,62.84074605,259,37.15925395,697,31,728,0,917,79.38931298
臺中縣,清水鎮,田寮里,378,529,59.50506187,360,40.49493813,889,12,901,0,1148,78.48432056
臺中縣,清水鎮,田寮里,379,450,62.06896552,275,37.93103448,725,22,747,0,977,76.45854657
臺中縣,清水鎮,橋頭里,380,735,59.65909091,497,40.34090909,1232,13,1245,1,1572,79.19847328
臺中縣,清水鎮,橋頭里,381,799,56.66666667,611,43.33333333,1410,27,1437,0,1742,82.49138921
臺中縣,清水鎮,橋頭里,382,579,57.44047619,429,42.55952381,1008,17,1025,0,1270,80.70866142
臺中縣,清水鎮,橋頭里,383,564,57.90554415,410,42.09445585,974,8,982,0,1217,80.69022186
臺中縣,清水鎮,下湳里,384,341,54.82315113,281,45.17684887,622,20,642,0,810,79.25925926
臺中縣,清水鎮,下湳里,385,354,58.31960461,253,41.68039539,607,22,629,0,792,79.41919192
臺中縣,清水鎮,下湳里,386,596,58.60373648,421,41.39626352,1017,16,1033,0,1259,82.04924543
臺中縣,清水鎮,東山里,387,432,50,432,50,864,31,895,0,1112,80.48561151
臺中縣,清水鎮,楊厝里,389,527,64.98150432,284,35.01849568,811,42,853,0,1037,82.25650916
臺中縣,清水鎮,海風里,390,588,64.05228758,330,35.94771242,918,42,960,0,1207,79.53603977
臺中縣,清水鎮,吳厝里,388,517,49.28503337,532,50.71496663,1049,42,1091,0,1332,81.90690691
臺中縣,沙鹿鎮,居仁里,391,579,52.68425842,520,47.31574158,1099,12,1111,0,1355,81.99261993
臺中縣,沙鹿鎮,洛泉里,392,402,52.68676278,361,47.31323722,763,20,783,1,964,81.22406639
臺中縣,沙鹿鎮,洛泉里,393,496,49.0603363,515,50.9396637,1011,16,1027,0,1234,83.22528363
臺中縣,沙鹿鎮,沙鹿里,394,576,61.14649682,366,38.85350318,942,21,963,0,1174,82.02725724
臺中縣,沙鹿鎮,美仁里,395,233,51.54867257,219,48.45132743,452,8,460,0,547,84.09506399
臺中縣,沙鹿鎮,興仁里,396,550,51.74035748,513,48.25964252,1063,20,1083,0,1335,81.12359551
臺中縣,沙鹿鎮,興仁里,397,425,49.53379953,433,50.46620047,858,14,872,0,1046,83.36520076
臺中縣,沙鹿鎮,斗抵里,400,394,46.9047619,446,53.0952381,840,12,852,0,1024,83.203125
臺中縣,沙鹿鎮,斗抵里,401,543,52.87244401,484,47.12755599,1027,32,1059,0,1267,83.58326756
臺中縣,沙鹿鎮,斗抵里,402,601,52.67309378,540,47.32690622,1141,22,1163,0,1393,83.48887294
臺中縣,沙鹿鎮,鹿峰里,403,599,61.68898043,372,38.31101957,971,26,997,0,1247,79.95188452
臺中縣,沙鹿鎮,鹿峰里,404,596,57.80795344,435,42.19204656,1031,23,1054,0,1298,81.201849
臺中縣,沙鹿鎮,鹿峰里,405,579,55.67307692,461,44.32692308,1040,29,1069,0,1328,80.49698795
臺中縣,沙鹿鎮,鹿寮里,406,783,61.65354331,487,38.34645669,1270,39,1309,2,1626,80.50430504
臺中縣,沙鹿鎮,鹿寮里,407,502,58.03468208,363,41.96531792,865,20,885,1,1087,81.41674333
臺中縣,沙鹿鎮,鹿寮里,408,548,65.0059312,295,34.9940688,843,16,859,0,1079,79.6107507
臺中縣,沙鹿鎮,鹿寮里,409,640,56.53710247,492,43.46289753,1132,20,1152,0,1357,84.89314665
臺中縣,沙鹿鎮,竹林里,410,484,46.67309547,553,53.32690453,1037,31,1068,0,1287,82.98368298
臺中縣,沙鹿鎮,竹林里,411,506,45.46271339,607,54.53728661,1113,29,1142,0,1411,80.93550673
臺中縣,沙鹿鎮,竹林里,412,640,57.55395683,472,42.44604317,1112,28,1140,0,1434,79.49790795
臺中縣,沙鹿鎮,竹林里,413,564,49.73544974,570,50.26455026,1134,17,1151,0,1369,84.07596786
臺中縣,沙鹿鎮,犁分里,414,371,57.43034056,275,42.56965944,646,35,681,0,840,81.07142857
臺中縣,沙鹿鎮,北勢里,417,399,48.77750611,419,51.22249389,818,17,835,1,1040,80.28846154
臺中縣,沙鹿鎮,北勢里,418,399,51.08834827,382,48.91165173,781,35,816,0,1058,77.12665406
臺中縣,沙鹿鎮,北勢里,419,479,50.79533404,464,49.20466596,943,29,972,0,1226,79.2822186
臺中縣,沙鹿鎮,福興里,415,533,48.58705561,564,51.41294439,1097,26,1123,1,1427,78.69656622
臺中縣,沙鹿鎮,福興里,416,251,41.3509061,356,58.6490939,607,17,624,0,809,77.13226205
臺中縣,沙鹿鎮,晉江里,420,541,55.20408163,439,44.79591837,980,42,1022,0,1254,81.49920255
臺中縣,沙鹿鎮,六路里,421,421,51.97530864,389,48.02469136,810,19,829,0,1042,79.55854127
臺中縣,沙鹿鎮,六路里,422,535,53.44655345,466,46.55344655,1001,24,1025,0,1262,81.22028526
臺中縣,沙鹿鎮,南勢里,423,445,58.94039735,310,41.05960265,755,23,778,0,971,80.12358393
臺中縣,沙鹿鎮,南勢里,424,349,51.93452381,323,48.06547619,672,30,702,0,879,79.86348123
臺中縣,沙鹿鎮,埔子里,425,808,50.5,792,49.5,1600,43,1643,0,2061,79.71858321
臺中縣,沙鹿鎮,公明里,428,406,39.26499033,628,60.73500967,1034,29,1063,0,1323,80.34769463
臺中縣,沙鹿鎮,公明里,429,93,13.77777778,582,86.22222222,675,16,691,1,868,79.60829493
臺中縣,沙鹿鎮,公明里,430,462,43.17757009,608,56.82242991,1070,25,1095,0,1287,85.08158508
臺中縣,沙鹿鎮,清泉里,431,350,40.6504065,511,59.3495935,861,10,871,0,1094,79.61608775
臺中縣,沙鹿鎮,清泉里,432,180,27.56508423,473,72.43491577,653,19,672,0,791,84.95575221
臺中縣,沙鹿鎮,西勢里,433,417,50.54545455,408,49.45454545,825,12,837,0,1040,80.48076923
臺中縣,沙鹿鎮,西勢里,434,361,47.37532808,401,52.62467192,762,11,773,0,944,81.88559322
臺中縣,沙鹿鎮,興安里,398,414,55.49597855,332,44.50402145,746,24,770,0,954,80.71278826
臺中縣,沙鹿鎮,興安里,399,719,53.45724907,626,46.54275093,1345,23,1368,1,1639,83.46552776
臺中縣,沙鹿鎮,三鹿里,426,363,41.91685912,503,58.08314088,866,25,891,0,1123,79.34105076
臺中縣,沙鹿鎮,三鹿里,427,411,43.30874605,538,56.69125395,949,27,976,0,1271,76.78992919
臺中縣,梧棲鎮,頂寮里,435,405,49.87684729,407,50.12315271,812,23,835,0,1060,78.77358491
臺中縣,梧棲鎮,頂寮里,436,522,43.06930693,690,56.93069307,1212,18,1230,0,1510,81.45695364
臺中縣,梧棲鎮,下寮里,437,288,38.70967742,456,61.29032258,744,22,766,0,913,83.8992333
臺中縣,梧棲鎮,下寮里,438,459,50.32894737,453,49.67105263,912,15,927,1,1102,84.11978221
臺中縣,梧棲鎮,中正里,439,446,53.3492823,390,46.6507177,836,21,857,0,1076,79.64684015
臺中縣,梧棲鎮,中正里,440,401,47.23203769,448,52.76796231,849,18,867,0,1118,77.54919499
臺中縣,梧棲鎮,中正里,441,411,45.31422271,496,54.68577729,907,13,920,0,1149,80.06962576
臺中縣,梧棲鎮,中和里,442,243,55.10204082,198,44.89795918,441,3,444,0,566,78.44522968
臺中縣,梧棲鎮,文化里,443,446,47.95698925,484,52.04301075,930,24,954,0,1148,83.1010453
臺中縣,梧棲鎮,安仁里,444,281,47.78911565,307,52.21088435,588,19,607,0,741,81.91632928
臺中縣,梧棲鎮,草湳里,445,402,46.47398844,463,53.52601156,865,27,892,0,1115,80
臺中縣,梧棲鎮,草湳里,446,564,49.3006993,580,50.6993007,1144,28,1172,0,1444,81.1634349
臺中縣,梧棲鎮,草湳里,447,515,52.65848671,463,47.34151329,978,26,1004,0,1260,79.68253968
臺中縣,梧棲鎮,草湳里,448,593,52.33892321,540,47.66107679,1133,19,1152,0,1405,81.99288256
臺中縣,梧棲鎮,南簡里,449,618,62.11055276,377,37.88944724,995,26,1021,0,1215,84.03292181
臺中縣,梧棲鎮,南簡里,450,640,57.70964833,469,42.29035167,1109,27,1136,0,1405,80.85409253
臺中縣,梧棲鎮,福德里,451,653,57.68551237,479,42.31448763,1132,20,1152,0,1404,82.05128205
臺中縣,梧棲鎮,福德里,452,624,53.24232082,548,46.75767918,1172,30,1202,0,1496,80.34759358
臺中縣,梧棲鎮,大庄里,453,497,57.72357724,364,42.27642276,861,17,878,0,1096,80.10948905
臺中縣,梧棲鎮,大庄里,454,450,52.44755245,408,47.55244755,858,14,872,0,1050,83.04761905
臺中縣,梧棲鎮,大庄里,455,505,46.75925926,575,53.24074074,1080,11,1091,0,1368,79.75146199
臺中縣,梧棲鎮,大庄里,456,303,50.83892617,293,49.16107383,596,21,617,0,766,80.54830287
臺中縣,梧棲鎮,大庄里,457,327,51.33437991,310,48.66562009,637,11,648,0,803,80.69738481
臺中縣,梧棲鎮,大村里,458,531,52.47035573,481,47.52964427,1012,23,1035,0,1311,78.94736842
臺中縣,梧棲鎮,大村里,459,533,51.05363985,511,48.94636015,1044,25,1069,0,1336,80.01497006
臺中縣,梧棲鎮,大村里,460,418,48.26789838,448,51.73210162,866,17,883,0,1088,81.15808824
臺中縣,梧棲鎮,興農里,461,450,56.17977528,351,43.82022472,801,29,830,0,1030,80.58252427
臺中縣,梧棲鎮,興農里,462,412,65.92,213,34.08,625,20,645,0,774,83.33333333
臺中縣,梧棲鎮,永寧里,463,476,57.21153846,356,42.78846154,832,5,837,0,1013,82.62586377
臺中縣,梧棲鎮,永寧里,464,509,54.32230523,428,45.67769477,937,19,956,0,1155,82.77056277
臺中縣,梧棲鎮,永安里,465,457,50.10964912,455,49.89035088,912,29,941,0,1148,81.96864111
臺中縣,梧棲鎮,永安里,466,502,58.37209302,358,41.62790698,860,10,870,0,1091,79.74335472
臺中縣,后里鄉,廣福村,467,278,44.48,347,55.52,625,27,652,0,772,84.45595855
臺中縣,后里鄉,廣福村,468,207,22.79735683,701,77.20264317,908,27,935,0,1159,80.67299396
臺中縣,后里鄉,仁里村,469,399,54.65753425,331,45.34246575,730,14,744,0,915,81.31147541
臺中縣,后里鄉,仁里村,470,48,4.293381038,1070,95.70661896,1118,32,1150,0,1394,82.4964132
臺中縣,后里鄉,義里村,471,437,43.09664694,577,56.90335306,1014,33,1047,0,1275,82.11764706
臺中縣,后里鄉,義里村,472,430,39.70452447,653,60.29547553,1083,16,1099,0,1351,81.34715026
臺中縣,后里鄉,后里村,475,487,49.24165824,502,50.75834176,989,12,1001,0,1208,82.86423841
臺中縣,后里鄉,后里村,476,468,46.47467726,539,53.52532274,1007,24,1031,0,1212,85.0660066
臺中縣,后里鄉,后里村,477,362,49.5890411,368,50.4109589,730,11,741,0,897,82.60869565
臺中縣,后里鄉,厚里村,478,397,55.21557719,322,44.78442281,719,21,740,0,896,82.58928571
臺中縣,后里鄉,厚里村,479,451,55.33742331,364,44.66257669,815,31,846,0,1000,84.6
臺中縣,后里鄉,墩東村,480,569,47.49582638,629,52.50417362,1198,28,1226,0,1515,80.92409241
臺中縣,后里鄉,墩東村,481,554,53.37186898,484,46.62813102,1038,30,1068,0,1328,80.42168675
臺中縣,后里鄉,墩東村,482,567,54.31034483,477,45.68965517,1044,32,1076,0,1250,86.08
臺中縣,后里鄉,墩西村,483,369,53.94736842,315,46.05263158,684,26,710,0,862,82.36658933
臺中縣,后里鄉,墩西村,484,464,60.57441253,302,39.42558747,766,21,787,0,935,84.17112299
臺中縣,后里鄉,墩南村,485,505,51.84804928,469,48.15195072,974,20,994,0,1205,82.48962656
臺中縣,后里鄉,墩南村,486,689,60.38562664,452,39.61437336,1141,31,1172,0,1394,84.07460545
臺中縣,后里鄉,墩北村,487,539,52.33009709,491,47.66990291,1030,33,1063,1,1262,84.23137876
臺中縣,后里鄉,墩北村,488,745,58.66141732,525,41.33858268,1270,35,1305,0,1573,82.96249205
臺中縣,后里鄉,中和村,489,501,64.56185567,275,35.43814433,776,25,801,0,961,83.35067638
臺中縣,后里鄉,中和村,490,496,56.88073394,376,43.11926606,872,25,897,0,1065,84.22535211
臺中縣,后里鄉,舊社村,491,670,63.38694418,387,36.61305582,1057,39,1096,0,1331,82.34410218
臺中縣,后里鄉,聯合村,492,714,60.86956522,459,39.13043478,1173,42,1215,0,1499,81.05403602
臺中縣,后里鄉,太平村,493,387,55.68345324,308,44.31654676,695,34,729,0,913,79.84665936
臺中縣,后里鄉,太平村,494,457,52.71049596,410,47.28950404,867,29,896,0,1103,81.23300091
臺中縣,后里鄉,眉山村,495,615,53.90008764,526,46.09991236,1141,25,1166,0,1441,80.91603053
臺中縣,后里鄉,眉山村,496,518,48.23091248,556,51.76908752,1074,34,1108,0,1384,80.05780347
臺中縣,后里鄉,泰安村,499,592,59.85844287,397,40.14155713,989,38,1027,0,1268,80.99369085
臺中縣,后里鄉,公館村,498,809,58.28530259,579,41.71469741,1388,47,1435,0,1769,81.11927643
臺中縣,后里鄉,月眉村,497,771,61.63069544,480,38.36930456,1251,30,1281,0,1543,83.02009073
臺中縣,后里鄉,義德村,473,398,39.09626719,620,60.90373281,1018,23,1041,0,1288,80.82298137
臺中縣,后里鄉,義德村,474,427,42.91457286,568,57.08542714,995,24,1019,0,1236,82.4433657
臺中縣,神岡鄉,神岡村,500,602,58.61733204,425,41.38266796,1027,22,1049,0,1263,83.05621536
臺中縣,神岡鄉,神岡村,501,494,49.05660377,513,50.94339623,1007,20,1027,0,1250,82.16
臺中縣,神岡鄉,庄前村,502,720,57.27923628,537,42.72076372,1257,29,1286,0,1586,81.08448928
臺中縣,神岡鄉,北庄村,503,477,61.31105398,301,38.68894602,778,28,806,0,947,85.11087645
臺中縣,神岡鄉,北庄村,504,555,58.35962145,396,41.64037855,951,29,980,0,1208,81.12582781
臺中縣,神岡鄉,庄後村,505,597,64.68039003,326,35.31960997,923,37,960,0,1141,84.13672217
臺中縣,神岡鄉,庄後村,506,458,64.87252125,248,35.12747875,706,20,726,0,870,83.44827586
臺中縣,神岡鄉,社口村,515,673,58.93169877,469,41.06830123,1142,35,1177,0,1417,83.06280875
臺中縣,神岡鄉,社口村,516,591,56.01895735,464,43.98104265,1055,22,1077,0,1293,83.29466357
臺中縣,神岡鄉,社口村,517,630,59.04404873,437,40.95595127,1067,22,1089,0,1337,81.45100972
臺中縣,神岡鄉,社口村,518,680,59.33682373,466,40.66317627,1146,11,1157,0,1371,84.39095551
臺中縣,神岡鄉,社南村,519,693,61.6,432,38.4,1125,36,1161,0,1403,82.75124733
臺中縣,神岡鄉,社南村,520,675,63.49952963,388,36.50047037,1063,31,1094,0,1308,83.63914373
臺中縣,神岡鄉,社南村,521,613,57.83018868,447,42.16981132,1060,31,1091,0,1329,82.09179834
臺中縣,神岡鄉,三角村,522,730,67.90697674,345,32.09302326,1075,32,1107,0,1319,83.92721759
臺中縣,神岡鄉,三角村,523,420,64.61538462,230,35.38461538,650,20,670,0,802,83.54114713
臺中縣,神岡鄉,岸裡村,527,683,63.53488372,392,36.46511628,1075,24,1099,0,1279,85.92650508
臺中縣,神岡鄉,岸裡村,528,681,65.92449177,352,34.07550823,1033,33,1066,0,1271,83.87096774
臺中縣,神岡鄉,大社村,524,588,59.21450151,405,40.78549849,993,30,1023,0,1219,83.92124692
臺中縣,神岡鄉,大社村,525,471,49.84126984,474,50.15873016,945,22,967,0,1216,79.52302632
臺中縣,神岡鄉,大社村,526,266,43.89438944,340,56.10561056,606,13,619,0,812,76.23152709
臺中縣,神岡鄉,豐洲村,529,718,60.693153,465,39.306847,1183,45,1228,0,1521,80.73635766
臺中縣,神岡鄉,豐洲村,530,826,63.05343511,484,36.94656489,1310,44,1354,0,1630,83.06748466
臺中縣,神岡鄉,豐洲村,531,744,59.95165189,497,40.04834811,1241,36,1277,0,1571,81.28580522
臺中縣,神岡鄉,豐洲村,532,734,63.00429185,431,36.99570815,1165,33,1198,0,1438,83.31015299
臺中縣,神岡鄉,神洲村,533,639,69.30585683,283,30.69414317,922,44,966,0,1115,86.6367713
臺中縣,神岡鄉,神洲村,534,626,65.34446764,332,34.65553236,958,28,986,0,1161,84.92678725
臺中縣,神岡鄉,溪洲村,535,627,58.81801126,439,41.18198874,1066,12,1078,0,1288,83.69565217
臺中縣,神岡鄉,溪洲村,536,686,68.80641926,311,31.19358074,997,33,1030,0,1210,85.12396694
臺中縣,神岡鄉,圳前村,507,548,57.08333333,412,42.91666667,960,26,986,0,1182,83.4179357
臺中縣,神岡鄉,圳前村,508,250,34.01360544,485,65.98639456,735,18,753,0,935,80.53475936
臺中縣,神岡鄉,新庄村,511,612,62.70491803,364,37.29508197,976,43,1019,0,1219,83.59310911
臺中縣,神岡鄉,新庄村,512,592,62.91179596,349,37.08820404,941,34,975,0,1200,81.25
臺中縣,神岡鄉,新庄村,513,426,49.30555556,438,50.69444444,864,31,895,0,1165,76.82403433
臺中縣,神岡鄉,圳堵村,509,371,54.00291121,316,45.99708879,687,21,708,0,807,87.73234201
臺中縣,神岡鄉,圳堵村,510,401,43.87308534,513,56.12691466,914,19,933,0,1144,81.55594406
臺中縣,神岡鄉,山皮村,514,429,58.68673051,302,41.31326949,731,31,762,1,917,83.09705562
臺中縣,潭子鄉,潭陽村,539,648,52.00642055,598,47.99357945,1246,29,1275,0,1541,82.73848151
臺中縣,潭子鄉,潭陽村,540,811,47.06906558,912,52.93093442,1723,22,1745,0,2074,84.13693346
臺中縣,潭子鄉,潭陽村,541,659,47.41007194,731,52.58992806,1390,28,1418,0,1898,74.71022129
臺中縣,潭子鄉,潭陽村,542,909,56.91922354,688,43.08077646,1597,32,1629,0,1981,82.23119637
臺中縣,潭子鄉,潭陽村,543,568,50.6690455,553,49.3309545,1121,29,1150,0,1358,84.68335788
臺中縣,潭子鄉,潭秀村,537,723,63.5883905,414,36.4116095,1137,18,1155,0,1377,83.87799564
臺中縣,潭子鄉,潭北村,538,822,48.40989399,876,51.59010601,1698,29,1727,0,2095,82.43436754
臺中縣,潭子鄉,福仁村,544,749,50,749,50,1498,46,1544,0,1872,82.47863248
臺中縣,潭子鄉,福仁村,545,681,43.73795761,876,56.26204239,1557,27,1584,0,1988,79.67806841
臺中縣,潭子鄉,福仁村,546,602,48.66612773,635,51.33387227,1237,33,1270,0,1582,80.27812895
臺中縣,潭子鄉,福仁村,547,653,43.97306397,832,56.02693603,1485,27,1512,0,1846,81.90682557
臺中縣,潭子鄉,頭家村,548,386,45.95238095,454,54.04761905,840,18,858,0,1011,84.86646884
臺中縣,潭子鄉,頭家村,549,582,39.19191919,903,60.80808081,1485,33,1518,0,1896,80.06329114
臺中縣,潭子鄉,頭家村,550,375,52.08333333,345,47.91666667,720,11,731,0,882,82.87981859
臺中縣,潭子鄉,甘蔗村,557,904,49.64305327,917,50.35694673,1821,33,1854,0,2237,82.87885561
臺中縣,潭子鄉,甘蔗村,558,833,50.57680631,814,49.42319369,1647,19,1666,0,2034,81.90757129
臺中縣,潭子鄉,甘蔗村,559,767,42.54021076,1036,57.45978924,1803,29,1832,0,2237,81.89539562
臺中縣,潭子鄉,東寶村,560,617,64.94736842,333,35.05263158,950,33,983,0,1171,83.94534586
臺中縣,潭子鄉,東寶村,561,455,49.78118162,459,50.21881838,914,27,941,0,1141,82.47151621
臺中縣,潭子鄉,東寶村,562,438,43.75624376,563,56.24375624,1001,15,1016,0,1239,82.00161421
臺中縣,潭子鄉,東寶村,563,804,53.45744681,700,46.54255319,1504,32,1536,0,1799,85.38076709
臺中縣,潭子鄉,東寶村,564,1068,60.37309214,701,39.62690786,1769,49,1818,0,2186,83.16559927
臺中縣,潭子鄉,東寶村,565,584,49.91452991,586,50.08547009,1170,31,1201,0,1459,82.31665524
臺中縣,潭子鄉,大富村,566,955,65.54564173,502,34.45435827,1457,35,1492,0,1770,84.29378531
臺中縣,潭子鄉,大豐村,567,838,57.16234652,628,42.83765348,1466,23,1489,1,1788,83.27740492
臺中縣,潭子鄉,大豐村,568,787,60.86620263,506,39.13379737,1293,28,1321,0,1570,84.14012739
臺中縣,潭子鄉,栗林村,569,692,50.91979397,667,49.08020603,1359,35,1394,0,1676,83.17422434
臺中縣,潭子鄉,栗林村,570,646,63.52015733,371,36.47984267,1017,32,1049,0,1272,82.46855346
臺中縣,潭子鄉,栗林村,571,559,58.47280335,397,41.52719665,956,25,981,0,1173,83.63171355
臺中縣,潭子鄉,嘉仁村,572,855,61.37832017,538,38.62167983,1393,54,1447,0,1688,85.72274882
臺中縣,潭子鄉,嘉仁村,573,626,44.74624732,773,55.25375268,1399,15,1414,0,1680,84.16666667
臺中縣,潭子鄉,新田村,574,703,60.91854419,451,39.08145581,1154,27,1181,0,1453,81.28011012
臺中縣,潭子鄉,聚興村,575,733,63.46320346,422,36.53679654,1155,46,1201,0,1444,83.17174515
臺中縣,潭子鄉,聚興村,576,558,51.28676471,530,48.71323529,1088,38,1126,0,1423,79.12860155
臺中縣,潭子鄉,頭家東村,551,584,42.69005848,784,57.30994152,1368,24,1392,0,1664,83.65384615
臺中縣,潭子鄉,頭家東村,552,535,52.34833659,487,47.65166341,1022,22,1044,0,1259,82.92295473
臺中縣,潭子鄉,家興村,553,580,39.61748634,884,60.38251366,1464,30,1494,0,1916,77.97494781
臺中縣,潭子鄉,家興村,554,708,47.10578842,795,52.89421158,1503,24,1527,0,1906,80.11542497
臺中縣,潭子鄉,家福村,555,629,53.85273973,539,46.14726027,1168,29,1197,0,1482,80.76923077
臺中縣,潭子鄉,家福村,556,529,49.90566038,531,50.09433962,1060,17,1077,0,1315,81.90114068
臺中縣,大雅鄉,大雅村,579,688,45.38258575,828,54.61741425,1516,33,1549,0,1881,82.34981393
臺中縣,大雅鄉,大雅村,580,772,51.88172043,716,48.11827957,1488,20,1508,0,1931,78.09425168
臺中縣,大雅鄉,員林村,599,835,59.13597734,577,40.86402266,1412,23,1435,0,1750,82
臺中縣,大雅鄉,員林村,600,904,54.19664269,764,45.80335731,1668,35,1703,0,2069,82.31029483
臺中縣,大雅鄉,員林村,601,862,47.88888889,938,52.11111111,1800,47,1847,0,2278,81.07989464
臺中縣,大雅鄉,六寶村,602,608,54.09252669,516,45.90747331,1124,24,1148,0,1380,83.1884058
臺中縣,大雅鄉,六寶村,603,269,23.18965517,891,76.81034483,1160,22,1182,0,1470,80.40816327
臺中縣,大雅鄉,六寶村,604,279,31.38357705,610,68.61642295,889,24,913,0,1147,79.59895379
臺中縣,大雅鄉,六寶村,605,627,57.84132841,457,42.15867159,1084,23,1107,0,1349,82.06078577
臺中縣,大雅鄉,秀山村,606,790,58.5618977,559,41.4381023,1349,30,1379,0,1641,84.03412553
臺中縣,大雅鄉,秀山村,607,480,56.80473373,365,43.19526627,845,29,874,0,1045,83.63636364
臺中縣,大雅鄉,忠義村,610,165,12.57621951,1147,87.42378049,1312,35,1347,0,1629,82.68876611
臺中縣,大雅鄉,忠義村,611,264,20.10662605,1049,79.89337395,1313,45,1358,0,1690,80.35502959
臺中縣,大雅鄉,橫山村,608,784,55.25017618,635,44.74982382,1419,40,1459,0,1800,81.05555556
臺中縣,大雅鄉,橫山村,609,661,53.22061192,581,46.77938808,1242,42,1284,0,1581,81.21442125
臺中縣,大雅鄉,三和村,584,972,56.5774156,746,43.4225844,1718,34,1752,0,2146,81.64026095
臺中縣,大雅鄉,三和村,585,680,50.70842655,661,49.29157345,1341,26,1367,0,1678,81.46603099
臺中縣,大雅鄉,西寶村,590,606,59.47006869,413,40.52993131,1019,24,1043,0,1253,83.24022346
臺中縣,大雅鄉,西寶村,591,862,60.66150598,559,39.33849402,1421,37,1458,0,1816,80.28634361
臺中縣,大雅鄉,上楓村,592,767,54.09026798,651,45.90973202,1418,19,1437,0,1744,82.39678899
臺中縣,大雅鄉,上楓村,593,715,51.77407676,666,48.22592324,1381,30,1411,0,1790,78.82681564
臺中縣,大雅鄉,上楓村,594,511,52.7892562,457,47.2107438,968,24,992,0,1279,77.56059421
臺中縣,大雅鄉,上楓村,595,699,57.5308642,516,42.4691358,1215,50,1265,0,1532,82.57180157
臺中縣,大雅鄉,上楓村,596,605,57.02167766,456,42.97832234,1061,31,1092,0,1355,80.5904059
臺中縣,大雅鄉,上楓村,597,482,47.02439024,543,52.97560976,1025,16,1041,0,1234,84.35980551
臺中縣,大雅鄉,上楓村,598,390,41.71122995,545,58.28877005,935,21,956,0,1235,77.40890688
臺中縣,大雅鄉,二和村,586,739,52.11565585,679,47.88434415,1418,22,1440,0,1785,80.67226891
臺中縣,大雅鄉,二和村,587,735,47.8515625,801,52.1484375,1536,31,1567,0,1923,81.48725949
臺中縣,大雅鄉,四德村,588,475,43.69825207,612,56.30174793,1087,10,1097,0,1347,81.44023756
臺中縣,大雅鄉,四德村,589,733,52.80979827,655,47.19020173,1388,25,1413,0,1751,80.69674472
臺中縣,大雅鄉,上雅村,577,729,47.77195282,797,52.22804718,1526,20,1546,0,1949,79.3227296
臺中縣,大雅鄉,上雅村,578,799,53.69623656,689,46.30376344,1488,32,1520,0,1857,81.85245019
臺中縣,大雅鄉,文雅村,581,504,38.41463415,808,61.58536585,1312,32,1344,0,1711,78.55055523
臺中縣,大雅鄉,文雅村,582,546,44.06779661,693,55.93220339,1239,21,1260,0,1498,84.11214953
臺中縣,大雅鄉,文雅村,583,495,50.97837281,476,49.02162719,971,24,995,0,1271,78.28481511
臺中縣,新社鄉,新社村,612,533,49.07918969,553,50.92081031,1086,33,1119,0,1330,84.13533835
臺中縣,新社鄉,新社村,613,529,44.15692821,669,55.84307179,1198,29,1227,0,1484,82.6819407
臺中縣,新社鄉,復盛村,614,574,43.85026738,735,56.14973262,1309,66,1375,0,1747,78.70635375
臺中縣,新社鄉,中正村,615,524,52.87588295,467,47.12411705,991,46,1037,0,1236,83.89967638
臺中縣,新社鄉,月湖村,616,414,56.71232877,316,43.28767123,730,27,757,0,911,83.09549945
臺中縣,新社鄉,崑山村,617,620,65.19453207,331,34.80546793,951,36,987,0,1205,81.90871369
臺中縣,新社鄉,大南村,618,752,49.50625411,767,50.49374589,1519,53,1572,0,1948,80.69815195
臺中縣,新社鄉,永源村,619,873,56.57809462,670,43.42190538,1543,57,1600,0,1939,82.51676122
臺中縣,新社鄉,永源村,620,426,73.95833333,150,26.04166667,576,18,594,0,707,84.01697313
臺中縣,新社鄉,中興村,621,91,14.21875,549,85.78125,640,26,666,0,809,82.32385661
臺中縣,新社鄉,協成村,622,544,56.37305699,421,43.62694301,965,36,1001,0,1216,82.31907895
臺中縣,新社鄉,協成村,623,642,60,428,40,1070,56,1126,0,1380,81.5942029
臺中縣,新社鄉,東興村,624,475,47.07631318,534,52.92368682,1009,45,1054,0,1274,82.73155416
臺中縣,新社鄉,慶西村,625,82,40.19607843,122,59.80392157,204,10,214,1,251,85.25896414
臺中縣,新社鄉,慶西村,626,322,65.98360656,166,34.01639344,488,27,515,0,641,80.34321373
臺中縣,新社鄉,中和村,627,160,35.01094092,297,64.98905908,457,17,474,0,587,80.74957411
臺中縣,新社鄉,福興村,628,409,56.33608815,317,43.66391185,726,55,781,0,1005,77.71144279
臺中縣,新社鄉,福興村,629,76,36.53846154,132,63.46153846,208,2,210,0,262,80.15267176
臺中縣,石岡鄉,石岡村,630,450,52.69320843,404,47.30679157,854,30,884,0,1058,83.55387524
臺中縣,石岡鄉,萬安村,631,525,53.46232179,457,46.53767821,982,26,1008,0,1160,86.89655172
臺中縣,石岡鄉,九房村,632,374,45.33333333,451,54.66666667,825,29,854,0,1047,81.56638013
臺中縣,石岡鄉,金星村,633,527,55.41535226,424,44.58464774,951,47,998,0,1212,82.34323432
臺中縣,石岡鄉,龍興村,634,288,52.65082267,259,47.34917733,547,13,560,0,679,82.4742268
臺中縣,石岡鄉,萬興村,635,564,50.76507651,547,49.23492349,1111,31,1142,0,1351,84.52997779
臺中縣,石岡鄉,梅子村,636,712,52.85820341,635,47.14179659,1347,47,1394,0,1724,80.85846868
臺中縣,石岡鄉,土牛村,637,323,44.49035813,403,55.50964187,726,28,754,0,929,81.16254037
臺中縣,石岡鄉,德興村,638,415,41.37587238,588,58.62412762,1003,37,1040,1,1268,82.01892744
臺中縣,石岡鄉,和盛村,639,341,34.83146067,638,65.16853933,979,19,998,0,1210,82.47933884
臺中縣,外埔鄉,永豐村,640,386,48.31038798,413,51.68961202,799,10,809,0,993,81.47029204
臺中縣,外埔鄉,六分村,641,513,42.04918033,707,57.95081967,1220,33,1253,0,1531,81.84193338
臺中縣,外埔鄉,三崁村,648,583,45.51131928,698,54.48868072,1281,51,1332,0,1694,78.63046045
臺中縣,外埔鄉,大同村,642,418,43.76963351,537,56.23036649,955,20,975,0,1192,81.79530201
臺中縣,外埔鄉,大同村,643,418,47.33861835,465,52.66138165,883,26,909,0,1131,80.37135279
臺中縣,外埔鄉,大同村,644,376,40.38668099,555,59.61331901,931,23,954,0,1183,80.64243449
臺中縣,外埔鄉,水美村,649,582,44.70046083,720,55.29953917,1302,31,1333,0,1686,79.0628707
臺中縣,外埔鄉,水美村,650,429,46.37837838,496,53.62162162,925,24,949,0,1189,79.81497056
臺中縣,外埔鄉,大東村,645,460,42.79069767,615,57.20930233,1075,39,1114,0,1407,79.17555082
臺中縣,外埔鄉,大東村,646,560,44.7284345,692,55.2715655,1252,40,1292,0,1596,80.95238095
臺中縣,外埔鄉,大東村,647,598,46.90196078,677,53.09803922,1275,33,1308,0,1656,78.98550725
臺中縣,外埔鄉,馬鳴村,654,483,46.71179884,551,53.28820116,1034,40,1074,0,1339,80.20911128
臺中縣,外埔鄉,中山村,653,341,42.78544542,456,57.21455458,797,24,821,0,1038,79.09441233
臺中縣,外埔鄉,鐵山村,651,304,43.18181818,400,56.81818182,704,31,735,0,952,77.20588235
臺中縣,外埔鄉,鐵山村,652,388,46.74698795,442,53.25301205,830,54,884,0,1105,80
臺中縣,外埔鄉,土城村,655,724,57.87370104,527,42.12629896,1251,57,1308,0,1571,83.25907066
臺中縣,外埔鄉,部子村,656,472,52.09713024,434,47.90286976,906,40,946,0,1205,78.50622407
臺中縣,大安鄉,南埔村,657,523,61.16959064,332,38.83040936,855,26,881,0,1077,81.80129991
臺中縣,大安鄉,南庄村,658,539,61.67048055,335,38.32951945,874,26,900,0,1114,80.78994614
臺中縣,大安鄉,中庄村,659,450,53.12868949,397,46.87131051,847,28,875,0,1138,76.88927944
臺中縣,大安鄉,中庄村,660,501,52.02492212,462,47.97507788,963,13,976,0,1250,78.08
臺中縣,大安鄉,龜殼村,663,331,48.25072886,355,51.74927114,686,21,707,0,835,84.67065868
臺中縣,大安鄉,龜殼村,664,300,53.19148936,264,46.80851064,564,28,592,0,739,80.1082544
臺中縣,大安鄉,福興村,662,519,60.27874564,342,39.72125436,861,42,903,0,1157,78.04667243
臺中縣,大安鄉,東安村,661,473,49.06639004,491,50.93360996,964,23,987,0,1200,82.25
臺中縣,大安鄉,頂安村,665,377,56.18479881,294,43.81520119,671,30,701,0,875,80.11428571
臺中縣,大安鄉,永安村,666,496,56.29965948,385,43.70034052,881,29,910,0,1119,81.32260947
臺中縣,大安鄉,永安村,667,179,41.43518519,253,58.56481481,432,17,449,0,530,84.71698113
臺中縣,大安鄉,福住村,668,393,50.97276265,378,49.02723735,771,35,806,0,989,81.49646107
臺中縣,大安鄉,海墘村,669,409,39.63178295,623,60.36821705,1032,33,1065,0,1362,78.1938326
臺中縣,大安鄉,西安村,670,607,57.69961977,445,42.30038023,1052,58,1110,0,1378,80.55152395
臺中縣,大安鄉,松雅村,671,367,58.43949045,261,41.56050955,628,11,639,0,768,83.203125
臺中縣,烏日鄉,烏日村,672,648,55.86206897,512,44.13793103,1160,22,1182,0,1390,85.03597122
臺中縣,烏日鄉,烏日村,673,702,56.98051948,530,43.01948052,1232,19,1251,0,1516,82.51978892
臺中縣,烏日鄉,烏日村,674,574,53.99811853,489,46.00188147,1063,24,1087,1,1395,77.92114695
臺中縣,烏日鄉,烏日村,675,603,46.74418605,687,53.25581395,1290,34,1324,0,1527,86.7059594
臺中縣,烏日鄉,湖日村,676,548,58.54700855,388,41.45299145,936,26,962,0,1160,82.93103448
臺中縣,烏日鄉,湖日村,677,373,49.53519256,380,50.46480744,753,13,766,0,980,78.16326531
臺中縣,烏日鄉,三和村,678,699,53.35877863,611,46.64122137,1310,43,1353,0,1638,82.6007326
臺中縣,烏日鄉,三和村,679,385,27.89855072,995,72.10144928,1380,62,1442,0,1724,83.64269142
臺中縣,烏日鄉,榮泉村,680,562,46.17912901,655,53.82087099,1217,29,1246,0,1459,85.40095956
臺中縣,烏日鄉,榮泉村,681,376,43.873979,481,56.126021,857,22,879,0,1064,82.61278195
臺中縣,烏日鄉,學田村,682,371,44.91525424,455,55.08474576,826,27,853,0,1040,82.01923077
臺中縣,烏日鄉,學田村,683,339,45.13981358,412,54.86018642,751,33,784,0,938,83.58208955
臺中縣,烏日鄉,九德村,684,676,46.08043626,791,53.91956374,1467,28,1495,0,1791,83.47292016
臺中縣,烏日鄉,九德村,685,667,49.37083642,684,50.62916358,1351,27,1378,0,1695,81.2979351
臺中縣,烏日鄉,九德村,686,620,49.95970991,621,50.04029009,1241,18,1259,0,1557,80.86062942
臺中縣,烏日鄉,九德村,687,712,55.40856031,573,44.59143969,1285,22,1307,0,1543,84.7051199
臺中縣,烏日鄉,九德村,688,686,54.01574803,584,45.98425197,1270,12,1282,0,1503,85.29607452
臺中縣,烏日鄉,九德村,689,630,54.40414508,528,45.59585492,1158,21,1179,0,1482,79.55465587
臺中縣,烏日鄉,仁德村,690,706,51.19651922,673,48.80348078,1379,26,1405,0,1723,81.54381892
臺中縣,烏日鄉,仁德村,691,631,46.46539028,727,53.53460972,1358,27,1385,0,1673,82.78541542
臺中縣,烏日鄉,仁德村,692,693,44.97079818,848,55.02920182,1541,22,1563,0,1887,82.82988871
臺中縣,烏日鄉,前竹村,693,512,61.09785203,326,38.90214797,838,23,861,0,1016,84.74409449
臺中縣,烏日鄉,前竹村,694,564,63.87315968,319,36.12684032,883,22,905,0,1056,85.70075758
臺中縣,烏日鄉,五光村,695,612,52.39726027,556,47.60273973,1168,37,1205,0,1473,81.80583842
臺中縣,烏日鄉,光明村,696,439,60.63535912,285,39.36464088,724,21,745,0,883,84.37146093
臺中縣,烏日鄉,光明村,697,506,55.36105033,408,44.63894967,914,25,939,0,1128,83.24468085
臺中縣,烏日鄉,東園村,698,748,56.49546828,576,43.50453172,1324,46,1370,0,1672,81.93779904
臺中縣,烏日鄉,溪埧村,699,745,50.33783784,735,49.66216216,1480,25,1505,0,1774,84.83652762
臺中縣,烏日鄉,溪埧村,700,838,56.81355932,637,43.18644068,1475,35,1510,0,1827,82.64915161
臺中縣,烏日鄉,螺潭村,701,702,56.29510826,545,43.70489174,1247,45,1292,0,1532,84.33420366
臺中縣,烏日鄉,北里村,702,665,59.64125561,450,40.35874439,1115,46,1161,0,1406,82.57467994
臺中縣,烏日鄉,南里村,703,491,56.05022831,385,43.94977169,876,21,897,0,1081,82.9787234
臺中縣,烏日鄉,溪尾村,704,339,57.07070707,255,42.92929293,594,30,624,0,812,76.84729064
臺中縣,大肚鄉,王田村,705,837,57.44680851,620,42.55319149,1457,40,1497,0,1831,81.75860186
臺中縣,大肚鄉,王田村,706,783,54.33726579,658,45.66273421,1441,38,1479,0,1829,80.86386003
臺中縣,大肚鄉,中和村,707,387,58.4592145,275,41.5407855,662,19,681,0,798,85.33834586
臺中縣,大肚鄉,福山村,708,475,56.41330166,367,43.58669834,842,27,869,0,1051,82.6831589
臺中縣,大肚鄉,福山村,709,468,50.81433225,453,49.18566775,921,19,940,0,1123,83.70436331
臺中縣,大肚鄉,福山村,710,443,49.71941639,448,50.28058361,891,23,914,0,1080,84.62962963
臺中縣,大肚鄉,營埔村,711,526,50.04757374,525,49.95242626,1051,29,1080,1,1292,83.59133127
臺中縣,大肚鄉,社腳村,712,401,43.96929825,511,56.03070175,912,27,939,0,1092,85.98901099
臺中縣,大肚鄉,社腳村,713,440,47.56756757,485,52.43243243,925,18,943,0,1166,80.87478559
臺中縣,大肚鄉,新興村,714,425,45.69892473,505,54.30107527,930,16,946,0,1176,80.44217687
臺中縣,大肚鄉,新興村,715,397,45.63218391,473,54.36781609,870,18,888,0,1130,78.5840708
臺中縣,大肚鄉,大東村,716,519,46.88346883,588,53.11653117,1107,20,1127,0,1364,82.62463343
臺中縣,大肚鄉,大東村,717,499,49.5531281,508,50.4468719,1007,23,1030,0,1225,84.08163265
臺中縣,大肚鄉,大肚村,718,300,44.70938897,371,55.29061103,671,15,686,0,827,82.95042322
臺中縣,大肚鄉,大肚村,719,365,44.51219512,455,55.48780488,820,9,829,0,1000,82.9
臺中縣,大肚鄉,永和村,720,338,50,338,50,676,11,687,0,845,81.30177515
臺中縣,大肚鄉,磺溪村,721,487,46.5583174,559,53.4416826,1046,33,1079,0,1329,81.18886381
臺中縣,大肚鄉,永順村,722,663,55.38847118,534,44.61152882,1197,42,1239,0,1476,83.94308943
臺中縣,大肚鄉,成功村,723,356,50.21156559,353,49.78843441,709,28,737,0,891,82.71604938
臺中縣,大肚鄉,山陽村,724,583,54.48598131,487,45.51401869,1070,42,1112,2,1344,82.73809524
臺中縣,大肚鄉,頂街村,725,620,51.40961857,586,48.59038143,1206,34,1240,0,1576,78.68020305
臺中縣,大肚鄉,頂街村,726,624,45.94992636,734,54.05007364,1358,20,1378,1,1696,81.25
臺中縣,大肚鄉,頂街村,727,587,43.32103321,768,56.67896679,1355,20,1375,0,1605,85.66978193
臺中縣,大肚鄉,瑞井村,728,605,57.78414518,442,42.21585482,1047,24,1071,0,1330,80.52631579
臺中縣,大肚鄉,瑞井村,729,566,52.31053604,516,47.68946396,1082,26,1108,0,1364,81.23167155
臺中縣,大肚鄉,瑞井村,730,419,45.39544962,504,54.60455038,923,14,937,0,1200,78.08333333
臺中縣,大肚鄉,蔗部村,731,811,61.579347,506,38.420653,1317,39,1356,0,1685,80.47477745
臺中縣,大肚鄉,蔗部村,732,741,52.74021352,664,47.25978648,1405,37,1442,0,1825,79.01369863
臺中縣,大肚鄉,自強村,733,568,54.72061657,470,45.27938343,1038,21,1059,0,1291,82.02943455
臺中縣,大肚鄉,自強村,734,343,25.23914643,1016,74.76085357,1359,27,1386,0,1664,83.29326923
臺中縣,龍井鄉,竹坑村,735,533,51.39826422,504,48.60173578,1037,25,1062,0,1312,80.94512195
臺中縣,龍井鄉,竹坑村,736,341,46.26865672,396,53.73134328,737,10,747,0,932,80.15021459
臺中縣,龍井鄉,龍東村,737,511,51.72064777,477,48.27935223,988,25,1013,0,1270,79.76377953
臺中縣,龍井鄉,龍東村,738,442,47.99131379,479,52.00868621,921,23,944,0,1159,81.44952545
臺中縣,龍井鄉,龍西村,739,613,46.19442351,714,53.80557649,1327,42,1369,0,1643,83.32318929
臺中縣,龍井鄉,田中村,740,585,53.91705069,500,46.08294931,1085,37,1122,0,1370,81.89781022
臺中縣,龍井鄉,田中村,741,523,54.53597497,436,45.46402503,959,16,975,0,1210,80.5785124
臺中縣,龍井鄉,福田村,742,345,46.875,391,53.125,736,31,767,0,998,76.85370741
臺中縣,龍井鄉,麗水村,743,344,39.44954128,528,60.55045872,872,31,903,0,1138,79.34973638
臺中縣,龍井鄉,麗水村,744,332,50.6870229,323,49.3129771,655,15,670,1,826,81.11380145
臺中縣,龍井鄉,龍津村,745,567,51.1732852,541,48.8267148,1108,27,1135,0,1427,79.53749124
臺中縣,龍井鄉,龍津村,746,503,49.55665025,512,50.44334975,1015,41,1056,3,1282,82.37129485
臺中縣,龍井鄉,龍津村,747,311,56.13718412,243,43.86281588,554,14,568,0,712,79.7752809
臺中縣,龍井鄉,龍津村,748,502,78.31513261,139,21.68486739,641,15,656,0,845,77.63313609
臺中縣,龍井鄉,三德村,749,592,54.31192661,498,45.68807339,1090,35,1125,0,1433,78.50662945
臺中縣,龍井鄉,三德村,750,518,62.86407767,306,37.13592233,824,21,845,0,1067,79.19400187
臺中縣,龍井鄉,忠和村,751,562,59.78723404,378,40.21276596,940,28,968,0,1183,81.82586644
臺中縣,龍井鄉,忠和村,752,567,53.49056604,493,46.50943396,1060,33,1093,0,1392,78.52011494
臺中縣,龍井鄉,忠和村,753,662,64.02321083,372,35.97678917,1034,33,1067,0,1292,82.58513932
臺中縣,龍井鄉,山腳村,754,408,52.37483954,371,47.62516046,779,21,800,0,1017,78.66273353
臺中縣,龍井鄉,山腳村,755,615,53.75874126,529,46.24125874,1144,34,1178,0,1516,77.70448549
臺中縣,龍井鄉,山腳村,756,612,55.9926807,481,44.0073193,1093,18,1111,0,1393,79.75592247
臺中縣,龍井鄉,龍泉村,757,438,47.1474704,491,52.8525296,929,20,949,0,1170,81.11111111
臺中縣,龍井鄉,龍泉村,758,568,58.55670103,402,41.44329897,970,25,995,0,1279,77.79515246
臺中縣,龍井鄉,龍泉村,759,392,43.75,504,56.25,896,21,917,1,1140,80.43859649
臺中縣,龍井鄉,龍泉村,760,233,39.82905983,352,60.17094017,585,22,607,0,791,76.73830594
臺中縣,龍井鄉,龍崗村,761,554,55.23429711,449,44.76570289,1003,26,1029,0,1305,78.85057471
臺中縣,龍井鄉,龍崗村,762,351,55.01567398,287,44.98432602,638,13,651,0,781,83.3546735
臺中縣,龍井鄉,新庄村,763,636,56.23342175,495,43.76657825,1131,43,1174,0,1485,79.05723906
臺中縣,龍井鄉,新庄村,764,603,51.10169492,577,48.89830508,1180,32,1212,0,1558,77.79204108
臺中縣,龍井鄉,新庄村,765,629,49.72332016,636,50.27667984,1265,36,1301,0,1616,80.50742574
臺中縣,龍井鄉,南寮村,766,640,57.70964833,469,42.29035167,1109,51,1160,0,1362,85.16886931
臺中縣,龍井鄉,新東村,771,618,50.20308692,613,49.79691308,1231,28,1259,0,1584,79.48232323
臺中縣,龍井鄉,新東村,772,606,47.01318852,683,52.98681148,1289,24,1313,0,1654,79.38331318
臺中縣,龍井鄉,東海村,767,460,34.61249059,869,65.38750941,1329,19,1348,0,1692,79.66903073
臺中縣,龍井鄉,東海村,768,501,46.09015639,586,53.90984361,1087,22,1109,0,1341,82.699478
臺中縣,龍井鄉,東海村,769,535,38.68402025,848,61.31597975,1383,13,1396,0,1739,80.2760207
臺中縣,龍井鄉,東海村,770,259,37.37373737,434,62.62626263,693,9,702,0,879,79.86348123
臺中縣,霧峰鄉,桐林村,773,511,56.03070175,401,43.96929825,912,27,939,0,1143,82.15223097
臺中縣,霧峰鄉,吉峰村,774,679,50.63385533,662,49.36614467,1341,13,1354,0,1658,81.66465621
臺中縣,霧峰鄉,吉峰村,775,624,53.88601036,534,46.11398964,1158,24,1182,1,1498,78.90520694
臺中縣,霧峰鄉,吉峰村,776,456,46.62576687,522,53.37423313,978,22,1000,0,1239,80.7102502
臺中縣,霧峰鄉,吉峰村,777,577,45.90294352,680,54.09705648,1257,27,1284,0,1598,80.35043805
臺中縣,霧峰鄉,吉峰村,778,588,49.57841484,598,50.42158516,1186,24,1210,0,1483,81.59136885
臺中縣,霧峰鄉,甲寅村,779,594,49.83221477,598,50.16778523,1192,23,1215,1,1465,82.93515358
臺中縣,霧峰鄉,甲寅村,780,499,45.40491356,600,54.59508644,1099,24,1123,0,1401,80.15703069
臺中縣,霧峰鄉,甲寅村,781,453,50.67114094,441,49.32885906,894,25,919,0,1140,80.61403509
臺中縣,霧峰鄉,本鄉村,782,779,52.31699127,710,47.68300873,1489,27,1516,0,1826,83.0230011
臺中縣,霧峰鄉,中正村,783,591,46.24413146,687,53.75586854,1278,23,1301,1,1546,84.15265201
臺中縣,霧峰鄉,錦榮村,784,374,47.70408163,410,52.29591837,784,16,800,0,942,84.92569002
臺中縣,霧峰鄉,萊園村,785,428,49.47976879,437,50.52023121,865,21,886,0,1071,82.7264239
臺中縣,霧峰鄉,本堂村,786,574,43.98467433,731,56.01532567,1305,26,1331,0,1660,80.18072289
臺中縣,霧峰鄉,本堂村,787,610,45.48844146,731,54.51155854,1341,39,1380,1,1733,79.63069821
臺中縣,霧峰鄉,本堂村,788,563,46.99499165,635,53.00500835,1198,25,1223,1,1476,82.85907859
臺中縣,霧峰鄉,坑口村,804,329,38.66039953,522,61.33960047,851,16,867,0,1021,84.91674829
臺中縣,霧峰鄉,坑口村,805,390,54.62184874,324,45.37815126,714,29,743,0,950,78.21052632
臺中縣,霧峰鄉,坑口村,806,218,29.78142077,514,70.21857923,732,14,746,0,904,82.52212389
臺中縣,霧峰鄉,北柳村,789,595,48.06138934,643,51.93861066,1238,35,1273,0,1499,84.92328219
臺中縣,霧峰鄉,北柳村,790,730,57.38993711,542,42.61006289,1272,29,1301,0,1554,83.71943372
臺中縣,霧峰鄉,南柳村,791,628,54.46660885,525,45.53339115,1153,41,1194,0,1428,83.61344538
臺中縣,霧峰鄉,四德村,792,493,59.61305925,334,40.38694075,827,34,861,0,1020,84.41176471
臺中縣,霧峰鄉,四德村,793,492,60.89108911,316,39.10891089,808,7,815,0,984,82.82520325
臺中縣,霧峰鄉,五福村,794,460,49.67602592,466,50.32397408,926,34,960,0,1147,83.69659983
臺中縣,霧峰鄉,五福村,795,565,56.21890547,440,43.78109453,1005,38,1043,0,1237,84.31689572
臺中縣,霧峰鄉,萬豐村,800,602,60.68548387,390,39.31451613,992,31,1023,1,1238,82.63327948
臺中縣,霧峰鄉,萬豐村,801,513,56.00436681,403,43.99563319,916,22,938,0,1165,80.51502146
臺中縣,霧峰鄉,舊正村,802,448,52.70588235,402,47.29411765,850,35,885,0,1074,82.40223464
臺中縣,霧峰鄉,舊正村,803,426,58.59697387,301,41.40302613,727,27,754,0,926,81.42548596
臺中縣,霧峰鄉,峰谷村,807,469,58.26086957,336,41.73913043,805,21,826,0,1036,79.72972973
臺中縣,霧峰鄉,六股村,808,645,64.05163853,362,35.94836147,1007,38,1045,0,1239,84.34221146
臺中縣,霧峰鄉,六股村,809,464,59.64010283,314,40.35989717,778,24,802,0,951,84.33228181
臺中縣,霧峰鄉,丁臺村,796,547,63.53077816,314,36.46922184,861,27,888,0,1015,87.48768473
臺中縣,霧峰鄉,丁臺村,797,493,65.64580559,258,34.35419441,751,35,786,0,922,85.2494577
臺中縣,霧峰鄉,北勢村,798,663,49.66292135,672,50.33707865,1335,51,1386,0,1662,83.39350181
臺中縣,霧峰鄉,南勢村,799,501,54.27952329,422,45.72047671,923,26,949,0,1162,81.66953528
臺中縣,和平鄉,南勢村,810,70,62.5,42,37.5,112,4,116,0,153,75.81699346
臺中縣,和平鄉,南勢村,811,275,47.90940767,299,52.09059233,574,25,599,0,791,75.72692794
臺中縣,和平鄉,南勢村,812,189,31.60535117,409,68.39464883,598,22,620,0,795,77.98742138
臺中縣,和平鄉,天輪村,813,144,42.10526316,198,57.89473684,342,17,359,0,485,74.02061856
臺中縣,和平鄉,博愛村,814,229,28.37670384,578,71.62329616,807,10,817,0,1067,76.56982193
臺中縣,和平鄉,博愛村,815,142,31.55555556,308,68.44444444,450,10,460,0,572,80.41958042
臺中縣,和平鄉,中坑村,821,126,42.28187919,172,57.71812081,298,8,306,0,376,81.38297872
臺中縣,和平鄉,自由村,816,49,29.16666667,119,70.83333333,168,6,174,0,229,75.98253275
臺中縣,和平鄉,自由村,817,68,21.93548387,242,78.06451613,310,6,316,0,408,77.45098039
臺中縣,和平鄉,自由村,818,44,19.55555556,181,80.44444444,225,10,235,0,310,75.80645161
臺中縣,和平鄉,達觀村,819,164,31.47792706,357,68.52207294,521,15,536,0,694,77.23342939
臺中縣,和平鄉,達觀村,820,36,14.63414634,210,85.36585366,246,2,248,0,294,84.3537415
臺中縣,和平鄉,梨山村,822,50,27.32240437,133,72.67759563,183,2,185,0,325,56.92307692
臺中縣,和平鄉,梨山村,823,174,26.5648855,481,73.4351145,655,20,675,0,1082,62.3844732
臺中縣,和平鄉,梨山村,824,12,9.677419355,112,90.32258065,124,5,129,0,257,50.19455253
臺中縣,和平鄉,梨山村,825,29,18.125,131,81.875,160,0,160,0,251,63.74501992
臺中縣,和平鄉,平等村,826,15,12.5,105,87.5,120,1,121,0,206,58.73786408
臺中縣,和平鄉,平等村,827,78,19.21182266,328,80.78817734,406,3,409,0,577,70.88388215
彰化縣,彰化市,文化里,79,562,48.07527802,607,51.92472198,1169,32,1201,0,1452,82.71349862
彰化縣,彰化市,下部里,84,932,47.30964467,1038,52.69035533,1970,33,2003,0,2439,82.12382124
彰化縣,彰化市,下部里,85,484,48.01587302,524,51.98412698,1008,24,1032,0,1247,82.75862069
彰化縣,彰化市,興北里,76,671,53.85232745,575,46.14767255,1246,22,1268,0,1540,82.33766234
彰化縣,彰化市,信義里,77,408,54.0397351,347,45.9602649,755,19,774,0,944,81.99152542
彰化縣,彰化市,民生里,78,578,49.35952178,593,50.64047822,1171,15,1186,0,1448,81.90607735
彰化縣,彰化市,陽明里,80,353,52.21893491,323,47.78106509,676,12,688,0,830,82.89156627
彰化縣,彰化市,陽明里,81,361,49.72451791,365,50.27548209,726,24,750,0,910,82.41758242
彰化縣,彰化市,萬安里,82,684,46.81724846,777,53.18275154,1461,31,1492,0,1765,84.5325779
彰化縣,彰化市,萬安里,83,752,48.99022801,783,51.00977199,1535,26,1561,0,1939,80.50541516
彰化縣,彰化市,新興里,71,500,50.30181087,494,49.69818913,994,22,1016,0,1241,81.86946011
彰化縣,彰化市,新興里,72,608,49.23076923,627,50.76923077,1235,30,1265,0,1516,83.44327177
彰化縣,彰化市,新興里,73,521,48.24074074,559,51.75925926,1080,17,1097,0,1305,84.06130268
彰化縣,彰化市,新華里,74,339,49.63396779,344,50.36603221,683,20,703,0,853,82.41500586
彰化縣,彰化市,新華里,75,385,49.74160207,389,50.25839793,774,16,790,0,960,82.29166667
彰化縣,彰化市,龍山里,16,346,38.2320442,559,61.7679558,905,23,928,0,1103,84.13417951
彰化縣,彰化市,龍山里,17,389,42.19088937,533,57.80911063,922,14,936,0,1126,83.12611012
彰化縣,彰化市,中山里,15,286,42.81437126,382,57.18562874,668,14,682,0,810,84.19753086
彰化縣,彰化市,中正里,14,608,51.83290708,565,48.16709292,1173,15,1188,0,1429,83.13505948
彰化縣,彰化市,永福里,12,424,55.64304462,338,44.35695538,762,26,788,0,933,84.45873526
彰化縣,彰化市,光復里,11,339,55.48281506,272,44.51718494,611,14,625,0,760,82.23684211
彰化縣,彰化市,光華里,13,384,57.22801788,287,42.77198212,671,9,680,0,808,84.15841584
彰化縣,彰化市,萬壽里,45,468,58.86792453,327,41.13207547,795,9,804,0,982,81.87372709
彰化縣,彰化市,中央里,42,428,57.83783784,312,42.16216216,740,11,751,0,909,82.61826183
彰化縣,彰化市,富貴里,43,444,55.2238806,360,44.7761194,804,16,820,0,992,82.66129032
彰化縣,彰化市,民權里,44,519,51.28458498,493,48.71541502,1012,22,1034,0,1226,84.33931485
彰化縣,彰化市,西興里,46,399,56.59574468,306,43.40425532,705,18,723,0,871,83.00803674
彰化縣,彰化市,西興里,47,559,46.97478992,631,53.02521008,1190,27,1217,0,1501,81.07928048
彰化縣,彰化市,西勢里,49,463,45.75098814,549,54.24901186,1012,19,1031,0,1256,82.08598726
彰化縣,彰化市,西勢里,50,538,50.37453184,530,49.62546816,1068,18,1086,0,1308,83.02752294
彰化縣,彰化市,忠孝里,53,485,51.70575693,453,48.29424307,938,16,954,0,1162,82.09982788
彰化縣,彰化市,忠權里,51,449,44.67661692,556,55.32338308,1005,14,1019,0,1270,80.23622047
彰化縣,彰化市,忠權里,52,494,43.87211368,632,56.12788632,1126,19,1145,0,1376,83.2122093
彰化縣,彰化市,五權里,54,674,49.74169742,681,50.25830258,1355,25,1380,0,1704,80.98591549
彰化縣,彰化市,五權里,55,603,48.5898469,638,51.4101531,1241,23,1264,0,1590,79.49685535
彰化縣,彰化市,長樂里,48,588,57.87401575,428,42.12598425,1016,28,1044,0,1209,86.35235732
彰化縣,彰化市,東芳里,67,503,48.59903382,532,51.40096618,1035,25,1060,0,1313,80.73115004
彰化縣,彰化市,東芳里,68,634,52.22405272,580,47.77594728,1214,30,1244,0,1554,80.05148005
彰化縣,彰化市,南安里,66,722,51.09695683,691,48.90304317,1413,43,1456,0,1779,81.84373243
彰化縣,彰化市,南美里,65,629,52.81276238,562,47.18723762,1191,33,1224,0,1501,81.54563624
彰化縣,彰化市,莿桐里,63,465,47.88877446,506,52.11122554,971,21,992,0,1211,81.91577209
彰化縣,彰化市,莿桐里,64,527,49.48356808,538,50.51643192,1065,20,1085,0,1294,83.84853168
彰化縣,彰化市,磚窯里,69,481,52.05627706,443,47.94372294,924,20,944,0,1188,79.46127946
彰化縣,彰化市,磚窯里,70,621,51.19538335,592,48.80461665,1213,41,1254,0,1530,81.96078431
彰化縣,彰化市,平和里,56,650,48.87218045,680,51.12781955,1330,32,1362,0,1674,81.36200717
彰化縣,彰化市,平和里,57,730,49.05913978,758,50.94086022,1488,32,1520,0,1865,81.50134048
彰化縣,彰化市,桃源里,1,497,50.71428571,483,49.28571429,980,39,1019,0,1248,81.65064103
彰化縣,彰化市,桃源里,2,432,37.89473684,708,62.10526316,1140,36,1176,0,1509,77.93240557
彰化縣,彰化市,卦山里,9,404,47.41784038,448,52.58215962,852,19,871,0,1044,83.42911877
彰化縣,彰化市,卦山里,10,373,34.79477612,699,65.20522388,1072,16,1088,0,1308,83.18042813
彰化縣,彰化市,東興里,3,654,50.26902383,647,49.73097617,1301,22,1323,0,1599,82.73921201
彰化縣,彰化市,大同里,7,482,58.07228916,348,41.92771084,830,19,849,0,1032,82.26744186
彰化縣,彰化市,永生里,8,589,52.9676259,523,47.0323741,1112,33,1145,0,1392,82.25574713
彰化縣,彰化市,華陽里,5,271,33.62282878,535,66.37717122,806,21,827,0,1010,81.88118812
彰化縣,彰化市,華陽里,6,401,46.95550351,453,53.04449649,854,22,876,0,1109,78.99008115
彰化縣,彰化市,華北里,4,596,49.25619835,614,50.74380165,1210,18,1228,0,1528,80.36649215
彰化縣,彰化市,南瑤里,32,718,54.39393939,602,45.60606061,1320,27,1347,0,1580,85.25316456
彰化縣,彰化市,南瑤里,33,678,50.29673591,670,49.70326409,1348,21,1369,0,1694,80.81463991
彰化縣,彰化市,南瑤里,34,630,47.40406321,699,52.59593679,1329,24,1353,0,1694,79.87012987
彰化縣,彰化市,南瑤里,35,607,49.47025265,620,50.52974735,1227,19,1246,0,1526,81.65137615
彰化縣,彰化市,成功里,36,599,49.38169827,614,50.61830173,1213,34,1247,0,1478,84.37077131
彰化縣,彰化市,延和里,27,747,51.02459016,717,48.97540984,1464,13,1477,0,1788,82.60626398
彰化縣,彰化市,延和里,28,818,54.53333333,682,45.46666667,1500,27,1527,0,1805,84.59833795
彰化縣,彰化市,南興里,29,717,50.13986014,713,49.86013986,1430,17,1447,0,1724,83.93271462
彰化縣,彰化市,南興里,30,631,46.94940476,713,53.05059524,1344,27,1371,0,1713,80.03502627
彰化縣,彰化市,南興里,31,689,49.89138306,692,50.10861694,1381,31,1412,0,1706,82.76670574
彰化縣,彰化市,西安里,38,550,50.27422303,544,49.72577697,1094,21,1115,0,1365,81.68498168
彰化縣,彰化市,西安里,39,606,54.2039356,512,45.7960644,1118,31,1149,0,1402,81.95435093
彰化縣,彰化市,彰安里,40,626,53.41296928,546,46.58703072,1172,23,1195,2,1441,82.92852186
彰化縣,彰化市,彰安里,41,662,51.92156863,613,48.07843137,1275,29,1304,0,1579,82.58391387
彰化縣,彰化市,光南里,20,567,50,567,50,1134,28,1162,0,1395,83.29749104
彰化縣,彰化市,介壽里,21,252,30.28846154,580,69.71153846,832,19,851,0,1021,83.3496572
彰化縣,彰化市,介壽里,22,319,46.36627907,369,53.63372093,688,19,707,0,1111,63.63636364
彰化縣,彰化市,延平里,23,596,48.45528455,634,51.54471545,1230,24,1254,0,1497,83.76753507
彰化縣,彰化市,延平里,24,582,44.94208494,713,55.05791506,1295,23,1318,0,1614,81.66047088
彰化縣,彰化市,延平里,25,641,51.19808307,611,48.80191693,1252,24,1276,0,1563,81.63787588
彰化縣,彰化市,延平里,26,546,45.69037657,649,54.30962343,1195,29,1224,0,1509,81.11332008
彰化縣,彰化市,建寶里,18,337,38.38268793,541,61.61731207,878,11,889,0,1068,83.23970037
彰化縣,彰化市,建寶里,19,414,39.01979265,647,60.98020735,1061,18,1079,0,1263,85.43151227
彰化縣,彰化市,福安里,37,446,50.05611672,445,49.94388328,891,15,906,0,1063,85.23047977
彰化縣,彰化市,大竹里,117,556,55.37848606,448,44.62151394,1004,22,1026,0,1225,83.75510204
彰化縣,彰化市,大竹里,118,599,49.50413223,611,50.49586777,1210,29,1239,0,1507,82.21632382
彰化縣,彰化市,竹中里,102,646,52.99425759,573,47.00574241,1219,50,1269,0,1621,78.28500925
彰化縣,彰化市,安溪里,115,484,57.8255675,353,42.1744325,837,18,855,0,1049,81.50619638
彰化縣,彰化市,香山里,103,610,50.70656692,593,49.29343308,1203,30,1233,0,1498,82.30974633
彰化縣,彰化市,香山里,104,511,57.74011299,374,42.25988701,885,28,913,0,1088,83.91544118
彰化縣,彰化市,牛埔里,105,773,58.73860182,543,41.26139818,1316,36,1352,0,1598,84.6057572
彰化縣,彰化市,牛埔里,106,454,45.17412935,551,54.82587065,1005,23,1028,0,1263,81.39350752
彰化縣,彰化市,福山里,111,597,54.87132353,491,45.12867647,1088,30,1118,0,1356,82.44837758
彰化縣,彰化市,福山里,112,667,55.53705246,534,44.46294754,1201,28,1229,0,1522,80.74901445
彰化縣,彰化市,福山里,113,689,57.36885928,512,42.63114072,1201,31,1232,0,1552,79.3814433
彰化縣,彰化市,福山里,114,720,56.42633229,556,43.57366771,1276,41,1317,0,1585,83.09148265
彰化縣,彰化市,中庄里,100,624,61.84340932,385,38.15659068,1009,10,1019,0,1246,81.78170144
彰化縣,彰化市,中庄里,101,369,52.86532951,329,47.13467049,698,22,720,1,904,79.6460177
彰化縣,彰化市,三村里,116,494,63.41463415,285,36.58536585,779,33,812,0,993,81.77240685
彰化縣,彰化市,國聖里,109,596,53.4529148,519,46.5470852,1115,35,1150,0,1394,82.4964132
彰化縣,彰化市,國聖里,110,353,50.5730659,345,49.4269341,698,27,725,0,863,84.00926999
彰化縣,彰化市,寶部里,89,394,49.18851436,407,50.81148564,801,26,827,0,1035,79.90338164
彰化縣,彰化市,茄苳里,86,360,55.81395349,285,44.18604651,645,29,674,0,810,83.20987654
彰化縣,彰化市,茄南里,87,434,48.70931538,457,51.29068462,891,33,924,0,1162,79.51807229
彰化縣,彰化市,茄南里,88,426,49.70828471,431,50.29171529,857,14,871,1,1036,84.07335907
彰化縣,彰化市,阿夷里,92,657,47.7124183,720,52.2875817,1377,34,1411,0,1751,80.58252427
彰化縣,彰化市,阿夷里,93,835,51.28992629,793,48.71007371,1628,52,1680,0,2012,83.49900596
彰化縣,彰化市,阿夷里,94,663,43.82022472,850,56.17977528,1513,28,1541,0,1912,80.59623431
彰化縣,彰化市,古夷里,90,448,53.84615385,384,46.15384615,832,29,861,0,1054,81.68880455
彰化縣,彰化市,古夷里,91,481,52.45365322,436,47.54634678,917,23,940,0,1200,78.33333333
彰化縣,彰化市,復興里,97,729,52.52161383,659,47.47838617,1388,31,1419,0,1751,81.03940605
彰化縣,彰化市,復興里,98,598,47.61146497,658,52.38853503,1256,14,1270,0,1553,81.77720541
彰化縣,彰化市,復興里,99,199,36.71586716,343,63.28413284,542,9,551,0,668,82.48502994
彰化縣,彰化市,和調里,95,410,48.00936768,444,51.99063232,854,31,885,1,1077,82.17270195
彰化縣,彰化市,和調里,96,450,47.31861199,501,52.68138801,951,18,969,0,1208,80.21523179
彰化縣,彰化市,石牌里,123,543,60.46770601,355,39.53229399,898,23,921,0,1135,81.14537445
彰化縣,彰化市,福田里,122,547,57.70042194,401,42.29957806,948,25,973,0,1197,81.28654971
彰化縣,彰化市,竹巷里,121,355,54.28134557,299,45.71865443,654,16,670,0,804,83.33333333
彰化縣,彰化市,田中里,119,383,59.75039002,258,40.24960998,641,21,662,0,813,81.42681427
彰化縣,彰化市,快官里,120,435,55.76923077,345,44.23076923,780,28,808,0,994,81.28772636
彰化縣,彰化市,台鳳里,107,706,43.44615385,919,56.55384615,1625,21,1646,0,2053,80.17535314
彰化縣,彰化市,台鳳里,108,550,44.71544715,680,55.28455285,1230,25,1255,0,1612,77.85359801
彰化縣,彰化市,崙平里,58,567,46.32352941,657,53.67647059,1224,17,1241,0,1491,83.23272971
彰化縣,彰化市,崙平里,59,512,50.34414946,505,49.65585054,1017,27,1044,0,1270,82.20472441
彰化縣,彰化市,崙平里,60,677,50.18532246,672,49.81467754,1349,25,1374,0,1664,82.57211538
彰化縣,彰化市,向陽里,61,542,41.15413819,775,58.84586181,1317,19,1336,0,1601,83.4478451
彰化縣,彰化市,向陽里,62,520,48.59813084,550,51.40186916,1070,27,1097,0,1360,80.66176471
彰化縣,花壇鄉,花壇村,124,423,45.68034557,503,54.31965443,926,21,947,0,1197,79.1144528
彰化縣,花壇鄉,花壇村,125,646,49.27536232,665,50.72463768,1311,33,1344,0,1594,84.3161857
彰化縣,花壇鄉,金墩村,126,674,53.32278481,590,46.67721519,1264,29,1293,0,1626,79.5202952
彰化縣,花壇鄉,中庄村,127,409,52.16836735,375,47.83163265,784,15,799,0,964,82.88381743
彰化縣,花壇鄉,中庄村,128,484,46.13918017,565,53.86081983,1049,34,1083,0,1293,83.7587007
彰化縣,花壇鄉,劉厝村,129,540,64.28571429,300,35.71428571,840,23,863,0,1035,83.38164251
彰化縣,花壇鄉,崙雅村,130,643,60.89015152,413,39.10984848,1056,42,1098,0,1338,82.06278027
彰化縣,花壇鄉,南口村,131,585,50.17152659,581,49.82847341,1166,22,1188,0,1461,81.31416838
彰化縣,花壇鄉,中口村,132,343,60.1754386,227,39.8245614,570,10,580,0,705,82.26950355
彰化縣,花壇鄉,北口村,133,385,54.6875,319,45.3125,704,23,727,0,885,82.14689266
彰化縣,花壇鄉,北口村,134,305,54.95495495,250,45.04504505,555,15,570,0,694,82.13256484
彰化縣,花壇鄉,長沙村,135,468,48.39710445,499,51.60289555,967,28,995,0,1225,81.2244898
彰化縣,花壇鄉,長沙村,136,509,46.10507246,595,53.89492754,1104,17,1121,0,1351,82.97557365
彰化縣,花壇鄉,長沙村,137,515,49.0943756,534,50.9056244,1049,18,1067,0,1300,82.07692308
彰化縣,花壇鄉,文德村,138,496,50.81967213,480,49.18032787,976,43,1019,0,1253,81.32482043
彰化縣,花壇鄉,文德村,139,393,44.76082005,485,55.23917995,878,17,895,0,1118,80.05366726
彰化縣,花壇鄉,白沙村,140,562,42.83536585,750,57.16463415,1312,25,1337,0,1654,80.83434099
彰化縣,花壇鄉,白沙村,141,791,49.65473949,802,50.34526051,1593,34,1627,0,2037,79.87236132
彰化縣,花壇鄉,岩竹村,142,513,51.5060241,483,48.4939759,996,37,1033,0,1304,79.21779141
彰化縣,花壇鄉,橋頭村,143,637,46.25998548,740,53.74001452,1377,44,1421,0,1827,77.77777778
彰化縣,花壇鄉,橋頭村,144,405,46.9837587,457,53.0162413,862,30,892,0,1097,81.31267092
彰化縣,花壇鄉,灣雅村,145,301,45.67526555,358,54.32473445,659,23,682,0,841,81.09393579
彰化縣,花壇鄉,灣東村,146,326,47.04184704,367,52.95815296,693,32,725,0,947,76.55755016
彰化縣,花壇鄉,三春村,147,589,46.78316124,670,53.21683876,1259,33,1292,0,1635,79.02140673
彰化縣,花壇鄉,永春村,148,533,48.19168174,573,51.80831826,1106,36,1142,0,1467,77.8459441
彰化縣,花壇鄉,長春村,149,523,46.65477252,598,53.34522748,1121,45,1166,0,1461,79.80835044
彰化縣,芬園鄉,舊社村,150,657,53.37124289,574,46.62875711,1231,68,1299,0,1695,76.63716814
彰化縣,芬園鄉,大埔村,151,535,54.42522889,448,45.57477111,983,57,1040,0,1321,78.72823618
彰化縣,芬園鄉,竹林村,152,645,52.73916599,578,47.26083401,1223,59,1282,0,1620,79.13580247
彰化縣,芬園鄉,社口村,154,479,53.75982043,412,46.24017957,891,22,913,0,1124,81.22775801
彰化縣,芬園鄉,社口村,155,483,56.42523364,373,43.57476636,856,30,886,0,1139,77.78753292
彰化縣,芬園鄉,茄荖村,156,482,54.96009122,395,45.03990878,877,39,916,0,1129,81.13374668
彰化縣,芬園鄉,茄荖村,157,507,58.95348837,353,41.04651163,860,20,880,0,1042,84.45297505
彰化縣,芬園鄉,嘉興村,158,686,57.59865659,505,42.40134341,1191,41,1232,0,1531,80.47028086
彰化縣,芬園鄉,芬園村,159,408,60.26587888,269,39.73412112,677,36,713,0,872,81.76605505
彰化縣,芬園鄉,縣庄村,161,569,67.73809524,271,32.26190476,840,40,880,0,1072,82.08955224
彰化縣,芬園鄉,圳墘村,162,367,68.0890538,172,31.9109462,539,33,572,0,682,83.87096774
彰化縣,芬園鄉,溪頭村,163,726,63.46153846,418,36.53846154,1144,52,1196,2,1484,80.59299191
彰化縣,芬園鄉,進芬村,160,399,56.75675676,304,43.24324324,703,37,740,0,938,78.891258
彰化縣,芬園鄉,同安村,164,624,66.24203822,318,33.75796178,942,74,1016,0,1254,81.02073365
彰化縣,芬園鄉,中崙村,165,429,60,286,40,715,35,750,0,986,76.06490872
彰化縣,芬園鄉,大竹村,166,506,67.37683089,245,32.62316911,751,49,800,2,1066,75.04690432
彰化縣,芬園鄉,楓坑村,153,238,53.3632287,208,46.6367713,446,17,463,0,570,81.22807018
彰化縣,鹿港鎮,大有里,167,565,62.77777778,335,37.22222222,900,33,933,0,1152,80.98958333
彰化縣,鹿港鎮,中興里,168,290,64.30155211,161,35.69844789,451,12,463,0,565,81.94690265
彰化縣,鹿港鎮,洛津里,169,488,61.61616162,304,38.38383838,792,20,812,0,994,81.69014085
彰化縣,鹿港鎮,順興里,170,403,57.73638968,295,42.26361032,698,9,707,0,863,81.9235226
彰化縣,鹿港鎮,頂厝里,187,948,64.79835954,515,35.20164046,1463,51,1514,0,1912,79.18410042
彰化縣,鹿港鎮,頂厝里,188,676,54.60420032,562,45.39579968,1238,24,1262,0,1544,81.7357513
彰化縣,鹿港鎮,頂厝里,189,937,58.93081761,653,41.06918239,1590,50,1640,0,1992,82.32931727
彰化縣,鹿港鎮,東崎里,190,704,50.32165833,695,49.67834167,1399,67,1466,0,1821,80.50521691
彰化縣,鹿港鎮,東崎里,191,642,65.04559271,345,34.95440729,987,58,1045,0,1262,82.80507132
彰化縣,鹿港鎮,東崎里,192,402,49.20440636,415,50.79559364,817,20,837,0,1106,75.67811935
彰化縣,鹿港鎮,埔崙里,185,874,63.56363636,501,36.43636364,1375,39,1414,0,1719,82.25712624
彰化縣,鹿港鎮,埔崙里,186,784,62.17287867,477,37.82712133,1261,37,1298,0,1603,80.9731753
彰化縣,鹿港鎮,東石里,181,740,64.62882096,405,35.37117904,1145,29,1174,0,1482,79.21727395
彰化縣,鹿港鎮,東石里,182,970,65.71815718,506,34.28184282,1476,30,1506,0,1816,82.92951542
彰化縣,鹿港鎮,郭厝里,178,278,63.90804598,157,36.09195402,435,16,451,0,593,76.0539629
彰化縣,鹿港鎮,新宮里,179,539,70.09102731,230,29.90897269,769,17,786,0,952,82.56302521
彰化縣,鹿港鎮,玉順里,180,639,63.39285714,369,36.60714286,1008,39,1047,0,1267,82.63614838
彰化縣,鹿港鎮,景福里,177,475,53.91600454,406,46.08399546,881,35,916,2,1123,81.56723063
彰化縣,鹿港鎮,泰興里,173,486,52.42718447,441,47.57281553,927,32,959,0,1180,81.27118644
彰化縣,鹿港鎮,長興里,174,131,54.58333333,109,45.41666667,240,16,256,0,322,79.50310559
彰化縣,鹿港鎮,龍山里,176,357,60.61120543,232,39.38879457,589,12,601,0,755,79.60264901
彰化縣,鹿港鎮,興化里,175,283,54.52793834,236,45.47206166,519,18,537,0,656,81.8597561
彰化縣,鹿港鎮,菜園里,171,547,70.12820513,233,29.87179487,780,30,810,0,981,82.56880734
彰化縣,鹿港鎮,街尾里,172,937,61.0821382,597,38.9178618,1534,37,1571,0,1921,81.78032275
彰化縣,鹿港鎮,頂番里,207,517,48.45360825,550,51.54639175,1067,30,1097,0,1352,81.13905325
彰化縣,鹿港鎮,頂番里,208,611,45.76779026,724,54.23220974,1335,45,1380,0,1742,79.21928817
彰化縣,鹿港鎮,頭崙里,205,522,48.55813953,553,51.44186047,1075,51,1126,0,1415,79.57597173
彰化縣,鹿港鎮,頭崙里,206,369,55.57228916,295,44.42771084,664,16,680,0,837,81.24253286
彰化縣,鹿港鎮,廖厝里,193,612,52.57731959,552,47.42268041,1164,32,1196,0,1514,78.99603699
彰化縣,鹿港鎮,廖厝里,194,610,47.14064915,684,52.85935085,1294,51,1345,0,1659,81.0729355
彰化縣,鹿港鎮,溝墘里,209,492,46.85714286,558,53.14285714,1050,32,1082,0,1357,79.73470892
彰化縣,鹿港鎮,溝墘里,210,477,46.58203125,547,53.41796875,1024,29,1053,0,1338,78.69955157
彰化縣,鹿港鎮,溝墘里,211,262,44.10774411,332,55.89225589,594,28,622,0,763,81.52031455
彰化縣,鹿港鎮,草中里,200,555,47.96888505,602,52.03111495,1157,35,1192,0,1517,78.57613711
彰化縣,鹿港鎮,草中里,201,502,47.76403425,549,52.23596575,1051,34,1085,0,1338,81.09118087
彰化縣,鹿港鎮,頭南里,204,653,47.76883687,714,52.23116313,1367,60,1427,0,1787,79.85450476
彰化縣,鹿港鎮,山崙里,202,543,66.95437731,268,33.04562269,811,24,835,0,1030,81.06796117
彰化縣,鹿港鎮,山崙里,203,861,56.83168317,654,43.16831683,1515,49,1564,0,1887,82.88288288
彰化縣,鹿港鎮,海埔里,196,639,54.94411006,524,45.05588994,1163,33,1196,0,1506,79.41567065
彰化縣,鹿港鎮,海埔里,197,626,59.05660377,434,40.94339623,1060,26,1086,0,1364,79.61876833
彰化縣,鹿港鎮,詔安里,195,699,58.44481605,497,41.55518395,1196,59,1255,0,1627,77.13583282
彰化縣,鹿港鎮,洋厝里,198,347,53.38461538,303,46.61538462,650,32,682,0,877,77.76510832
彰化縣,鹿港鎮,洋厝里,199,821,71.14384749,333,28.85615251,1154,37,1191,0,1469,81.07556161
彰化縣,鹿港鎮,永安里,183,794,55.13888889,646,44.86111111,1440,44,1484,2,1794,82.72017837
彰化縣,鹿港鎮,永安里,184,842,58.35065835,601,41.64934165,1443,47,1490,0,1865,79.89276139
彰化縣,褔興鄉,番社村,223,756,75,252,25,1008,40,1048,0,1275,82.19607843
彰化縣,褔興鄉,社尾村,222,551,57.27650728,411,42.72349272,962,56,1018,0,1329,76.59894658
彰化縣,褔興鄉,大崙村,214,445,52.66272189,400,47.33727811,845,29,874,0,1097,79.67183227
彰化縣,褔興鄉,外埔村,215,538,65.05441354,289,34.94558646,827,55,882,0,1075,82.04651163
彰化縣,褔興鄉,外中村,218,584,65.25139665,311,34.74860335,895,44,939,0,1163,80.7394669
彰化縣,褔興鄉,元中村,219,460,53.55064028,399,46.44935972,859,42,901,1,1075,83.81395349
彰化縣,褔興鄉,三汴村,216,630,64.15478615,352,35.84521385,982,35,1017,0,1228,82.81758958
彰化縣,褔興鄉,萬豐村,217,331,56.29251701,257,43.70748299,588,25,613,0,741,82.72604588
彰化縣,褔興鄉,番婆村,212,501,56.48252537,386,43.51747463,887,25,912,1,1169,78.01539778
彰化縣,褔興鄉,番婆村,213,361,54.86322188,297,45.13677812,658,31,689,0,909,75.79757976
彰化縣,褔興鄉,橋頭村,220,442,59.40860215,302,40.59139785,744,33,777,0,953,81.5320042
彰化縣,褔興鄉,橋頭村,221,473,49.3736952,485,50.6263048,958,25,983,0,1211,81.17258464
彰化縣,褔興鄉,秀厝村,228,388,55.58739255,310,44.41260745,698,25,723,0,895,80.78212291
彰化縣,褔興鄉,秀厝村,229,499,55.07726269,407,44.92273731,906,30,936,0,1174,79.7274276
彰化縣,褔興鄉,鎮平村,230,459,56.18115055,358,43.81884945,817,39,856,0,1091,78.46012832
彰化縣,褔興鄉,三和村,231,541,67.87954831,256,32.12045169,797,37,834,0,1021,81.68462292
彰化縣,褔興鄉,麥厝村,232,463,60.84099869,298,39.15900131,761,38,799,0,1036,77.12355212
彰化縣,褔興鄉,麥厝村,233,488,61.69405815,303,38.30594185,791,40,831,0,1071,77.59103641
彰化縣,褔興鄉,廈粘村,234,353,51.68374817,330,48.31625183,683,29,712,0,881,80.81725312
彰化縣,褔興鄉,廈粘村,235,362,50.7713885,351,49.2286115,713,25,738,1,943,78.26086957
彰化縣,褔興鄉,頂粘村,236,346,50.36390102,341,49.63609898,687,35,722,0,904,79.86725664
彰化縣,褔興鄉,頂粘村,237,437,50.93240093,421,49.06759907,858,44,902,0,1149,78.50304613
彰化縣,褔興鄉,福寶村,238,410,46.53802497,471,53.46197503,881,39,920,0,1174,78.36456559
彰化縣,褔興鄉,二港村,239,481,49.63880289,488,50.36119711,969,41,1010,0,1257,80.35003978
彰化縣,褔興鄉,福興村,240,661,54.40329218,554,45.59670782,1215,31,1246,0,1564,79.66751918
彰化縣,褔興鄉,福興村,241,570,58.46153846,405,41.53846154,975,37,1012,0,1249,81.02481986
彰化縣,褔興鄉,福南村,242,424,54.42875481,355,45.57124519,779,35,814,0,1013,80.35538006
彰化縣,褔興鄉,福南村,243,460,51.4541387,434,48.5458613,894,24,918,0,1151,79.75673328
彰化縣,褔興鄉,同安村,224,441,54.7826087,364,45.2173913,805,32,837,0,1001,83.61638362
彰化縣,褔興鄉,同安村,225,495,57.15935335,371,42.84064665,866,23,889,0,1088,81.70955882
彰化縣,褔興鄉,西勢村,226,397,50.96277279,382,49.03722721,779,22,801,0,950,84.31578947
彰化縣,褔興鄉,西勢村,227,332,58.04195804,240,41.95804196,572,18,590,0,715,82.51748252
彰化縣,秀水鄉,秀水村,244,474,57.87545788,345,42.12454212,819,21,840,0,1019,82.43375859
彰化縣,秀水鄉,秀水村,245,290,58.94308943,202,41.05691057,492,19,511,0,604,84.60264901
彰化縣,秀水鄉,安溪村,246,697,58.1803005,501,41.8196995,1198,45,1243,0,1491,83.36686787
彰化縣,秀水鄉,莊雅村,247,444,51.27020785,422,48.72979215,866,39,905,0,1137,79.59542656
彰化縣,秀水鄉,莊雅村,248,383,48.78980892,402,51.21019108,785,11,796,0,920,86.52173913
彰化縣,秀水鄉,金興村,250,337,48.48920863,358,51.51079137,695,26,721,0,863,83.54577057
彰化縣,秀水鄉,金興村,251,355,55.1242236,289,44.8757764,644,27,671,0,797,84.19071518
彰化縣,秀水鄉,陝西村,249,468,48.85177453,490,51.14822547,958,37,995,0,1194,83.33333333
彰化縣,秀水鄉,安東村,252,424,45.34759358,511,54.65240642,935,25,960,0,1181,81.28704488
彰化縣,秀水鄉,安東村,253,429,57.66129032,315,42.33870968,744,17,761,0,928,82.00431034
彰化縣,秀水鄉,安東村,254,492,56.94444444,372,43.05555556,864,34,898,0,1118,80.32200358
彰化縣,秀水鄉,鶴鳴村,255,707,59.26236379,486,40.73763621,1193,45,1238,0,1487,83.25487559
彰化縣,秀水鄉,鶴鳴村,256,500,54.17118093,423,45.82881907,923,30,953,0,1165,81.80257511
彰化縣,秀水鄉,馬興村,257,570,60.38135593,374,39.61864407,944,10,954,0,1156,82.52595156
彰化縣,秀水鄉,馬興村,258,415,63.35877863,240,36.64122137,655,43,698,0,849,82.21436985
彰化縣,秀水鄉,義興村,259,497,55.65509518,396,44.34490482,893,27,920,0,1116,82.43727599
彰化縣,秀水鄉,福安村,260,534,54.71311475,442,45.28688525,976,35,1011,0,1255,80.55776892
彰化縣,秀水鄉,福安村,261,429,48.36527621,458,51.63472379,887,31,918,0,1114,82.40574506
彰化縣,秀水鄉,福安村,262,479,54.93119266,393,45.06880734,872,21,893,0,1118,79.87477639
彰化縣,秀水鄉,埔崙村,263,299,57.72200772,219,42.27799228,518,10,528,0,643,82.11508554
彰化縣,秀水鄉,埔崙村,264,506,58.02752294,366,41.97247706,872,24,896,0,1104,81.15942029
彰化縣,秀水鄉,曾厝村,265,624,57.88497217,454,42.11502783,1078,40,1118,0,1365,81.9047619
彰化縣,秀水鄉,金陵村,266,764,64.91079014,413,35.08920986,1177,26,1203,0,1439,83.59972203
彰化縣,秀水鄉,下崙村,267,473,52.79017857,423,47.20982143,896,44,940,0,1146,82.02443281
彰化縣,秀水鄉,下崙村,268,426,69.26829268,189,30.73170732,615,25,640,0,750,85.33333333
彰化縣,和美鎮,竹營里,269,791,54.89243581,650,45.10756419,1441,39,1480,0,1848,80.08658009
彰化縣,和美鎮,竹營里,270,858,48.83323847,899,51.16676153,1757,34,1791,0,2227,80.4220925
彰化縣,和美鎮,和東里,271,807,50.59561129,788,49.40438871,1595,25,1620,0,1962,82.56880734
彰化縣,和美鎮,和東里,272,575,46.74796748,655,53.25203252,1230,28,1258,0,1553,81.00450741
彰化縣,和美鎮,和南里,273,168,42.53164557,227,57.46835443,395,2,397,0,457,86.87089716
彰化縣,和美鎮,和北里,274,524,47.42081448,581,52.57918552,1105,29,1134,0,1389,81.64146868
彰化縣,和美鎮,和西里,275,534,46.84210526,606,53.15789474,1140,34,1174,0,1440,81.52777778
彰化縣,和美鎮,和西里,276,617,46.88449848,699,53.11550152,1316,37,1353,1,1669,81.06650689
彰化縣,和美鎮,四張里,277,495,57.42459397,367,42.57540603,862,28,890,0,1086,81.95211786
彰化縣,和美鎮,四張里,278,480,48.04804805,519,51.95195195,999,28,1027,0,1281,80.17174083
彰化縣,和美鎮,頭前里,279,511,47.66791045,561,52.33208955,1072,36,1108,0,1364,81.23167155
彰化縣,和美鎮,還社里,280,336,52.83018868,300,47.16981132,636,22,658,0,776,84.79381443
彰化縣,和美鎮,面前里,281,220,49.88662132,221,50.11337868,441,21,462,0,573,80.62827225
彰化縣,和美鎮,面前里,282,485,53.23819978,426,46.76180022,911,16,927,0,1132,81.89045936
彰化縣,和美鎮,鎮平里,283,535,54.64759959,444,45.35240041,979,20,999,0,1179,84.73282443
彰化縣,和美鎮,鎮平里,284,572,57.89473684,416,42.10526316,988,27,1015,0,1272,79.79559748
彰化縣,和美鎮,大霞里,285,432,43.46076459,562,56.53923541,994,22,1016,0,1238,82.06785137
彰化縣,和美鎮,源埤里,286,608,50.79365079,589,49.20634921,1197,41,1238,0,1556,79.56298201
彰化縣,和美鎮,南佃里,287,728,54.08618128,618,45.91381872,1346,56,1402,0,1755,79.88603989
彰化縣,和美鎮,雅溝里,288,544,56.02471679,427,43.97528321,971,16,987,0,1248,79.08653846
彰化縣,和美鎮,山犁里,289,725,51.38199858,686,48.61800142,1411,32,1443,0,1779,81.11298482
彰化縣,和美鎮,山犁里,290,658,48.0642805,711,51.9357195,1369,43,1412,0,1731,81.57134604
彰化縣,和美鎮,山犁里,291,776,49.39528962,795,50.60471038,1571,39,1610,0,2023,79.58477509
彰化縣,和美鎮,嘉犁里,292,552,45.32019704,666,54.67980296,1218,28,1246,0,1570,79.36305732
彰化縣,和美鎮,鐵山里,294,496,47.55512943,547,52.44487057,1043,27,1070,4,1324,80.81570997
彰化縣,和美鎮,鐵山里,295,459,53.24825986,403,46.75174014,862,15,877,0,1064,82.42481203
彰化縣,和美鎮,詔安里,293,656,50.69551777,638,49.30448223,1294,34,1328,0,1670,79.52095808
彰化縣,和美鎮,柑井里,296,562,52.6710403,505,47.3289597,1067,40,1107,0,1340,82.6119403
彰化縣,和美鎮,柑井里,297,563,51.88940092,522,48.11059908,1085,30,1115,0,1311,85.04958047
彰化縣,和美鎮,竹園里,298,445,67.11915535,218,32.88084465,663,21,684,0,814,84.02948403
彰化縣,和美鎮,新庄里,299,479,51.78378378,446,48.21621622,925,28,953,0,1201,79.35054122
彰化縣,和美鎮,新庄里,300,421,48.33524684,450,51.66475316,871,27,898,0,1087,82.61269549
彰化縣,和美鎮,犁盛里,301,465,54.96453901,381,45.03546099,846,23,869,0,1066,81.51969981
彰化縣,和美鎮,犁盛里,302,397,50.70242656,386,49.29757344,783,21,804,0,994,80.88531187
彰化縣,和美鎮,中寮里,303,492,58.50178359,349,41.49821641,841,29,870,0,1093,79.59743824
彰化縣,和美鎮,中圍里,304,479,61.01910828,306,38.98089172,785,36,821,0,1013,81.04639684
彰化縣,和美鎮,中圍里,305,653,55.29212532,528,44.70787468,1181,38,1219,0,1562,78.04097311
彰化縣,和美鎮,糖友里,306,581,47.04453441,654,52.95546559,1235,26,1261,0,1538,81.98959688
彰化縣,和美鎮,糖友里,307,427,43.79487179,548,56.20512821,975,14,989,0,1182,83.67174281
彰化縣,和美鎮,塗厝里,308,583,45.40498442,701,54.59501558,1284,41,1325,0,1665,79.57957958
彰化縣,和美鎮,地潭里,309,344,51.34328358,326,48.65671642,670,25,695,0,842,82.5415677
彰化縣,和美鎮,湖內里,310,671,71.15588547,272,28.84411453,943,52,995,0,1204,82.64119601
彰化縣,和美鎮,嘉寶里,311,662,50.76687117,642,49.23312883,1304,43,1347,0,1714,78.58809802
彰化縣,和美鎮,月眉里,312,715,55.90304926,564,44.09695074,1279,35,1314,0,1651,79.58812841
彰化縣,和美鎮,月眉里,313,511,54.30393199,430,45.69606801,941,26,967,0,1181,81.87976291
彰化縣,和美鎮,好修里,314,379,53.68271955,327,46.31728045,706,34,740,0,939,78.80724175
彰化縣,和美鎮,好修里,315,277,51.58286778,260,48.41713222,537,28,565,0,706,80.02832861
彰化縣,線西鄉,線西村,316,544,36.55913978,944,63.44086022,1488,48,1536,0,1917,80.12519562
彰化縣,線西鄉,頂庄村,317,341,38.31460674,549,61.68539326,890,44,934,0,1136,82.21830986
彰化縣,線西鄉,寓埔村,318,767,50.2292076,760,49.7707924,1527,20,1547,0,1996,77.50501002
彰化縣,線西鄉,塭仔村,319,423,46.12868048,494,53.87131952,917,23,940,0,1155,81.38528139
彰化縣,線西鄉,溝內村,320,329,42.34234234,448,57.65765766,777,34,811,0,1037,78.20636451
彰化縣,線西鄉,下犁村,321,609,47.99054374,660,52.00945626,1269,42,1311,0,1676,78.22195704
彰化縣,線西鄉,頂犁村,322,303,39.453125,465,60.546875,768,39,807,0,990,81.51515152
彰化縣,線西鄉,頂犁村,323,368,41.72335601,514,58.27664399,882,34,916,0,1173,78.09036658
彰化縣,線西鄉,德興村,324,360,41.86046512,500,58.13953488,860,34,894,0,1094,81.71846435
彰化縣,伸港鄉,曾家村,337,637,56.47163121,491,43.52836879,1128,56,1184,0,1486,79.6769852
彰化縣,伸港鄉,蚵寮村,338,634,71.8006795,249,28.1993205,883,43,926,0,1145,80.87336245
彰化縣,伸港鄉,埤墘村,339,419,53.92535393,358,46.07464607,777,22,799,0,960,83.22916667
彰化縣,伸港鄉,溪底村,332,677,55.58292282,541,44.41707718,1218,66,1284,0,1575,81.52380952
彰化縣,伸港鄉,泉州村,335,603,46.45608629,695,53.54391371,1298,44,1342,0,1663,80.69753458
彰化縣,伸港鄉,泉厝村,336,489,52.75080906,438,47.24919094,927,43,970,0,1197,81.03592314
彰化縣,伸港鄉,海尾村,330,659,51.12490303,630,48.87509697,1289,40,1329,0,1621,81.98642813
彰化縣,伸港鄉,全興村,331,414,36.47577093,721,63.52422907,1135,52,1187,0,1532,77.48041775
彰化縣,伸港鄉,定興村,333,335,42.08542714,461,57.91457286,796,23,819,0,1025,79.90243902
彰化縣,伸港鄉,定興村,334,437,50.46189376,429,49.53810624,866,42,908,0,1171,77.54056362
彰化縣,伸港鄉,新港村,325,468,47.80388151,511,52.19611849,979,20,999,0,1232,81.08766234
彰化縣,伸港鄉,新港村,326,548,47.86026201,597,52.13973799,1145,26,1171,0,1473,79.4976239
彰化縣,伸港鄉,新港村,327,604,51.0998308,578,48.9001692,1182,33,1215,0,1519,79.98683344
彰化縣,伸港鄉,什股村,328,453,38.58603066,721,61.41396934,1174,50,1224,0,1539,79.53216374
彰化縣,伸港鄉,大同村,329,539,54.38950555,452,45.61049445,991,25,1016,0,1239,82.00161421
彰化縣,伸港鄉,七嘉村,340,701,46.9210174,793,53.0789826,1494,49,1543,0,1934,79.78283351
彰化縣,伸港鄉,汴頭村,341,753,47.83989835,821,52.16010165,1574,45,1619,0,1986,81.52064451
彰化縣,員林鎮,東和里,342,376,43.92523364,480,56.07476636,856,9,865,0,1077,80.31569174
彰化縣,員林鎮,民生里,343,476,57.62711864,350,42.37288136,826,29,855,0,1063,80.43273754
彰化縣,員林鎮,民生里,344,549,45,671,55,1220,31,1251,1,1558,80.29525032
彰化縣,員林鎮,中正里,345,550,48.37291117,587,51.62708883,1137,22,1159,0,1410,82.19858156
彰化縣,員林鎮,中正里,346,570,47.18543046,638,52.81456954,1208,11,1219,0,1526,79.88204456
彰化縣,員林鎮,仁美里,347,533,48.63138686,563,51.36861314,1096,19,1115,0,1369,81.44631118
彰化縣,員林鎮,仁美里,348,491,44.88117002,603,55.11882998,1094,21,1115,0,1356,82.22713864
彰化縣,員林鎮,新興里,349,333,51.4683153,314,48.5316847,647,13,660,0,819,80.58608059
彰化縣,員林鎮,和平里,350,414,49.69987995,419,50.30012005,833,19,852,0,1061,80.30160226
彰化縣,員林鎮,和平里,351,609,47.17273431,682,52.82726569,1291,33,1324,1,1625,81.47692308
彰化縣,員林鎮,光明里,352,410,52.49679898,371,47.50320102,781,15,796,0,960,82.91666667
彰化縣,員林鎮,黎明里,354,315,46.52880355,362,53.47119645,677,19,696,1,860,80.93023256
彰化縣,員林鎮,黎明里,355,356,50.56818182,348,49.43181818,704,22,726,0,893,81.29899216
彰化縣,員林鎮,惠來里,356,712,50.89349535,687,49.10650465,1399,22,1421,0,1748,81.29290618
彰化縣,員林鎮,惠來里,357,548,52.04178538,505,47.95821462,1053,25,1078,1,1380,78.11594203
彰化縣,員林鎮,惠來里,358,517,47.3010064,576,52.6989936,1093,35,1128,0,1380,81.73913043
彰化縣,員林鎮,三義里,359,416,51.42150803,393,48.57849197,809,13,822,0,990,83.03030303
彰化縣,員林鎮,三義里,360,472,46.13880743,551,53.86119257,1023,30,1053,1,1271,82.84815106
彰化縣,員林鎮,新生里,361,410,47.50869061,453,52.49130939,863,20,883,0,1097,80.4922516
彰化縣,員林鎮,新生里,362,413,50.06060606,412,49.93939394,825,21,846,0,1047,80.80229226
彰化縣,員林鎮,新生里,363,316,47.37631184,351,52.62368816,667,8,675,0,795,84.90566038
彰化縣,員林鎮,新生里,364,311,46.21099554,362,53.78900446,673,18,691,0,837,82.5567503
彰化縣,員林鎮,南平里,365,352,44.27672956,443,55.72327044,795,20,815,0,1018,80.0589391
彰化縣,員林鎮,南平里,366,512,52.67489712,460,47.32510288,972,18,990,0,1200,82.5
彰化縣,員林鎮,南平里,367,544,49.95408632,545,50.04591368,1089,31,1120,0,1345,83.27137546
彰化縣,員林鎮,南興里,368,598,50.12573345,595,49.87426655,1193,38,1231,0,1515,81.25412541
彰化縣,員林鎮,南興里,369,462,42.23034735,632,57.76965265,1094,36,1130,0,1379,81.94343727
彰化縣,員林鎮,南興里,370,398,39.44499504,611,60.55500496,1009,21,1030,0,1283,80.28059236
彰化縣,員林鎮,源潭里,371,713,60.21959459,471,39.78040541,1184,58,1242,1,1523,81.54957321
彰化縣,員林鎮,大埔里,372,730,52.63157895,657,47.36842105,1387,61,1448,0,1778,81.43982002
彰化縣,員林鎮,三條里,376,459,55.43478261,369,44.56521739,828,24,852,0,1052,80.98859316
彰化縣,員林鎮,三條里,377,366,45.80725907,433,54.19274093,799,20,819,0,1016,80.61023622
彰化縣,員林鎮,三和里,378,625,44.61099215,776,55.38900785,1401,39,1440,0,1838,78.34602829
彰化縣,員林鎮,三和里,379,553,46.35373009,640,53.64626991,1193,25,1218,1,1557,78.22736031
彰化縣,員林鎮,三和里,380,585,46.24505929,680,53.75494071,1265,26,1291,0,1593,81.04205901
彰化縣,員林鎮,三橋里,381,491,52.8525296,438,47.1474704,929,28,957,0,1166,82.0754717
彰化縣,員林鎮,三橋里,382,532,49.81273408,536,50.18726592,1068,33,1101,0,1367,80.54133138
彰化縣,員林鎮,中央里,389,630,51.51267375,593,48.48732625,1223,42,1265,0,1561,81.03779628
彰化縣,員林鎮,溝皂里,390,425,47.48603352,470,52.51396648,895,18,913,0,1108,82.40072202
彰化縣,員林鎮,溝皂里,391,434,56.43693108,335,43.56306892,769,25,794,0,984,80.69105691
彰化縣,員林鎮,大饒里,392,484,50.78698846,469,49.21301154,953,27,980,0,1187,82.56107835
彰化縣,員林鎮,大饒里,393,476,46.43902439,549,53.56097561,1025,27,1052,0,1323,79.51625094
彰化縣,員林鎮,大明里,394,518,60.44340723,339,39.55659277,857,37,894,0,1086,82.32044199
彰化縣,員林鎮,大明里,395,379,52.63888889,341,47.36111111,720,26,746,0,920,81.08695652
彰化縣,員林鎮,萬年里,396,389,59.20852359,268,40.79147641,657,25,682,0,836,81.57894737
彰化縣,員林鎮,萬年里,397,352,45.18613607,427,54.81386393,779,30,809,0,993,81.47029204
彰化縣,員林鎮,萬年里,398,418,40.74074074,608,59.25925926,1026,9,1035,0,1227,84.35207824
彰化縣,員林鎮,崙雅里,399,289,34.90338164,539,65.09661836,828,33,861,0,1046,82.31357553
彰化縣,員林鎮,崙雅里,400,458,48.0587618,495,51.9412382,953,36,989,0,1191,83.03946264
彰化縣,員林鎮,振興里,401,468,53.73134328,403,46.26865672,871,25,896,0,1114,80.43087971
彰化縣,員林鎮,振興里,402,386,43.37078652,504,56.62921348,890,30,920,0,1145,80.34934498
彰化縣,員林鎮,林厝里,403,429,53.69211514,370,46.30788486,799,32,831,0,1042,79.75047985
彰化縣,員林鎮,林厝里,404,555,57.45341615,411,42.54658385,966,41,1007,0,1225,82.20408163
彰化縣,員林鎮,出水里,405,736,56.70261941,562,43.29738059,1298,58,1356,1,1679,80.76235855
彰化縣,員林鎮,湖水里,406,588,61.50627615,368,38.49372385,956,32,988,0,1288,76.70807453
彰化縣,員林鎮,大峰里,407,273,48.57651246,289,51.42348754,562,19,581,0,737,78.83310719
彰化縣,員林鎮,鎮興里,408,406,52.38709677,369,47.61290323,775,29,804,0,1006,79.92047714
彰化縣,員林鎮,鎮興里,409,313,49.13657771,324,50.86342229,637,20,657,0,818,80.31784841
彰化縣,員林鎮,浮圳里,410,477,54.32801822,401,45.67198178,878,19,897,0,1117,80.30438675
彰化縣,員林鎮,浮圳里,411,336,47.05882353,378,52.94117647,714,20,734,0,917,80.0436205
彰化縣,員林鎮,西東里,412,796,61.08979279,507,38.91020721,1303,36,1339,1,1682,79.60760999
彰化縣,員林鎮,南東里,413,387,53.30578512,339,46.69421488,726,27,753,0,954,78.93081761
彰化縣,員林鎮,南東里,414,298,56.01503759,234,43.98496241,532,21,553,0,692,79.9132948
彰化縣,員林鎮,中東里,415,588,51.89761695,545,48.10238305,1133,46,1179,0,1507,78.23490378
彰化縣,員林鎮,東北里,416,457,54.86194478,376,45.13805522,833,15,848,0,1000,84.8
彰化縣,員林鎮,東北里,417,406,50.75,394,49.25,800,21,821,0,1024,80.17578125
彰化縣,員林鎮,三愛里,383,504,48.09160305,544,51.90839695,1048,22,1070,0,1324,80.81570997
彰化縣,員林鎮,三愛里,384,425,47.22222222,475,52.77777778,900,24,924,0,1122,82.35294118
彰化縣,員林鎮,三信里,385,338,45.49125168,405,54.50874832,743,11,754,0,934,80.72805139
彰化縣,員林鎮,三信里,386,367,47.7243173,402,52.2756827,769,20,789,0,967,81.59255429
彰化縣,員林鎮,三多里,387,365,41.80985109,508,58.19014891,873,12,885,0,1111,79.6579658
彰化縣,員林鎮,三多里,388,381,52.40715268,346,47.59284732,727,19,746,0,896,83.25892857
彰化縣,員林鎮,仁愛里,373,508,47.69953052,557,52.30046948,1065,23,1088,0,1279,85.06645817
彰化縣,員林鎮,忠孝里,374,420,52.36907731,382,47.63092269,802,22,824,0,1004,82.07171315
彰化縣,員林鎮,忠孝里,375,277,41.77978884,386,58.22021116,663,10,673,0,825,81.57575758
彰化縣,員林鎮,中山里,353,300,51.45797599,283,48.54202401,583,15,598,1,711,84.1068917
彰化縣,大村鄉,大村村,418,472,51.64113786,442,48.35886214,914,5,919,0,1106,83.09222423
彰化縣,大村鄉,大村村,419,357,48.57142857,378,51.42857143,735,27,762,0,960,79.375
彰化縣,大村鄉,茄苳村,420,673,54.75996745,556,45.24003255,1229,47,1276,0,1552,82.21649485
彰化縣,大村鄉,南勢村,426,553,58.45665962,393,41.54334038,946,30,976,0,1196,81.60535117
彰化縣,大村鄉,田洋村,421,362,51.27478754,344,48.72521246,706,31,737,0,912,80.81140351
彰化縣,大村鄉,新興村,425,501,59.64285714,339,40.35714286,840,29,869,0,1115,77.93721973
彰化縣,大村鄉,過溝村,429,380,45.6182473,453,54.3817527,833,17,850,0,1021,83.25171401
彰化縣,大村鄉,過溝村,430,391,44.73684211,483,55.26315789,874,14,888,0,1090,81.46788991
彰化縣,大村鄉,美港村,433,613,53.96126761,523,46.03873239,1136,28,1164,1,1425,81.68421053
彰化縣,大村鄉,美港村,434,416,47.11211778,467,52.88788222,883,27,910,0,1093,83.25709058
彰化縣,大村鄉,平和村,437,489,54.21286031,413,45.78713969,902,40,942,0,1130,83.36283186
彰化縣,大村鄉,平和村,438,337,51.21580547,321,48.78419453,658,42,700,0,879,79.63594994
彰化縣,大村鄉,貢旗村,422,548,52.14081827,503,47.85918173,1051,41,1092,0,1359,80.35320088
彰化縣,大村鄉,加錫村,423,483,49.69135802,489,50.30864198,972,47,1019,0,1256,81.13057325
彰化縣,大村鄉,村上村,432,497,49.55134596,506,50.44865404,1003,34,1037,0,1247,83.159583
彰化縣,大村鄉,大橋村,431,638,46.03174603,748,53.96825397,1386,53,1439,0,1804,79.76718404
彰化縣,大村鄉,大崙村,424,609,55.87155963,481,44.12844037,1090,73,1163,0,1449,80.26224983
彰化縣,大村鄉,擺塘村,427,551,55.32128514,445,44.67871486,996,43,1039,0,1263,82.26444972
彰化縣,大村鄉,擺塘村,428,357,51.88953488,331,48.11046512,688,24,712,0,893,79.731243
彰化縣,大村鄉,黃厝村,435,668,47.61225944,735,52.38774056,1403,54,1457,0,1794,81.21516165
彰化縣,大村鄉,福興村,436,754,55.85185185,596,44.14814815,1350,43,1393,0,1753,79.46377638
彰化縣,永靖鄉,永東村,439,337,50.29850746,333,49.70149254,670,10,680,0,815,83.43558282
彰化縣,永靖鄉,永西村,440,595,50.5952381,581,49.4047619,1176,34,1210,0,1459,82.93351611
彰化縣,永靖鄉,永南村,441,733,50.7266436,712,49.2733564,1445,57,1502,0,1841,81.58609451
彰化縣,永靖鄉,永北村,442,767,52.67857143,689,47.32142857,1456,41,1497,0,1901,78.74802735
彰化縣,永靖鄉,港西村,443,626,48.791894,657,51.208106,1283,50,1333,0,1645,81.03343465
彰化縣,永靖鄉,五福村,444,576,53.68126747,497,46.31873253,1073,36,1109,0,1367,81.1265545
彰化縣,永靖鄉,湳港村,445,452,60.58981233,294,39.41018767,746,30,776,0,949,81.77028451
彰化縣,永靖鄉,新莊村,446,278,39.88522238,419,60.11477762,697,26,723,0,867,83.39100346
彰化縣,永靖鄉,瑚璉村,447,431,52.49695493,390,47.50304507,821,25,846,0,1050,80.57142857
彰化縣,永靖鄉,瑚璉村,448,414,51.11111111,396,48.88888889,810,25,835,0,1003,83.25024925
彰化縣,永靖鄉,五汴村,449,599,56.08614232,469,43.91385768,1068,31,1099,0,1345,81.71003717
彰化縣,永靖鄉,浮圳村,450,416,48.71194379,438,51.28805621,854,41,895,0,1076,83.17843866
彰化縣,永靖鄉,光雲村,451,725,59.42622951,495,40.57377049,1220,61,1281,0,1551,82.59187621
彰化縣,永靖鄉,東寧村,452,665,52.81969817,594,47.18030183,1259,53,1312,0,1645,79.75683891
彰化縣,永靖鄉,永興村,453,583,48.78661088,612,51.21338912,1195,52,1247,0,1518,82.14756258
彰化縣,永靖鄉,崙子村,454,565,61.14718615,359,38.85281385,924,30,954,0,1176,81.12244898
彰化縣,永靖鄉,獨鰲村,455,357,55.60747664,285,44.39252336,642,40,682,0,846,80.61465721
彰化縣,永靖鄉,敦厚村,456,273,49.10071942,283,50.89928058,556,23,579,0,717,80.75313808
彰化縣,永靖鄉,崙美村,457,335,55.46357616,269,44.53642384,604,23,627,0,748,83.82352941
彰化縣,永靖鄉,同安村,458,252,46.32352941,292,53.67647059,544,20,564,0,682,82.69794721
彰化縣,永靖鄉,同仁村,459,350,48.54368932,371,51.45631068,721,28,749,0,945,79.25925926
彰化縣,永靖鄉,湳墘村,460,293,46.14173228,342,53.85826772,635,34,669,0,832,80.40865385
彰化縣,永靖鄉,四芳村,461,250,48.73294347,263,51.26705653,513,32,545,0,680,80.14705882
彰化縣,永靖鄉,福興村,462,394,44.02234637,501,55.97765363,895,39,934,0,1143,81.71478565
彰化縣,永靖鄉,竹子村,463,708,65.67717996,370,34.32282004,1078,12,1090,0,1349,80.80059303
彰化縣,溪湖鎮,光平里,464,490,50.05107252,489,49.94892748,979,29,1008,0,1221,82.55528256
彰化縣,溪湖鎮,平和里,465,313,48.90625,327,51.09375,640,12,652,0,754,86.47214854
彰化縣,溪湖鎮,太平里,466,541,48.95927602,564,51.04072398,1105,23,1128,0,1391,81.09273904
彰化縣,溪湖鎮,光華里,467,181,45.25,219,54.75,400,8,408,0,491,83.09572301
彰化縣,溪湖鎮,東寮里,468,459,44.17709336,580,55.82290664,1039,26,1065,0,1338,79.59641256
彰化縣,溪湖鎮,東寮里,469,494,42.95652174,656,57.04347826,1150,28,1178,0,1484,79.38005391
彰化縣,溪湖鎮,西寮里,470,314,47.57575758,346,52.42424242,660,16,676,0,875,77.25714286
彰化縣,溪湖鎮,西寮里,471,323,42.33289646,440,57.66710354,763,33,796,0,978,81.39059305
彰化縣,溪湖鎮,大突里,472,398,46.2253194,463,53.7746806,861,20,881,1,1105,79.72850679
彰化縣,溪湖鎮,大突里,473,408,48.86227545,427,51.13772455,835,25,860,0,1082,79.48243993
彰化縣,溪湖鎮,北勢里,474,577,58.81753313,404,41.18246687,981,43,1024,0,1254,81.65869219
彰化縣,溪湖鎮,汴頭里,475,554,56.41547862,428,43.58452138,982,37,1019,0,1282,79.48517941
彰化縣,溪湖鎮,汴頭里,476,423,50.78031212,410,49.21968788,833,18,851,0,1051,80.97050428
彰化縣,溪湖鎮,大竹里,477,414,42.99065421,549,57.00934579,963,18,981,0,1201,81.68193172
彰化縣,溪湖鎮,大竹里,478,410,48.98446834,427,51.01553166,837,30,867,0,1064,81.48496241
彰化縣,溪湖鎮,湖西里,479,327,46.31728045,379,53.68271955,706,16,722,0,918,78.64923747
彰化縣,溪湖鎮,湖西里,480,378,48.71134021,398,51.28865979,776,23,799,0,1001,79.82017982
彰化縣,溪湖鎮,田中里,481,333,54.59016393,277,45.40983607,610,33,643,0,769,83.61508453
彰化縣,溪湖鎮,河東里,482,667,51.11111111,638,48.88888889,1305,65,1370,0,1631,83.99754752
彰化縣,溪湖鎮,中山里,483,443,51.09573241,424,48.90426759,867,30,897,0,1109,80.88367899
彰化縣,溪湖鎮,中山里,484,455,54.03800475,387,45.96199525,842,33,875,0,1113,78.6163522
彰化縣,溪湖鎮,中竹里,485,331,53.21543408,291,46.78456592,622,26,648,0,783,82.75862069
彰化縣,溪湖鎮,東溪里,486,648,64.92985972,350,35.07014028,998,34,1032,0,1262,81.77496038
彰化縣,溪湖鎮,西溪里,487,583,49.44868533,596,50.55131467,1179,43,1222,0,1527,80.02619515
彰化縣,溪湖鎮,湖東里,488,525,54.17956656,444,45.82043344,969,35,1004,0,1226,81.89233279
彰化縣,溪湖鎮,湖東里,489,502,53.68983957,433,46.31016043,935,39,974,2,1251,77.85771383
彰化縣,溪湖鎮,湖東里,490,467,51.31868132,443,48.68131868,910,33,943,0,1133,83.23036187
彰化縣,溪湖鎮,頂庄里,491,223,45.23326572,270,54.76673428,493,21,514,0,649,79.19876733
彰化縣,溪湖鎮,忠覺里,492,446,47.14587738,500,52.85412262,946,45,991,1,1224,80.96405229
彰化縣,溪湖鎮,湳底里,493,305,54.1740675,258,45.8259325,563,27,590,0,734,80.38147139
彰化縣,溪湖鎮,大庭里,494,407,41.53061224,573,58.46938776,980,34,1014,0,1264,80.22151899
彰化縣,溪湖鎮,媽厝里,495,567,56.19425173,442,43.80574827,1009,51,1060,1,1323,80.12093726
彰化縣,溪湖鎮,西勢里,496,327,55.80204778,259,44.19795222,586,23,609,0,741,82.18623482
彰化縣,溪湖鎮,西勢里,497,472,52.61984392,425,47.38015608,897,27,924,0,1169,79.04191617
彰化縣,溪湖鎮,番婆里,498,591,51.93321617,547,48.06678383,1138,45,1183,0,1519,77.88018433
彰化縣,埔鹽鄉,埔鹽村,499,581,50,581,50,1162,55,1217,1,1525,79.80327869
彰化縣,埔鹽鄉,埔南村,500,559,49.95531725,560,50.04468275,1119,53,1172,0,1473,79.56551256
彰化縣,埔鹽鄉,部子村,501,397,43.34061135,519,56.65938865,916,33,949,0,1155,82.16450216
彰化縣,埔鹽鄉,出水村,502,283,45.06369427,345,54.93630573,628,18,646,0,806,80.14888337
彰化縣,埔鹽鄉,南港村,503,733,55.99694423,576,44.00305577,1309,39,1348,0,1627,82.85187462
彰化縣,埔鹽鄉,打廉村,504,405,54.28954424,341,45.71045576,746,38,784,0,931,84.21052632
彰化縣,埔鹽鄉,豐澤村,505,562,55.31496063,454,44.68503937,1016,35,1051,0,1290,81.47286822
彰化縣,埔鹽鄉,崑崙村,506,368,47.85435631,401,52.14564369,769,40,809,0,1034,78.23984526
彰化縣,埔鹽鄉,角樹村,507,257,44.93006993,315,55.06993007,572,25,597,0,711,83.96624473
彰化縣,埔鹽鄉,瓦窯村,508,439,48.34801762,469,51.65198238,908,14,922,0,1164,79.20962199
彰化縣,埔鹽鄉,好修村,509,395,38.34951456,635,61.65048544,1030,26,1056,1,1334,79.16041979
彰化縣,埔鹽鄉,西湖村,510,741,49.8989899,744,50.1010101,1485,67,1552,0,1955,79.38618926
彰化縣,埔鹽鄉,大有村,511,480,49.43357364,491,50.56642636,971,43,1014,0,1252,80.99041534
彰化縣,埔鹽鄉,新興村,512,121,39.54248366,185,60.45751634,306,7,313,0,396,79.04040404
彰化縣,埔鹽鄉,永平村,513,390,49.05660377,405,50.94339623,795,40,835,0,1041,80.21133525
彰化縣,埔鹽鄉,永樂村,514,304,49.83606557,306,50.16393443,610,26,636,0,766,83.02872063
彰化縣,埔鹽鄉,石埤村,515,527,55.53213909,422,44.46786091,949,83,1032,0,1307,78.95944912
彰化縣,埔鹽鄉,天盛村,516,232,37.72357724,383,62.27642276,615,29,644,0,834,77.21822542
彰化縣,埔鹽鄉,太平村,517,504,46.9273743,570,53.0726257,1074,61,1135,0,1460,77.73972603
彰化縣,埔鹽鄉,新水村,518,380,34.60837887,718,65.39162113,1098,30,1128,1,1379,81.79840464
彰化縣,埔鹽鄉,三省村,519,402,41.74454829,561,58.25545171,963,42,1005,0,1269,79.19621749
彰化縣,埔鹽鄉,南新村,520,345,36.54661017,599,63.45338983,944,42,986,0,1245,79.19678715
彰化縣,埔心鄉,東門村,521,532,55.24402908,431,44.75597092,963,21,984,0,1198,82.13689482
彰化縣,埔心鄉,東門村,522,603,53.41009743,526,46.58990257,1129,36,1165,0,1437,81.07167711
彰化縣,埔心鄉,埔心村,523,509,57.70975057,373,42.29024943,882,34,916,0,1188,77.1043771
彰化縣,埔心鄉,義民村,524,577,49.65576592,585,50.34423408,1162,38,1200,0,1437,83.50730689
彰化縣,埔心鄉,油車村,525,458,51.17318436,437,48.82681564,895,30,925,1,1131,81.78603006
彰化縣,埔心鄉,瓦北村,526,675,54.17335474,571,45.82664526,1246,37,1283,0,1588,80.79345088
彰化縣,埔心鄉,瓦中村,527,742,53.8071066,637,46.1928934,1379,48,1427,0,1723,82.82066164
彰化縣,埔心鄉,瓦南村,528,604,56.50140318,465,43.49859682,1069,42,1111,0,1327,83.72268274
彰化縣,埔心鄉,太平村,530,836,59.71428571,564,40.28571429,1400,75,1475,0,1769,83.38044093
彰化縣,埔心鄉,經口村,529,808,62.05837174,494,37.94162826,1302,56,1358,0,1673,81.17154812
彰化縣,埔心鄉,大華村,531,262,54.24430642,221,45.75569358,483,17,500,0,601,83.19467554
彰化縣,埔心鄉,仁里村,532,418,51.54130703,393,48.45869297,811,38,849,0,1068,79.49438202
彰化縣,埔心鄉,舊館村,533,508,56.63322185,389,43.36677815,897,36,933,0,1150,81.13043478
彰化縣,埔心鄉,南館村,534,373,59.96784566,249,40.03215434,622,29,651,0,790,82.40506329
彰化縣,埔心鄉,新館村,535,385,55.31609195,311,44.68390805,696,33,729,0,898,81.18040089
彰化縣,埔心鄉,羅厝村,537,581,58.15815816,418,41.84184184,999,53,1052,0,1329,79.1572611
彰化縣,埔心鄉,芎蕉村,536,835,61.94362018,513,38.05637982,1348,15,1363,0,1678,81.22765197
彰化縣,埔心鄉,二重村,539,607,60.63936064,394,39.36063936,1001,11,1012,0,1203,84.12302577
彰化縣,埔心鄉,梧鳳村,538,358,52.88035451,319,47.11964549,677,29,706,0,873,80.87056128
彰化縣,埔心鄉,埤霞村,540,325,53.89718076,278,46.10281924,603,31,634,0,766,82.76762402
彰化縣,埔心鄉,埤腳村,541,357,52.73264402,320,47.26735598,677,36,713,0,846,84.27895981
彰化縣,田中鎮,香山里,542,391,59.15279879,270,40.84720121,661,35,696,0,870,80
彰化縣,田中鎮,碧峰里,543,296,43.59351988,383,56.40648012,679,51,730,0,1025,71.2195122
彰化縣,田中鎮,碧峰里,544,16,3.219315895,481,96.7806841,497,62,559,0,1118,50
彰化縣,田中鎮,東源里,545,250,51.65289256,234,48.34710744,484,29,513,0,649,79.04468413
彰化縣,田中鎮,復興里,546,536,46.16709733,625,53.83290267,1161,28,1189,0,1494,79.58500669
彰化縣,田中鎮,平和里,547,575,50.08710801,573,49.91289199,1148,43,1191,0,1472,80.91032609
彰化縣,田中鎮,頂潭里,548,530,55.907173,418,44.092827,948,38,986,0,1232,80.03246753
彰化縣,田中鎮,中潭里,549,718,55.83203733,568,44.16796267,1286,45,1331,0,1696,78.47877358
彰化縣,田中鎮,龍潭里,550,291,58.08383234,210,41.91616766,501,21,522,0,654,79.81651376
彰化縣,田中鎮,北路里,551,590,46.31083203,684,53.68916797,1274,46,1320,1,1670,79.04191617
彰化縣,田中鎮,北路里,552,457,49.13978495,473,50.86021505,930,14,944,0,1128,83.68794326
彰化縣,田中鎮,西路里,553,379,55.65345081,302,44.34654919,681,14,695,0,864,80.43981481
彰化縣,田中鎮,西路里,554,507,49.65719882,514,50.34280118,1021,28,1049,0,1267,82.79400158
彰化縣,田中鎮,東路里,555,485,54.86425339,399,45.13574661,884,15,899,0,1094,82.17550274
彰化縣,田中鎮,南路里,556,546,52.7027027,490,47.2972973,1036,21,1057,0,1278,82.70735524
彰化縣,田中鎮,中路里,557,364,51.92582026,337,48.07417974,701,9,710,0,898,79.06458797
彰化縣,田中鎮,中路里,558,405,47.53521127,447,52.46478873,852,24,876,0,1095,80
彰化縣,田中鎮,新庄里,559,370,50.61559508,361,49.38440492,731,23,754,0,967,77.97311272
彰化縣,田中鎮,新庄里,560,410,47.72991851,449,52.27008149,859,22,881,0,1081,81.4986124
彰化縣,田中鎮,三安里,561,756,62.27347611,458,37.72652389,1214,39,1253,0,1616,77.53712871
彰化縣,田中鎮,大崙里,562,554,56.58835546,425,43.41164454,979,49,1028,0,1316,78.11550152
彰化縣,田中鎮,沙崙里,563,642,51.89975748,595,48.10024252,1237,63,1300,0,1643,79.12355447
彰化縣,田中鎮,新民里,564,661,48.63870493,698,51.36129507,1359,36,1395,1,1707,81.72231986
彰化縣,田中鎮,新民里,565,647,49.69278034,655,50.30721966,1302,34,1336,0,1702,78.49588719
彰化縣,田中鎮,梅州里,566,604,59.98013903,403,40.01986097,1007,41,1048,0,1323,79.21390779
彰化縣,田中鎮,三民里,567,563,48.78682842,591,51.21317158,1154,50,1204,0,1523,79.0544977
彰化縣,田中鎮,三光里,568,384,55.41125541,309,44.58874459,693,29,722,0,888,81.30630631
彰化縣,田中鎮,大社里,569,383,59.37984496,262,40.62015504,645,21,666,0,817,81.51774786
彰化縣,社頭鄉,社頭村,570,573,56.73267327,437,43.26732673,1010,25,1035,0,1271,81.43194335
彰化縣,社頭鄉,社頭村,571,594,54.89833641,488,45.10166359,1082,19,1101,0,1304,84.43251534
彰化縣,社頭鄉,東興村,582,538,55.29290853,435,44.70709147,973,46,1019,0,1242,82.04508857
彰化縣,社頭鄉,山湖村,590,548,67.15686275,268,32.84313725,816,31,847,0,992,85.38306452
彰化縣,社頭鄉,廣興村,572,540,59.27552141,371,40.72447859,911,28,939,0,1151,81.58123371
彰化縣,社頭鄉,廣興村,573,648,59.88909427,434,40.11090573,1082,42,1124,0,1373,81.86453023
彰化縣,社頭鄉,廣興村,574,573,56.62055336,439,43.37944664,1012,18,1030,0,1245,82.73092369
彰化縣,社頭鄉,廣福村,583,362,53.86904762,310,46.13095238,672,27,699,0,824,84.83009709
彰化縣,社頭鄉,朝興村,591,413,50.799508,400,49.200492,813,38,851,0,1021,83.3496572
彰化縣,社頭鄉,仁雅村,575,417,52.1902378,382,47.8097622,799,21,820,0,1011,81.10781405
彰化縣,社頭鄉,仁雅村,576,626,53.55004277,543,46.44995723,1169,31,1200,0,1459,82.24811515
彰化縣,社頭鄉,橋頭村,584,893,58.21382008,641,41.78617992,1534,60,1594,0,1903,83.76248029
彰化縣,社頭鄉,仁和村,592,258,50.88757396,249,49.11242604,507,28,535,0,685,78.10218978
彰化縣,社頭鄉,崙雅村,577,319,50.31545741,315,49.68454259,634,15,649,0,803,80.82191781
彰化縣,社頭鄉,湳底村,585,710,60.52855925,463,39.47144075,1173,36,1209,0,1476,81.91056911
彰化縣,社頭鄉,泰安村,593,337,47.86931818,367,52.13068182,704,28,732,0,892,82.06278027
彰化縣,社頭鄉,美雅村,578,433,52.1686747,397,47.8313253,830,28,858,0,1037,82.73866924
彰化縣,社頭鄉,新厝村,586,630,58.01104972,456,41.98895028,1086,53,1139,0,1401,81.29907209
彰化縣,社頭鄉,平和村,594,409,53.39425587,357,46.60574413,766,31,797,0,947,84.16050686
彰化縣,社頭鄉,里仁村,579,425,50.23640662,421,49.76359338,846,33,879,0,1075,81.76744186
彰化縣,社頭鄉,張厝村,587,515,57.60626398,379,42.39373602,894,18,912,0,1113,81.94070081
彰化縣,社頭鄉,龍井村,595,359,57.34824281,267,42.65175719,626,27,653,0,800,81.625
彰化縣,社頭鄉,舊社村,580,666,59.9459946,445,40.0540054,1111,35,1146,0,1410,81.27659574
彰化縣,社頭鄉,埤斗村,588,422,55.16339869,343,44.83660131,765,30,795,0,991,80.22199798
彰化縣,社頭鄉,湳雅村,596,609,56.91588785,461,43.08411215,1070,50,1120,0,1377,81.3362382
彰化縣,社頭鄉,松竹村,581,424,57.21997301,317,42.78002699,741,37,778,0,944,82.41525424
彰化縣,社頭鄉,清水村,589,398,47.43742551,441,52.56257449,839,35,874,0,1062,82.29755179
彰化縣,社頭鄉,協和村,597,849,55.49019608,681,44.50980392,1530,64,1594,0,1935,82.37726098
彰化縣,二水鄉,合和村,600,346,52.50379363,313,47.49620637,659,33,692,0,877,78.90535918
彰化縣,二水鄉,上豊村,601,467,58.15691158,336,41.84308842,803,32,835,1,1033,80.83252662
彰化縣,二水鄉,過圳村,602,259,49.52198853,264,50.47801147,523,17,540,0,650,83.07692308
彰化縣,二水鄉,五伯村,603,300,55.24861878,243,44.75138122,543,30,573,0,669,85.65022422
彰化縣,二水鄉,光化村,604,406,51.85185185,377,48.14814815,783,22,805,0,979,82.226762
彰化縣,二水鄉,文化村,605,387,46.85230024,439,53.14769976,826,21,847,0,1026,82.55360624
彰化縣,二水鄉,二水村,606,336,48.76632801,353,51.23367199,689,25,714,0,888,80.40540541
彰化縣,二水鄉,聖化村,607,171,43.18181818,225,56.81818182,396,8,404,0,503,80.31809145
彰化縣,二水鄉,裕民村,608,406,57.34463277,302,42.65536723,708,28,736,0,951,77.39221872
彰化縣,二水鄉,惠民村,609,409,61.31934033,258,38.68065967,667,29,696,0,870,80
彰化縣,二水鄉,大園村,610,411,64.92890995,222,35.07109005,633,24,657,0,786,83.58778626
彰化縣,二水鄉,修仁村,611,324,51.84,301,48.16,625,36,661,0,803,82.31631382
彰化縣,二水鄉,合興村,612,369,64.28571429,205,35.71428571,574,29,603,0,745,80.93959732
彰化縣,二水鄉,源泉村,613,248,49.6993988,251,50.3006012,499,21,520,0,669,77.72795217
彰化縣,二水鄉,倡和村,614,251,51.96687371,232,48.03312629,483,14,497,1,634,78.39116719
彰化縣,二水鄉,復興村,598,533,65.72133169,278,34.27866831,811,34,845,0,1038,81.40655106
彰化縣,二水鄉,十五村,599,315,58.11808118,227,41.88191882,542,30,572,0,732,78.1420765
彰化縣,北斗鎮,光復里,622,509,46.27272727,591,53.72727273,1100,25,1125,0,1391,80.87706686
彰化縣,北斗鎮,新政里,623,324,49.9229584,325,50.0770416,649,12,661,0,802,82.41895262
彰化縣,北斗鎮,重慶里,624,292,58.05168986,211,41.94831014,503,15,518,0,627,82.61562998
彰化縣,北斗鎮,五權里,625,306,50.83056478,296,49.16943522,602,19,621,0,749,82.9105474
彰化縣,北斗鎮,七星里,626,639,60.2262017,422,39.7737983,1061,39,1100,0,1390,79.13669065
彰化縣,北斗鎮,居仁里,627,499,47.2985782,556,52.7014218,1055,26,1081,0,1324,81.64652568
彰化縣,北斗鎮,東光里,628,762,55.62043796,608,44.37956204,1370,33,1403,0,1726,81.28621089
彰化縣,北斗鎮,文昌里,629,348,46.46194927,401,53.53805073,749,39,788,0,995,79.1959799
彰化縣,北斗鎮,文昌里,630,507,52.593361,457,47.406639,964,38,1002,1,1308,76.60550459
彰化縣,北斗鎮,中和里,631,454,56.53798257,349,43.46201743,803,30,833,0,1045,79.71291866
彰化縣,北斗鎮,西德里,618,557,52.05607477,513,47.94392523,1070,25,1095,0,1303,84.03683807
彰化縣,北斗鎮,西德里,619,483,50.62893082,471,49.37106918,954,17,971,0,1164,83.41924399
彰化縣,北斗鎮,西德里,620,574,52.66055046,516,47.33944954,1090,33,1123,0,1391,80.73328541
彰化縣,北斗鎮,西安里,621,648,53.46534653,564,46.53465347,1212,44,1256,0,1580,79.49367089
彰化縣,北斗鎮,中寮里,615,484,53.95763657,413,46.04236343,897,31,928,0,1160,80
彰化縣,北斗鎮,中寮里,616,534,59.20177384,368,40.79822616,902,41,943,0,1175,80.25531915
彰化縣,北斗鎮,大道里,617,856,61.45010768,537,38.54989232,1393,63,1456,0,1734,83.96770473
彰化縣,北斗鎮,新生里,632,624,49.68152866,632,50.31847134,1256,75,1331,0,1735,76.71469741
彰化縣,北斗鎮,大新里,633,572,50.66430469,557,49.33569531,1129,53,1182,0,1546,76.45536869
彰化縣,溪州鄉,溪厝村,634,394,70.23172906,167,29.76827094,561,41,602,0,770,78.18181818
彰化縣,溪州鄉,溪厝村,635,438,65.08172363,235,34.91827637,673,43,716,0,986,72.61663286
彰化縣,溪州鄉,舊眉村,643,682,67.32477789,331,32.67522211,1013,39,1052,0,1314,80.0608828
彰化縣,溪州鄉,柑園村,652,415,50.486618,407,49.513382,822,58,880,0,1124,78.29181495
彰化縣,溪州鄉,水尾村,658,706,74.63002114,240,25.36997886,946,37,983,0,1283,76.6173032
彰化縣,溪州鄉,坑厝村,636,356,70.35573123,150,29.64426877,506,33,539,0,676,79.73372781
彰化縣,溪州鄉,圳寮村,644,593,57.6848249,435,42.3151751,1028,52,1080,0,1469,73.51940095
彰化縣,溪州鄉,潮洋村,653,449,67.92738275,212,32.07261725,661,60,721,0,966,74.63768116
彰化縣,溪州鄉,瓦厝村,637,500,67.02412869,246,32.97587131,746,26,772,0,959,80.50052138
彰化縣,溪州鄉,西畔村,645,532,63.10794781,311,36.89205219,843,42,885,0,1124,78.7366548
彰化縣,溪州鄉,西畔村,646,453,67.11111111,222,32.88888889,675,47,722,0,921,78.39305103
彰化縣,溪州鄉,張厝村,654,320,62.25680934,194,37.74319066,514,42,556,0,740,75.13513514
彰化縣,溪州鄉,溪州村,638,336,58.13148789,242,41.86851211,578,18,596,0,760,78.42105263
彰化縣,溪州鄉,溪州村,639,340,52.4691358,308,47.5308642,648,26,674,0,858,78.55477855
彰化縣,溪州鄉,成功村,647,424,60.14184397,281,39.85815603,705,47,752,0,943,79.74549311
彰化縣,溪州鄉,成功村,648,381,57.72727273,279,42.27272727,660,21,681,0,885,76.94915254
彰化縣,溪州鄉,菜公村,655,416,61.99701937,255,38.00298063,671,39,710,0,895,79.32960894
彰化縣,溪州鄉,尾厝村,640,608,57.79467681,444,42.20532319,1052,37,1089,0,1395,78.06451613
彰化縣,溪州鄉,大庄村,649,395,58.00293686,286,41.99706314,681,40,721,0,933,77.27759914
彰化縣,溪州鄉,大庄村,650,462,66.85962373,229,33.14037627,691,48,739,0,971,76.10710608
彰化縣,溪州鄉,三圳村,656,589,65.59020045,309,34.40979955,898,52,950,0,1203,78.96924356
彰化縣,溪州鄉,東州村,641,367,61.06489185,234,38.93510815,601,43,644,0,818,78.72860636
彰化縣,溪州鄉,東州村,642,435,63.7829912,247,36.2170088,682,43,725,0,890,81.46067416
彰化縣,溪州鄉,榮光村,651,202,33.00653595,410,66.99346405,612,28,640,0,801,79.90012484
彰化縣,溪州鄉,三條村,657,517,73.33333333,188,26.66666667,705,36,741,0,886,83.63431151
彰化縣,田尾鄉,田尾村,659,466,51.89309577,432,48.10690423,898,42,940,0,1231,76.36068237
彰化縣,田尾鄉,豐田村,660,256,46.54545455,294,53.45454545,550,20,570,0,680,83.82352941
彰化縣,田尾鄉,饒平村,661,789,50.51216389,773,49.48783611,1562,45,1607,1,2026,79.31885489
彰化縣,田尾鄉,睦宜村,664,362,48.07436919,391,51.92563081,753,37,790,0,1020,77.45098039
彰化縣,田尾鄉,福田村,668,352,53.74045802,303,46.25954198,655,36,691,0,855,80.81871345
彰化縣,田尾鄉,新興村,669,427,53.84615385,366,46.15384615,793,30,823,0,1007,81.72790467
彰化縣,田尾鄉,北鎮村,666,406,52.65888457,365,47.34111543,771,39,810,0,1014,79.8816568
彰化縣,田尾鄉,南鎮村,667,266,54.39672802,223,45.60327198,489,28,517,0,655,78.93129771
彰化縣,田尾鄉,新生村,665,491,53.42763874,428,46.57236126,919,35,954,0,1159,82.31233822
彰化縣,田尾鄉,南曾村,663,529,58.25991189,379,41.74008811,908,45,953,0,1200,79.41666667
彰化縣,田尾鄉,北曾村,662,541,54.92385787,444,45.07614213,985,42,1027,0,1274,80.6122449
彰化縣,田尾鄉,溪畔村,670,543,57.76595745,397,42.23404255,940,40,980,0,1232,79.54545455
彰化縣,田尾鄉,打簾村,671,720,55.55555556,576,44.44444444,1296,62,1358,0,1694,80.16528926
彰化縣,田尾鄉,柳鳳村,672,291,44.90740741,357,55.09259259,648,39,687,0,811,84.71023428
彰化縣,田尾鄉,陸豐村,673,341,50,341,50,682,34,716,0,873,82.01603666
彰化縣,田尾鄉,海豐村,674,573,53.45149254,499,46.54850746,1072,54,1126,0,1459,77.17614805
彰化縣,田尾鄉,仁里村,675,575,48.6463621,607,51.3536379,1182,58,1240,0,1554,79.79407979
彰化縣,田尾鄉,新厝村,676,101,44.49339207,126,55.50660793,227,6,233,0,294,79.25170068
彰化縣,田尾鄉,溪頂村,677,275,57.77310924,201,42.22689076,476,29,505,0,636,79.40251572
彰化縣,田尾鄉,正義村,678,299,50.85034014,289,49.14965986,588,23,611,0,731,83.58413133
彰化縣,埤頭鄉,和豊村,679,447,60.2425876,295,39.7574124,742,41,783,0,1004,77.98804781
彰化縣,埤頭鄉,和豊村,680,471,50.10638298,469,49.89361702,940,49,989,0,1296,76.3117284
彰化縣,埤頭鄉,興農村,681,631,54.25623388,532,45.74376612,1163,65,1228,0,1567,78.36630504
彰化縣,埤頭鄉,埤頭村,682,740,62.71186441,440,37.28813559,1180,59,1239,0,1589,77.97356828
彰化縣,埤頭鄉,豊崙村,683,302,44.34654919,379,55.65345081,681,55,736,1,956,76.9874477
彰化縣,埤頭鄉,豊崙村,684,362,43.30143541,474,56.69856459,836,44,880,0,1192,73.82550336
彰化縣,埤頭鄉,崙子村,685,453,53.35689046,396,46.64310954,849,52,901,0,1159,77.73943054
彰化縣,埤頭鄉,永豊村,686,590,56.35148042,457,43.64851958,1047,86,1133,0,1467,77.23244717
彰化縣,埤頭鄉,合興村,687,460,44.1882805,581,55.8117195,1041,40,1081,0,1353,79.89652624
彰化縣,埤頭鄉,合興村,688,639,51.99349064,590,48.00650936,1229,57,1286,0,1610,79.8757764
彰化縣,埤頭鄉,平原村,689,613,50.91362126,591,49.08637874,1204,59,1263,0,1635,77.24770642
彰化縣,埤頭鄉,崙腳村,690,314,61.93293886,193,38.06706114,507,42,549,0,695,78.99280576
彰化縣,埤頭鄉,元埔村,691,244,53.98230088,208,46.01769912,452,26,478,0,598,79.93311037
彰化縣,埤頭鄉,芙朝村,692,588,51.26416739,559,48.73583261,1147,72,1219,0,1645,74.10334347
彰化縣,埤頭鄉,新庄村,693,614,72.0657277,238,27.9342723,852,50,902,1,1167,77.29220223
彰化縣,埤頭鄉,陸嘉村,694,375,65.55944056,197,34.44055944,572,50,622,0,820,75.85365854
彰化縣,埤頭鄉,竹圍村,695,439,66.21417798,224,33.78582202,663,37,700,0,906,77.26269316
彰化縣,埤頭鄉,中和村,696,662,67.34486267,321,32.65513733,983,51,1034,0,1336,77.39520958
彰化縣,埤頭鄉,庄內村,697,504,72.30989957,193,27.69010043,697,52,749,0,961,77.9396462
彰化縣,埤頭鄉,大湖村,698,504,69.80609418,218,30.19390582,722,38,760,0,990,76.76767677
彰化縣,二林鎮,東和里,699,333,49.04270987,346,50.95729013,679,18,697,0,851,81.90364277
彰化縣,二林鎮,東和里,700,457,49.08700322,474,50.91299678,931,36,967,0,1226,78.87438825
彰化縣,二林鎮,南光里,701,462,45.1171875,562,54.8828125,1024,38,1062,0,1333,79.66991748
彰化縣,二林鎮,南光里,702,465,39.07563025,725,60.92436975,1190,29,1219,0,1539,79.20727745
彰化縣,二林鎮,西平里,703,469,47.37373737,521,52.62626263,990,37,1027,0,1328,77.33433735
彰化縣,二林鎮,北平里,704,454,49.40152339,465,50.59847661,919,41,960,0,1244,77.17041801
彰化縣,二林鎮,北平里,705,483,45.60906516,576,54.39093484,1059,64,1123,0,1467,76.55078391
彰化縣,二林鎮,中西里,706,448,39.6460177,682,60.3539823,1130,84,1214,0,1648,73.66504854
彰化縣,二林鎮,廣興里,707,615,58.85167464,430,41.14832536,1045,84,1129,0,1481,76.23227549
彰化縣,二林鎮,香田里,708,538,62.92397661,317,37.07602339,855,54,909,0,1192,76.25838926
彰化縣,二林鎮,外竹里,709,353,43.58024691,457,56.41975309,810,37,847,0,1083,78.20867959
彰化縣,二林鎮,興華里,710,292,36.00493218,519,63.99506782,811,56,867,0,1115,77.75784753
彰化縣,二林鎮,東興里,711,421,46.8298109,478,53.1701891,899,36,935,0,1214,77.01812191
彰化縣,二林鎮,後厝里,712,425,49.13294798,440,50.86705202,865,60,925,0,1253,73.82282522
彰化縣,二林鎮,後厝里,713,380,42.03539823,524,57.96460177,904,20,924,0,1177,78.5046729
彰化縣,二林鎮,豐田里,714,252,51.42857143,238,48.57142857,490,34,524,0,709,73.90691114
彰化縣,二林鎮,豐田里,715,452,44.09756098,573,55.90243902,1025,38,1063,0,1383,76.86189443
彰化縣,二林鎮,頂厝里,716,474,48.66529774,500,51.33470226,974,64,1038,0,1403,73.98431932
彰化縣,二林鎮,趙甲里,717,518,43.89830508,662,56.10169492,1180,82,1262,0,1669,75.6141402
彰化縣,二林鎮,振興里,718,414,44.70842333,512,55.29157667,926,47,973,0,1294,75.19319938
彰化縣,二林鎮,萬興里,719,261,42.78688525,349,57.21311475,610,29,639,0,813,78.59778598
彰化縣,二林鎮,永興里,720,589,50.68846816,573,49.31153184,1162,57,1219,0,1566,77.84163474
彰化縣,二林鎮,西庄里,721,575,61.3660619,362,38.6339381,937,49,986,0,1265,77.94466403
彰化縣,二林鎮,梅芳里,722,419,51.28518972,398,48.71481028,817,57,874,0,1101,79.38237965
彰化縣,二林鎮,華崙里,723,307,34.61104848,580,65.38895152,887,43,930,1,1196,77.75919732
彰化縣,二林鎮,華崙里,724,398,46.38694639,460,53.61305361,858,33,891,0,1167,76.3496144
彰化縣,二林鎮,華崙里,725,344,40.75829384,500,59.24170616,844,53,897,0,1184,75.76013514
彰化縣,二林鎮,東勢里,727,329,46.86609687,373,53.13390313,702,63,765,0,1004,76.19521912
彰化縣,二林鎮,萬合里,726,377,39.60084034,575,60.39915966,952,62,1014,0,1336,75.89820359
彰化縣,二林鎮,大永里,728,301,47.47634069,333,52.52365931,634,48,682,0,890,76.62921348
彰化縣,二林鎮,原斗里,729,466,50.76252723,452,49.23747277,918,48,966,0,1237,78.09215845
彰化縣,二林鎮,西斗里,730,361,47.62532982,397,52.37467018,758,46,804,0,1059,75.92067989
彰化縣,二林鎮,東華里,731,377,51.64383562,353,48.35616438,730,47,777,0,1021,76.10186092
彰化縣,二林鎮,復豐里,732,267,48.28209765,286,51.71790235,553,41,594,0,742,80.05390836
彰化縣,芳苑鄉,芳苑村,733,385,55.15759312,313,44.84240688,698,42,740,0,1024,72.265625
彰化縣,芳苑鄉,芳中村,734,205,57.90960452,149,42.09039548,354,27,381,0,529,72.02268431
彰化縣,芳苑鄉,仁愛村,735,298,49.41956882,305,50.58043118,603,43,646,0,885,72.99435028
彰化縣,芳苑鄉,信義村,736,188,45.74209246,223,54.25790754,411,31,442,0,647,68.31530139
彰化縣,芳苑鄉,後寮村,737,266,40.18126888,396,59.81873112,662,48,710,0,969,73.27141383
彰化縣,芳苑鄉,三合村,738,661,48.89053254,691,51.10946746,1352,63,1415,0,1873,75.5472504
彰化縣,芳苑鄉,永興村,739,517,55.89189189,408,44.10810811,925,93,1018,0,1399,72.76626162
彰化縣,芳苑鄉,五俊村,753,181,52.7696793,162,47.2303207,343,19,362,0,561,64.52762923
彰化縣,芳苑鄉,路上村,741,262,52.4,238,47.6,500,45,545,0,748,72.86096257
彰化縣,芳苑鄉,路平村,742,208,39.02439024,325,60.97560976,533,22,555,0,742,74.79784367
彰化縣,芳苑鄉,三成村,743,388,56.06936416,304,43.93063584,692,66,758,0,1002,75.64870259
彰化縣,芳苑鄉,福榮村,744,249,54.24836601,210,45.75163399,459,27,486,0,691,70.33285094
彰化縣,芳苑鄉,頂部村,745,193,50.39164491,190,49.60835509,383,40,423,0,602,70.26578073
彰化縣,芳苑鄉,新街村,740,417,70.91836735,171,29.08163265,588,74,662,0,1013,65.35044423
彰化縣,芳苑鄉,王功村,746,580,70.90464548,238,29.09535452,818,47,865,0,1184,73.05743243
彰化縣,芳苑鄉,王功村,747,394,66.55405405,198,33.44594595,592,51,643,0,911,70.58177827
彰化縣,芳苑鄉,博愛村,748,377,65.33795494,200,34.66204506,577,42,619,0,800,77.375
彰化縣,芳苑鄉,和平村,749,356,65.80406654,185,34.19593346,541,40,581,0,817,71.11383109
彰化縣,芳苑鄉,民生村,751,372,71.81467181,146,28.18532819,518,33,551,0,779,70.73170732
彰化縣,芳苑鄉,興仁村,750,608,69.64490263,265,30.35509737,873,84,957,0,1395,68.60215054
彰化縣,芳苑鄉,新寶村,752,597,56.53409091,459,43.46590909,1056,66,1122,0,1470,76.32653061
彰化縣,芳苑鄉,草湖村,754,494,49.35064935,507,50.64935065,1001,49,1050,0,1428,73.52941176
彰化縣,芳苑鄉,文津村,758,355,50.35460993,350,49.64539007,705,39,744,1,1041,71.46974063
彰化縣,芳苑鄉,建平村,755,338,51.52439024,318,48.47560976,656,43,699,0,920,75.97826087
彰化縣,芳苑鄉,建平村,756,455,52.5404157,411,47.4595843,866,45,911,0,1176,77.46598639
彰化縣,芳苑鄉,崙腳村,757,214,43.0583501,283,56.9416499,497,23,520,0,720,72.22222222
彰化縣,芳苑鄉,新生村,759,562,63.35963923,325,36.64036077,887,66,953,0,1362,69.97063142
彰化縣,芳苑鄉,漢寶村,760,672,58.53658537,476,41.46341463,1148,63,1211,0,1584,76.4520202
彰化縣,芳苑鄉,漢寶村,761,537,57.1884984,402,42.8115016,939,63,1002,0,1333,75.1687922
彰化縣,大城鄉,潭墘村,762,556,62.6832018,331,37.3167982,887,67,954,0,1334,71.51424288
彰化縣,大城鄉,上山村,767,201,46.42032333,232,53.57967667,433,17,450,0,653,68.91271057
彰化縣,大城鄉,上山村,768,179,47.22955145,200,52.77044855,379,24,403,0,574,70.20905923
彰化縣,大城鄉,東城村,765,424,48.84792627,444,51.15207373,868,41,909,0,1269,71.63120567
彰化縣,大城鄉,西城村,764,283,48.29351536,303,51.70648464,586,48,634,0,864,73.37962963
彰化縣,大城鄉,大城村,766,341,44.80946124,420,55.19053876,761,31,792,0,1070,74.01869159
彰化縣,大城鄉,菜寮村,774,298,38.7012987,472,61.2987013,770,60,830,0,1196,69.39799331
彰化縣,大城鄉,山腳村,763,435,47.48908297,481,52.51091703,916,80,996,0,1447,68.83206634
彰化縣,大城鄉,永和村,769,233,44.38095238,292,55.61904762,525,7,532,0,757,70.27741083
彰化縣,大城鄉,頂庄村,777,288,56.0311284,226,43.9688716,514,49,563,0,811,69.42046856
彰化縣,大城鄉,公館村,770,147,47.72727273,161,52.27272727,308,21,329,0,466,70.60085837
彰化縣,大城鄉,公館村,771,204,40.3960396,301,59.6039604,505,32,537,0,775,69.29032258
彰化縣,大城鄉,臺西村,778,396,58.32106038,283,41.67893962,679,67,746,0,1012,73.71541502
彰化縣,大城鄉,東港村,775,334,39.43329398,513,60.56670602,847,66,913,0,1350,67.62962963
彰化縣,大城鄉,西港村,776,289,41.10953058,414,58.89046942,703,49,752,0,1096,68.61313869
彰化縣,大城鄉,豐美村,772,335,54.56026059,279,45.43973941,614,67,681,0,923,73.78114843
彰化縣,大城鄉,三豐村,773,213,47.12389381,239,52.87610619,452,40,492,1,749,65.68758344
彰化縣,竹塘鄉,竹元村,779,458,57.03611457,345,42.96388543,803,27,830,0,1105,75.11312217
彰化縣,竹塘鄉,竹塘村,780,653,49.695586,661,50.304414,1314,26,1340,0,1689,79.33688573
彰化縣,竹塘鄉,小西村,781,298,49.17491749,308,50.82508251,606,30,636,0,815,78.03680982
彰化縣,竹塘鄉,民靖村,782,257,45.89285714,303,54.10714286,560,33,593,0,808,73.39108911
彰化縣,竹塘鄉,五庄村,783,759,68.9373297,342,31.0626703,1101,66,1167,0,1530,76.2745098
彰化縣,竹塘鄉,樹腳村,784,335,65.94488189,173,34.05511811,508,21,529,0,653,81.01071975
彰化縣,竹塘鄉,田頭村,785,439,63.34776335,254,36.65223665,693,37,730,0,992,73.58870968
彰化縣,竹塘鄉,新廣村,786,554,64.04624277,311,35.95375723,865,53,918,0,1181,77.73073666
彰化縣,竹塘鄉,溪墘村,787,243,61.6751269,151,38.3248731,394,33,427,0,563,75.84369449
彰化縣,竹塘鄉,竹林村,788,365,57.84469097,266,42.15530903,631,25,656,0,894,73.37807606
彰化縣,竹塘鄉,土庫村,789,325,63.60078278,186,36.39921722,511,35,546,0,734,74.38692098
彰化縣,竹塘鄉,內新村,790,314,68.11279826,147,31.88720174,461,34,495,0,674,73.4421365
彰化縣,竹塘鄉,長安村,791,350,64.57564576,192,35.42435424,542,35,577,0,788,73.22335025
彰化縣,竹塘鄉,永安村,792,311,65.06276151,167,34.93723849,478,28,506,0,692,73.12138728
南投縣,南投市,龍泉里,1,402,53.67156208,347,46.32843792,749,10,759,0,946,80.23255814
南投縣,南投市,康壽里,2,524,49.01777362,545,50.98222638,1069,20,1089,0,1369,79.54711468
南投縣,南投市,三民里,3,274,41.89602446,380,58.10397554,654,15,669,0,797,83.93977415
南投縣,南投市,仁和里,4,261,57.23684211,195,42.76315789,456,17,473,0,547,86.47166362
南投縣,南投市,南投里,5,303,55.39305302,244,44.60694698,547,11,558,0,690,80.86956522
南投縣,南投市,彰仁里,6,216,58.37837838,154,41.62162162,370,6,376,0,445,84.49438202
南投縣,南投市,崇文里,7,430,50.88757396,415,49.11242604,845,21,866,1,1056,82.00757576
南投縣,南投市,漳興里,44,446,52.28604924,407,47.71395076,853,16,869,0,1083,80.24007387
南投縣,南投市,漳興里,45,514,50.34280118,507,49.65719882,1021,18,1039,0,1273,81.61822467
南投縣,南投市,漳和里,46,414,41.94528875,573,58.05471125,987,24,1011,0,1279,79.04612979
南投縣,南投市,漳和里,47,703,49.22969188,725,50.77030812,1428,35,1463,0,1815,80.60606061
南投縣,南投市,漳和里,48,429,44.78079332,529,55.21920668,958,25,983,0,1216,80.83881579
南投縣,南投市,漳和里,49,582,47.24025974,650,52.75974026,1232,33,1265,0,1573,80.41958042
南投縣,南投市,軍功里,23,554,41.40508221,784,58.59491779,1338,36,1374,0,1731,79.37608319
南投縣,南投市,軍功里,24,605,47.08171206,680,52.91828794,1285,24,1309,0,1712,76.46028037
南投縣,南投市,軍功里,25,126,43.90243902,161,56.09756098,287,6,293,0,340,86.17647059
南投縣,南投市,東山里,26,153,48.11320755,165,51.88679245,318,8,326,0,411,79.31873479
南投縣,南投市,平和里,16,424,49.47491249,433,50.52508751,857,23,880,0,1173,75.02131287
南投縣,南投市,平和里,17,458,44.4228904,573,55.5771096,1031,20,1051,1,1311,80.16781083
南投縣,南投市,平和里,18,509,50.29644269,503,49.70355731,1012,29,1041,0,1284,81.07476636
南投縣,南投市,平和里,19,462,41.88576609,641,58.11423391,1103,11,1114,0,1366,81.55197657
南投縣,南投市,振興里,20,238,57.21153846,178,42.78846154,416,17,433,0,550,78.72727273
南投縣,南投市,振興里,21,690,61.82795699,426,38.17204301,1116,22,1138,0,1438,79.13769124
南投縣,南投市,千秋里,22,358,55.07692308,292,44.92307692,650,12,662,0,881,75.14188422
南投縣,南投市,三興里,8,436,53.36597307,381,46.63402693,817,31,848,0,1089,77.86960514
南投縣,南投市,三興里,9,550,39.34191702,848,60.65808298,1398,8,1406,0,1744,80.61926606
南投縣,南投市,三興里,10,474,40.47822374,697,59.52177626,1171,28,1199,0,1512,79.2989418
南投縣,南投市,三和里,11,489,47.29206963,545,52.70793037,1034,11,1045,0,1319,79.22668688
南投縣,南投市,三和里,12,543,45.82278481,642,54.17721519,1185,20,1205,0,1432,84.14804469
南投縣,南投市,嘉興里,13,845,60.87896254,543,39.12103746,1388,33,1421,0,1780,79.83146067
南投縣,南投市,嘉和里,14,620,46.16530156,723,53.83469844,1343,27,1370,0,1679,81.59618821
南投縣,南投市,嘉和里,15,623,52.57383966,562,47.42616034,1185,19,1204,0,1503,80.10645376
南投縣,南投市,福山里,62,653,48.33456699,698,51.66543301,1351,49,1400,0,1788,78.29977629
南投縣,南投市,永興里,60,327,56.47668394,252,43.52331606,579,27,606,0,756,80.15873016
南投縣,南投市,鳳鳴里,61,333,61.66666667,207,38.33333333,540,32,572,0,729,78.46364883
南投縣,南投市,鳳山里,59,551,59.69664139,372,40.30335861,923,42,965,1,1251,77.13828937
南投縣,南投市,平山里,50,550,45.87155963,649,54.12844037,1199,24,1223,0,1588,77.01511335
南投縣,南投市,平山里,51,508,49.70645793,514,50.29354207,1022,7,1029,0,1303,78.97160399
南投縣,南投市,平山里,52,445,45.22357724,539,54.77642276,984,16,1000,0,1253,79.8084597
南投縣,南投市,新興里,53,770,52.41660994,699,47.58339006,1469,45,1514,0,1937,78.16210635
南投縣,南投市,新興里,54,774,52.01612903,714,47.98387097,1488,34,1522,0,1911,79.64416536
南投縣,南投市,永豐里,55,497,49.7,503,50.3,1000,26,1026,0,1264,81.17088608
南投縣,南投市,永豐里,56,459,49.19614148,474,50.80385852,933,22,955,0,1170,81.62393162
南投縣,南投市,福興里,57,539,50.56285178,527,49.43714822,1066,26,1092,0,1333,81.92048012
南投縣,南投市,福興里,58,479,51.45005371,452,48.54994629,931,25,956,0,1225,78.04081633
南投縣,南投市,營北里,29,489,38.59510655,778,61.40489345,1267,28,1295,0,1573,82.32676414
南投縣,南投市,營北里,30,378,26.30480167,1059,73.69519833,1437,21,1458,0,1698,85.86572438
南投縣,南投市,營北里,31,320,24.35312024,994,75.64687976,1314,20,1334,0,1560,85.51282051
南投縣,南投市,營南里,27,366,42.65734266,492,57.34265734,858,22,880,0,1075,81.86046512
南投縣,南投市,營南里,28,302,40.97693351,435,59.02306649,737,18,755,0,909,83.05830583
南投縣,南投市,內興里,32,455,50.78125,441,49.21875,896,31,927,0,1120,82.76785714
南投縣,南投市,內興里,33,425,37.02090592,723,62.97909408,1148,35,1183,0,1439,82.20986796
南投縣,南投市,內興里,34,530,34.68586387,998,65.31413613,1528,21,1549,1,1860,83.27956989
南投縣,南投市,內興里,35,202,44.49339207,252,55.50660793,454,12,466,0,585,79.65811966
南投縣,南投市,內新里,36,591,54.47004608,494,45.52995392,1085,30,1115,0,1352,82.4704142
南投縣,南投市,光華里,42,73,12.69565217,502,87.30434783,575,4,579,0,696,83.18965517
南投縣,南投市,光華里,43,87,13.3640553,564,86.6359447,651,16,667,0,789,84.5373891
南投縣,南投市,光榮里,38,92,15.00815661,521,84.99184339,613,11,624,0,763,81.78243775
南投縣,南投市,光榮里,39,134,16.32155907,687,83.67844093,821,17,838,0,1057,79.28098392
南投縣,南投市,光明里,40,89,11.58854167,679,88.41145833,768,10,778,0,906,85.87196468
南投縣,南投市,光明里,41,104,13,696,87,800,8,808,0,953,84.78488982
南投縣,南投市,光輝里,37,145,28.82703777,358,71.17296223,503,2,505,0,593,85.16020236
南投縣,埔里鎮,東門里,63,302,47.7093207,331,52.2906793,633,27,660,0,886,74.49209932
南投縣,埔里鎮,東門里,64,301,44.99252616,368,55.00747384,669,28,697,1,904,77.10176991
南投縣,埔里鎮,東門里,65,460,52.21339387,421,47.78660613,881,21,902,0,1168,77.2260274
南投縣,埔里鎮,南門里,69,372,52.17391304,341,47.82608696,713,13,726,0,939,77.31629393
南投縣,埔里鎮,西門里,66,377,50.33377837,372,49.66622163,749,10,759,0,1025,74.04878049
南投縣,埔里鎮,西門里,67,406,52.38709677,369,47.61290323,775,20,795,0,1038,76.58959538
南投縣,埔里鎮,西門里,68,324,39.08323281,505,60.91676719,829,15,844,0,1069,78.95229186
南投縣,埔里鎮,北門里,70,344,38.30734967,554,61.69265033,898,14,912,0,1189,76.70311186
南投縣,埔里鎮,北門里,71,377,42.98745724,500,57.01254276,877,17,894,0,1177,75.95581988
南投縣,埔里鎮,同聲里,78,425,46.75467547,484,53.24532453,909,24,933,0,1192,78.27181208
南投縣,埔里鎮,同聲里,79,365,46.02774275,428,53.97225725,793,31,824,0,1093,75.38883806
南投縣,埔里鎮,薰化里,83,424,44.7257384,524,55.2742616,948,20,968,0,1191,81.27623846
南投縣,埔里鎮,清新里,80,348,46.09271523,407,53.90728477,755,13,768,0,1048,73.28244275
南投縣,埔里鎮,清新里,81,339,46.12244898,396,53.87755102,735,28,763,0,1029,74.14965986
南投縣,埔里鎮,清新里,82,479,45.48907882,574,54.51092118,1053,31,1084,0,1475,73.49152542
南投縣,埔里鎮,大城里,84,421,40.48076923,619,59.51923077,1040,35,1075,0,1412,76.13314448
南投縣,埔里鎮,大城里,85,494,44.90909091,606,55.09090909,1100,28,1128,0,1431,78.82599581
南投縣,埔里鎮,大城里,86,440,47.26100967,491,52.73899033,931,4,935,0,1260,74.20634921
南投縣,埔里鎮,大城里,87,507,42.67676768,681,57.32323232,1188,18,1206,0,1610,74.9068323
南投縣,埔里鎮,籃城里,88,411,55.91836735,324,44.08163265,735,17,752,0,978,76.89161554
南投縣,埔里鎮,枇杷里,91,468,48.64864865,494,51.35135135,962,31,993,0,1302,76.26728111
南投縣,埔里鎮,枇杷里,92,242,47.82608696,264,52.17391304,506,26,532,0,736,72.2826087
南投縣,埔里鎮,枇杷里,93,428,48.0359147,463,51.9640853,891,33,924,1,1270,72.75590551
南投縣,埔里鎮,枇杷里,94,499,40.50324675,733,59.49675325,1232,5,1237,0,1587,77.9458097
南投縣,埔里鎮,枇杷里,95,342,45.29801325,413,54.70198675,755,20,775,0,1059,73.1822474
南投縣,埔里鎮,水頭里,96,318,48.54961832,337,51.45038168,655,29,684,1,962,71.1018711
南投縣,埔里鎮,水頭里,97,326,45.85091421,385,54.14908579,711,23,734,0,1002,73.25349301
南投縣,埔里鎮,水頭里,98,458,54.20118343,387,45.79881657,845,22,867,0,1176,73.7244898
南投縣,埔里鎮,麒麟里,99,376,52.29485396,343,47.70514604,719,23,742,0,1006,73.75745527
南投縣,埔里鎮,珠格里,100,375,52.66853933,337,47.33146067,712,31,743,0,991,74.97477296
南投縣,埔里鎮,溪南里,101,303,42.31843575,413,57.68156425,716,17,733,0,916,80.02183406
南投縣,埔里鎮,桃米里,102,354,46.88741722,401,53.11258278,755,29,784,0,1031,76.04267701
南投縣,埔里鎮,成功里,103,104,37.68115942,172,62.31884058,276,10,286,0,384,74.47916667
南投縣,埔里鎮,南村里,104,471,49.52681388,480,50.47318612,951,28,979,0,1313,74.56207159
南投縣,埔里鎮,愛蘭里,105,452,43.9688716,576,56.0311284,1028,29,1057,0,1360,77.72058824
南投縣,埔里鎮,鐵山里,106,508,42.33333333,692,57.66666667,1200,42,1242,0,1649,75.31837477
南投縣,埔里鎮,房里里,107,307,47.81931464,335,52.18068536,642,39,681,0,898,75.83518931
南投縣,埔里鎮,房里里,108,141,55.078125,115,44.921875,256,7,263,0,347,75.7925072
南投縣,埔里鎮,向善里,109,282,55.84158416,223,44.15841584,505,19,524,0,655,80
南投縣,埔里鎮,一新里,110,284,46.86468647,322,53.13531353,606,3,609,0,809,75.27812114
南投縣,埔里鎮,廣成里,113,461,52.14932127,423,47.85067873,884,14,898,0,1225,73.30612245
南投縣,埔里鎮,史港里,114,231,45.74257426,274,54.25742574,505,15,520,0,669,77.72795217
南投縣,埔里鎮,福興里,115,442,63.05278174,259,36.94721826,701,28,729,0,989,73.71081901
南投縣,埔里鎮,牛眠里,116,466,57.960199,338,42.039801,804,23,827,0,1100,75.18181818
南投縣,埔里鎮,牛眠里,117,602,60.93117409,386,39.06882591,988,41,1029,0,1330,77.36842105
南投縣,埔里鎮,大湳里,118,513,56.43564356,396,43.56435644,909,33,942,0,1206,78.10945274
南投縣,埔里鎮,蜈蚣里,119,261,33.29081633,523,66.70918367,784,19,803,0,1066,75.32833021
南投縣,埔里鎮,蜈蚣里,120,341,48.30028329,365,51.69971671,706,11,717,0,934,76.76659529
南投縣,埔里鎮,蜈蚣里,121,261,66.07594937,134,33.92405063,395,16,411,0,561,73.26203209
南投縣,埔里鎮,合成里,111,523,55.75692964,415,44.24307036,938,31,969,0,1292,75
南投縣,埔里鎮,合成里,112,75,40.98360656,108,59.01639344,183,1,184,0,257,71.59533074
南投縣,埔里鎮,北安里,72,522,39.87776929,787,60.12223071,1309,22,1331,0,1767,75.3254103
南投縣,埔里鎮,北安里,73,518,45.51845343,620,54.48154657,1138,35,1173,0,1481,79.20324105
南投縣,埔里鎮,杷城里,89,455,52.84552846,406,47.15447154,861,28,889,0,1123,79.16295637
南投縣,埔里鎮,杷城里,90,428,48.69169511,451,51.30830489,879,28,907,0,1196,75.8361204
南投縣,埔里鎮,北梅里,76,315,39.03345725,492,60.96654275,807,10,817,0,1067,76.56982193
南投縣,埔里鎮,北梅里,77,452,52.55813953,408,47.44186047,860,31,891,0,1181,75.44453853
南投縣,埔里鎮,泰安里,74,328,40.94881398,473,59.05118602,801,23,824,0,1017,81.02261554
南投縣,埔里鎮,泰安里,75,338,44.82758621,416,55.17241379,754,13,767,0,986,77.78904665
南投縣,草屯鎮,玉峰里,122,330,47.96511628,358,52.03488372,688,20,708,0,879,80.54607509
南投縣,草屯鎮,玉峰里,123,392,44.44444444,490,55.55555556,882,19,901,0,1108,81.31768953
南投縣,草屯鎮,炎峰里,126,336,45.59023066,401,54.40976934,737,24,761,0,934,81.47751606
南投縣,草屯鎮,炎峰里,127,398,44.66891134,493,55.33108866,891,14,905,0,1122,80.65953654
南投縣,草屯鎮,和平里,129,485,46.99612403,547,53.00387597,1032,24,1056,0,1249,84.54763811
南投縣,草屯鎮,敦和里,132,453,49.88986784,455,50.11013216,908,32,940,0,1202,78.20299501
南投縣,草屯鎮,敦和里,133,529,49.85862394,532,50.14137606,1061,31,1092,0,1375,79.41818182
南投縣,草屯鎮,敦和里,134,430,42.82868526,574,57.17131474,1004,20,1024,0,1300,78.76923077
南投縣,草屯鎮,敦和里,135,537,43.94435352,685,56.05564648,1222,38,1260,0,1555,81.02893891
南投縣,草屯鎮,山腳里,136,534,41.42746315,755,58.57253685,1289,23,1312,0,1638,80.0976801
南投縣,草屯鎮,山腳里,137,567,43.15068493,747,56.84931507,1314,19,1333,0,1626,81.9803198
南投縣,草屯鎮,山腳里,138,382,35.33765032,699,64.66234968,1081,14,1095,0,1316,83.20668693
南投縣,草屯鎮,山腳里,139,498,40.35656402,736,59.64343598,1234,30,1264,0,1571,80.45830681
南投縣,草屯鎮,富寮里,165,629,52.63598326,566,47.36401674,1195,28,1223,0,1512,80.88624339
南投縣,草屯鎮,富寮里,166,565,52.55813953,510,47.44186047,1075,28,1103,0,1453,75.9119064
南投縣,草屯鎮,富寮里,167,330,40.94292804,476,59.05707196,806,5,811,0,1018,79.66601179
南投縣,草屯鎮,富寮里,168,204,54.98652291,167,45.01347709,371,13,384,0,500,76.8
南投縣,草屯鎮,御史里,151,517,47.25776965,577,52.74223035,1094,32,1126,0,1408,79.97159091
南投縣,草屯鎮,御史里,152,619,47.94732765,672,52.05267235,1291,33,1324,0,1667,79.42411518
南投縣,草屯鎮,御史里,153,275,46.92832765,311,53.07167235,586,27,613,0,820,74.75609756
南投縣,草屯鎮,御史里,154,529,56.57754011,406,43.42245989,935,7,942,1,1221,77.14987715
南投縣,草屯鎮,新豐里,155,604,61.13360324,384,38.86639676,988,34,1022,0,1302,78.49462366
南投縣,草屯鎮,新豐里,156,426,48.51936219,452,51.48063781,878,23,901,0,1112,81.02517986
南投縣,草屯鎮,新豐里,157,410,53.73525557,353,46.26474443,763,29,792,0,981,80.73394495
南投縣,草屯鎮,碧峰里,144,428,50.83135392,414,49.16864608,842,22,864,0,1099,78.61692448
南投縣,草屯鎮,碧峰里,145,551,57.27650728,411,42.72349272,962,32,994,0,1198,82.97161937
南投縣,草屯鎮,碧峰里,146,454,49.08108108,471,50.91891892,925,18,943,0,1179,79.98303647
南投縣,草屯鎮,碧洲里,147,424,47.9638009,460,52.0361991,884,24,908,0,1078,84.23005566
南投縣,草屯鎮,碧洲里,148,222,40.2173913,330,59.7826087,552,9,561,0,679,82.62150221
南投縣,草屯鎮,復興里,149,565,57.24417427,422,42.75582573,987,41,1028,0,1259,81.65210485
南投縣,草屯鎮,復興里,150,566,48.62542955,598,51.37457045,1164,36,1200,0,1531,78.3801437
南投縣,草屯鎮,上林里,142,498,41.32780083,707,58.67219917,1205,16,1221,0,1484,82.27762803
南投縣,草屯鎮,上林里,143,351,46.06299213,411,53.93700787,762,24,786,0,975,80.61538462
南投縣,草屯鎮,新庄里,158,511,44.51219512,637,55.48780488,1148,37,1185,0,1494,79.31726908
南投縣,草屯鎮,新庄里,159,503,46.66048237,575,53.33951763,1078,43,1121,0,1434,78.17294282
南投縣,草屯鎮,北投里,163,551,57.75681342,403,42.24318658,954,23,977,0,1177,83.00764656
南投縣,草屯鎮,北投里,164,508,52.4251806,461,47.5748194,969,28,997,1,1242,80.27375201
南投縣,草屯鎮,石川里,162,553,55.74596774,439,44.25403226,992,38,1030,0,1247,82.59823577
南投縣,草屯鎮,加老里,160,349,60.59027778,227,39.40972222,576,20,596,0,722,82.54847645
南投縣,草屯鎮,加老里,161,566,53.14553991,499,46.85446009,1065,29,1094,0,1307,83.70313695
南投縣,草屯鎮,北勢里,169,568,52.73909006,509,47.26090994,1077,53,1130,0,1421,79.52146376
南投縣,草屯鎮,北勢里,170,219,58.87096774,153,41.12903226,372,12,384,0,485,79.17525773
南投縣,草屯鎮,中原里,171,487,58.46338535,346,41.53661465,833,10,843,0,1052,80.13307985
南投縣,草屯鎮,中原里,172,382,61.91247974,235,38.08752026,617,25,642,0,820,78.29268293
南投縣,草屯鎮,南埔里,173,635,57.10431655,477,42.89568345,1112,12,1124,0,1415,79.43462898
南投縣,草屯鎮,南埔里,174,488,59.87730061,327,40.12269939,815,19,834,0,1053,79.2022792
南投縣,草屯鎮,南埔里,175,366,48.60557769,387,51.39442231,753,19,772,0,941,82.04038257
南投縣,草屯鎮,土城里,177,210,43.20987654,276,56.79012346,486,17,503,0,641,78.47113885
南投縣,草屯鎮,土城里,178,361,46.22279129,420,53.77720871,781,28,809,0,1044,77.49042146
南投縣,草屯鎮,坪頂里,176,339,46.374829,392,53.625171,731,9,740,0,937,78.97545358
南投縣,草屯鎮,雙冬里,180,461,56.63390663,353,43.36609337,814,29,843,0,1135,74.27312775
南投縣,草屯鎮,雙冬里,181,414,48.36448598,442,51.63551402,856,40,896,0,1183,75.73964497
南投縣,草屯鎮,平林里,179,387,48.80201765,406,51.19798235,793,1,794,0,1031,77.01260912
南投縣,草屯鎮,中正里,128,249,42.49146758,337,57.50853242,586,16,602,0,731,82.35294118
南投縣,草屯鎮,中山里,130,328,44.74761255,405,55.25238745,733,17,750,0,909,82.50825083
南投縣,草屯鎮,中山里,131,536,51.43953935,506,48.56046065,1042,20,1062,0,1311,81.00686499
南投縣,草屯鎮,明正里,124,632,47.41185296,701,52.58814704,1333,26,1359,1,1699,79.98822837
南投縣,草屯鎮,明正里,125,599,43.43727339,780,56.56272661,1379,32,1411,0,1759,80.21603184
南投縣,草屯鎮,新厝里,140,448,40.80145719,650,59.19854281,1098,35,1133,0,1380,82.10144928
南投縣,草屯鎮,新厝里,141,532,47.71300448,583,52.28699552,1115,17,1132,0,1370,82.62773723
南投縣,竹山鎮,竹山里,182,451,48.18376068,485,51.81623932,936,20,956,0,1211,78.9430223
南投縣,竹山鎮,竹山里,183,384,52.67489712,345,47.32510288,729,7,736,0,896,82.14285714
南投縣,竹山鎮,中正里,184,286,50.70921986,278,49.29078014,564,5,569,0,691,82.34442836
南投縣,竹山鎮,中山里,185,411,51.43929912,388,48.56070088,799,21,820,0,1102,74.41016334
南投縣,竹山鎮,中山里,186,648,59.83379501,435,40.16620499,1083,33,1116,0,1442,77.3925104
南投縣,竹山鎮,中山里,187,730,53.05232558,646,46.94767442,1376,41,1417,0,1853,76.47058824
南投縣,竹山鎮,雲林里,188,575,54.24528302,485,45.75471698,1060,16,1076,0,1369,78.59751644
南投縣,竹山鎮,雲林里,189,744,53.52517986,646,46.47482014,1390,32,1422,0,1817,78.26086957
南投縣,竹山鎮,回窯里,219,653,58.5125448,463,41.4874552,1116,29,1145,0,1460,78.42465753
南投縣,竹山鎮,下坪里,194,237,63.2,138,36.8,375,24,399,0,503,79.32405567
南投縣,竹山鎮,下坪里,195,217,51.05882353,208,48.94117647,425,10,435,0,546,79.67032967
南投縣,竹山鎮,桂林里,192,710,53.82865807,609,46.17134193,1319,16,1335,0,1760,75.85227273
南投縣,竹山鎮,桂林里,193,688,56.11745514,538,43.88254486,1226,31,1257,0,1634,76.92778458
南投縣,竹山鎮,中和里,196,602,73.68421053,215,26.31578947,817,33,850,1,1070,79.43925234
南投縣,竹山鎮,中崎里,197,509,50.54617676,498,49.45382324,1007,32,1039,0,1292,80.41795666
南投縣,竹山鎮,德興里,220,186,63.05084746,109,36.94915254,295,15,310,0,392,79.08163265
南投縣,竹山鎮,德興里,221,214,53.63408521,185,46.36591479,399,19,418,0,507,82.44575937
南投縣,竹山鎮,延平里,208,497,57.39030023,369,42.60969977,866,32,898,1,1226,73.24632953
南投縣,竹山鎮,延平里,209,443,61.61335188,276,38.38664812,719,24,743,0,924,80.41125541
南投縣,竹山鎮,延平里,210,312,70.27027027,132,29.72972973,444,19,463,0,567,81.65784832
南投縣,竹山鎮,延正里,206,361,69.15708812,161,30.84291188,522,21,543,0,685,79.27007299
南投縣,竹山鎮,延正里,207,439,59.9726776,293,40.0273224,732,40,772,0,990,77.97979798
南投縣,竹山鎮,延山里,211,305,58.88030888,213,41.11969112,518,24,542,0,671,80.77496274
南投縣,竹山鎮,延和里,201,544,49.6803653,551,50.3196347,1095,22,1117,0,1458,76.61179698
南投縣,竹山鎮,延和里,202,639,53.83319292,548,46.16680708,1187,22,1209,0,1539,78.55750487
南投縣,竹山鎮,延和里,203,465,49.46808511,475,50.53191489,940,22,962,0,1254,76.71451356
南投縣,竹山鎮,山崇里,212,542,62.22732491,329,37.77267509,871,25,896,0,1178,76.06112054
南投縣,竹山鎮,山崇里,213,270,55.32786885,218,44.67213115,488,26,514,0,665,77.29323308
南投縣,竹山鎮,社寮里,214,429,57.81671159,313,42.18328841,742,27,769,0,965,79.68911917
南投縣,竹山鎮,中央里,215,648,65.25679758,345,34.74320242,993,41,1034,0,1344,76.93452381
南投縣,竹山鎮,富州里,216,291,55.11363636,237,44.88636364,528,23,551,0,722,76.31578947
南投縣,竹山鎮,大鞍里,200,180,57.8778135,131,42.1221865,311,11,322,0,435,74.02298851
南投縣,竹山鎮,田子里,217,207,58.64022663,146,41.35977337,353,4,357,0,447,79.86577181
南投縣,竹山鎮,田子里,218,71,56.8,54,43.2,125,7,132,0,190,69.47368421
南投縣,竹山鎮,福興里,222,66,43.70860927,85,56.29139073,151,3,154,0,204,75.49019608
南投縣,竹山鎮,福興里,223,135,48.38709677,144,51.61290323,279,14,293,0,378,77.51322751
南投縣,竹山鎮,鯉魚里,224,206,58.52272727,146,41.47727273,352,21,373,0,523,71.31931166
南投縣,竹山鎮,鯉魚里,225,141,57.31707317,105,42.68292683,246,12,258,0,348,74.13793103
南投縣,竹山鎮,瑞竹里,227,324,60.6741573,210,39.3258427,534,18,552,0,725,76.13793103
南投縣,竹山鎮,坪頂里,226,243,64.28571429,135,35.71428571,378,28,406,0,534,76.02996255
南投縣,竹山鎮,桶頭里,228,278,68.98263027,125,31.01736973,403,22,425,0,600,70.83333333
南投縣,竹山鎮,桶頭里,229,166,51.875,154,48.125,320,13,333,0,461,72.23427332
南投縣,竹山鎮,秀林里,198,114,62.63736264,68,37.36263736,182,6,188,0,245,76.73469388
南投縣,竹山鎮,秀林里,199,245,65.15957447,131,34.84042553,376,18,394,0,516,76.35658915
南投縣,竹山鎮,延祥里,204,803,59.13107511,555,40.86892489,1358,35,1393,0,1795,77.60445682
南投縣,竹山鎮,延祥里,205,618,55.37634409,498,44.62365591,1116,37,1153,1,1495,77.12374582
南投縣,竹山鎮,竹圍里,190,289,53.32103321,253,46.67896679,542,17,559,0,688,81.25
南投縣,竹山鎮,竹圍里,191,581,51.64444444,544,48.35555556,1125,30,1155,0,1538,75.09752926
南投縣,集集鎮,集集里,230,317,43.9667129,404,56.0332871,721,17,738,0,962,76.71517672
南投縣,集集鎮,和平里,231,330,46.74220963,376,53.25779037,706,23,729,0,945,77.14285714
南投縣,集集鎮,林尾里,232,239,56.9047619,181,43.0952381,420,11,431,0,564,76.41843972
南投縣,集集鎮,田寮里,233,435,46.67381974,497,53.32618026,932,56,988,0,1254,78.78787879
南投縣,集集鎮,隘寮里,234,241,56.17715618,188,43.82284382,429,16,445,0,561,79.32263815
南投縣,集集鎮,玉映里,235,196,56,154,44,350,13,363,0,452,80.30973451
南投縣,集集鎮,吳厝里,236,323,44.61325967,401,55.38674033,724,19,743,0,898,82.73942094
南投縣,集集鎮,八張里,237,552,53.54025218,479,46.45974782,1031,32,1063,0,1413,75.23000708
南投縣,集集鎮,永昌里,238,352,50.21398003,349,49.78601997,701,16,717,0,915,78.36065574
南投縣,集集鎮,富山里,241,133,42.49201278,180,57.50798722,313,2,315,0,423,74.46808511
南投縣,集集鎮,廣明里,239,230,50.43859649,226,49.56140351,456,18,474,0,624,75.96153846
南投縣,集集鎮,廣明里,240,165,53.74592834,142,46.25407166,307,14,321,0,435,73.79310345
南投縣,名間鄉,南雅村,242,428,55.44041451,344,44.55958549,772,29,801,1,1017,78.76106195
南投縣,名間鄉,中正村,243,547,58.31556503,391,41.68443497,938,31,969,0,1262,76.78288431
南投縣,名間鄉,中正村,244,683,55.03626108,558,44.96373892,1241,32,1273,0,1648,77.24514563
南投縣,名間鄉,中山村,245,311,52.80135823,278,47.19864177,589,17,606,0,768,78.90625
南投縣,名間鄉,中山村,246,557,56.54822335,428,43.45177665,985,40,1025,1,1274,80.45525903
南投縣,名間鄉,濁水村,247,673,57.17926933,504,42.82073067,1177,47,1224,0,1551,78.91682785
南投縣,名間鄉,炭寮村,249,450,57.54475703,332,42.45524297,782,30,812,0,1010,80.3960396
南投縣,名間鄉,新民村,248,457,57.92141952,332,42.07858048,789,48,837,0,1041,80.40345821
南投縣,名間鄉,新街村,250,767,59.5959596,520,40.4040404,1287,35,1322,0,1617,81.7563389
南投縣,名間鄉,新街村,251,502,67.83783784,238,32.16216216,740,11,751,0,926,81.10151188
南投縣,名間鄉,新街村,252,466,55.34441805,376,44.65558195,842,19,861,0,1093,78.77401647
南投縣,名間鄉,東湖村,253,398,66.77852349,198,33.22147651,596,6,602,1,785,76.68789809
南投縣,名間鄉,東湖村,254,372,57.14285714,279,42.85714286,651,14,665,0,843,78.88493476
南投縣,名間鄉,萬丹村,256,490,63.06306306,287,36.93693694,777,36,813,0,995,81.70854271
南投縣,名間鄉,田仔村,257,535,67.72151899,255,32.27848101,790,42,832,0,1040,80
南投縣,名間鄉,田仔村,258,464,71.16564417,188,28.83435583,652,19,671,0,842,79.6912114
南投縣,名間鄉,大庄村,259,571,71.0199005,233,28.9800995,804,31,835,0,1026,81.38401559
南投縣,名間鄉,大庄村,260,477,67.37288136,231,32.62711864,708,34,742,0,920,80.65217391
南投縣,名間鄉,部下村,260,477,67.37288136,231,32.62711864,708,34,742,0,920,80.65217391
南投縣,名間鄉,部下村,261,348,59.5890411,236,40.4109589,584,31,615,0,770,79.87012987
南投縣,名間鄉,大坑村,258,464,71.16564417,188,28.83435583,652,19,671,0,842,79.6912114
南投縣,名間鄉,大坑村,260,477,67.37288136,231,32.62711864,708,34,742,0,920,80.65217391
南投縣,名間鄉,竹圍村,264,527,72.99168975,195,27.00831025,722,25,747,1,926,80.66954644
南投縣,名間鄉,赤水村,262,352,63.08243728,206,36.91756272,558,16,574,0,701,81.88302425
南投縣,名間鄉,赤水村,263,278,62.47191011,167,37.52808989,445,10,455,0,569,79.96485062
南投縣,名間鄉,三崙村,265,476,59.13043478,329,40.86956522,805,37,842,0,1030,81.74757282
南投縣,名間鄉,三崙村,266,254,68.64864865,116,31.35135135,370,9,379,0,453,83.66445916
南投縣,名間鄉,松山村,267,649,56.19047619,506,43.80952381,1155,29,1184,0,1482,79.89203779
南投縣,名間鄉,松柏村,268,550,60.77348066,355,39.22651934,905,24,929,0,1141,81.41980719
南投縣,名間鄉,埔中村,270,431,60.96181047,276,39.03818953,707,14,721,0,878,82.11845103
南投縣,名間鄉,崁腳村,269,333,52.19435737,305,47.80564263,638,6,644,0,802,80.29925187
南投縣,名間鄉,新厝村,271,381,60.86261981,245,39.13738019,626,27,653,0,817,79.92656059
南投縣,名間鄉,新光村,272,370,63.24786325,215,36.75213675,585,25,610,0,774,78.81136951
南投縣,名間鄉,新光村,273,375,56.39097744,290,43.60902256,665,31,696,0,866,80.36951501
南投縣,名間鄉,仁和村,255,289,45.3689168,348,54.6310832,637,28,665,0,857,77.59626604
南投縣,鹿谷鄉,鹿谷村,275,670,51.69753086,626,48.30246914,1296,14,1310,0,1668,78.53717026
南投縣,鹿谷鄉,初鄉村,274,567,52.11397059,521,47.88602941,1088,64,1152,0,1597,72.1352536
南投縣,鹿谷鄉,彰雅村,276,301,49.75206612,304,50.24793388,605,17,622,0,757,82.1664465
南投縣,鹿谷鄉,彰雅村,277,176,56.77419355,134,43.22580645,310,13,323,0,418,77.27272727
南投縣,鹿谷鄉,廣興村,278,244,42.43478261,331,57.56521739,575,26,601,0,780,77.05128205
南投縣,鹿谷鄉,廣興村,279,431,50.46838407,423,49.53161593,854,23,877,0,1092,80.31135531
南投縣,鹿谷鄉,內湖村,280,206,50.73891626,200,49.26108374,406,13,419,0,568,73.76760563
南投縣,鹿谷鄉,內湖村,281,191,55.52325581,153,44.47674419,344,11,355,0,449,79.06458797
南投縣,鹿谷鄉,竹林村,283,593,52.57092199,535,47.42907801,1128,34,1162,0,1522,76.34691196
南投縣,鹿谷鄉,竹豐村,284,315,45.85152838,372,54.14847162,687,20,707,0,892,79.26008969
南投縣,鹿谷鄉,和雅村,282,208,44.92440605,255,55.07559395,463,23,486,0,609,79.80295567
南投縣,鹿谷鄉,鳳凰村,285,578,56.50048876,445,43.49951124,1023,48,1071,0,1359,78.80794702
南投縣,鹿谷鄉,永隆村,286,552,52.12464589,507,47.87535411,1059,30,1089,0,1331,81.81818182
南投縣,鹿谷鄉,永隆村,288,207,67.64705882,99,32.35294118,306,13,319,0,437,72.99771167
南投縣,鹿谷鄉,秀峰村,287,304,65.09635974,163,34.90364026,467,4,471,0,643,73.2503888
南投縣,鹿谷鄉,清水村,289,316,59.96204934,211,40.03795066,527,23,550,0,731,75.23939808
南投縣,鹿谷鄉,瑞田村,290,282,54.23076923,238,45.76923077,520,35,555,0,778,71.33676093
南投縣,中寮鄉,廣興村,291,409,66.07431341,210,33.92568659,619,38,657,0,853,77.02227433
南投縣,中寮鄉,崁頂村,292,125,59.52380952,85,40.47619048,210,3,213,0,266,80.07518797
南投縣,中寮鄉,崁頂村,293,115,63.5359116,66,36.4640884,181,13,194,0,251,77.29083665
南投縣,中寮鄉,八仙村,294,160,55.74912892,127,44.25087108,287,12,299,0,386,77.4611399
南投縣,中寮鄉,八仙村,295,171,61.95652174,105,38.04347826,276,5,281,0,368,76.35869565
南投縣,中寮鄉,和興村,298,299,61.14519427,190,38.85480573,489,30,519,0,698,74.35530086
南投縣,中寮鄉,福盛村,296,192,58.0060423,139,41.9939577,331,19,350,0,429,81.58508159
南投縣,中寮鄉,福盛村,297,120,47.61904762,132,52.38095238,252,15,267,0,369,72.35772358
南投縣,中寮鄉,永平村,299,348,46.21513944,405,53.78486056,753,25,778,0,979,79.46884576
南投縣,中寮鄉,永平村,300,311,51.83333333,289,48.16666667,600,20,620,0,786,78.88040712
南投縣,中寮鄉,復興村,301,109,55.8974359,86,44.1025641,195,6,201,0,273,73.62637363
南投縣,中寮鄉,中寮村,302,235,44.50757576,293,55.49242424,528,1,529,0,709,74.61212976
南投縣,中寮鄉,廣福村,303,269,65.45012165,142,34.54987835,411,22,433,0,548,79.01459854
南投縣,中寮鄉,永福村,304,187,62.75167785,111,37.24832215,298,8,306,0,379,80.73878628
南投縣,中寮鄉,永福村,305,303,49.42903752,310,50.57096248,613,13,626,0,768,81.51041667
南投縣,中寮鄉,義和村,306,198,54.6961326,164,45.3038674,362,14,376,0,468,80.34188034
南投縣,中寮鄉,義和村,307,297,60.36585366,195,39.63414634,492,16,508,0,645,78.75968992
南投縣,中寮鄉,清水村,308,362,54.60030166,301,45.39969834,663,42,705,0,959,73.51407716
南投縣,中寮鄉,龍安村,310,310,60.4288499,203,39.5711501,513,21,534,0,700,76.28571429
南投縣,中寮鄉,龍岩村,312,274,50.92936803,264,49.07063197,538,16,554,0,686,80.75801749
南投縣,中寮鄉,永和村,314,207,51.11111111,198,48.88888889,405,20,425,0,549,77.41347905
南投縣,中寮鄉,內城村,309,164,50.93167702,158,49.06832298,322,16,338,0,468,72.22222222
南投縣,中寮鄉,永芳村,313,165,49.10714286,171,50.89285714,336,11,347,0,437,79.40503432
南投縣,中寮鄉,爽文村,311,205,49.75728155,207,50.24271845,412,6,418,0,543,76.97974217
南投縣,魚池鄉,東池村,316,604,57.57864633,445,42.42135367,1049,45,1094,0,1529,71.5500327
南投縣,魚池鄉,魚池村,315,694,51.56017831,652,48.43982169,1346,35,1381,0,1909,72.34154007
南投縣,魚池鄉,中明村,330,250,55.80357143,198,44.19642857,448,20,468,0,641,73.01092044
南投縣,魚池鄉,中明村,331,157,57.50915751,116,42.49084249,273,7,280,0,384,72.91666667
南投縣,魚池鄉,新城村,323,294,52.68817204,264,47.31182796,558,6,564,0,740,76.21621622
南投縣,魚池鄉,新城村,324,130,62.80193237,77,37.19806763,207,6,213,0,292,72.94520548
南投縣,魚池鄉,新城村,325,117,55.98086124,92,44.01913876,209,2,211,0,285,74.03508772
南投縣,魚池鄉,大林村,317,247,70.57142857,103,29.42857143,350,10,360,0,501,71.85628743
南投縣,魚池鄉,大林村,318,199,49.75,201,50.25,400,17,417,0,564,73.93617021
南投縣,魚池鄉,東光村,319,534,64.49275362,294,35.50724638,828,35,863,0,1242,69.48470209
南投縣,魚池鄉,共和村,320,118,68.20809249,55,31.79190751,173,11,184,0,235,78.29787234
南投縣,魚池鄉,共和村,321,216,57.29442971,161,42.70557029,377,6,383,0,539,71.05751391
南投縣,魚池鄉,共和村,322,65,46.09929078,76,53.90070922,141,10,151,0,207,72.9468599
南投縣,魚池鄉,大雁村,326,121,52.38095238,110,47.61904762,231,1,232,0,290,80
南投縣,魚池鄉,大雁村,327,158,59.84848485,106,40.15151515,264,17,281,0,380,73.94736842
南投縣,魚池鄉,五城村,328,180,45.34005038,217,54.65994962,397,23,420,0,562,74.73309609
南投縣,魚池鄉,五城村,329,71,60.16949153,47,39.83050847,118,9,127,0,166,76.5060241
南投縣,魚池鄉,水社村,332,270,45.5311973,323,54.4688027,593,8,601,0,807,74.47335812
南投縣,魚池鄉,頭社村,334,146,50.87108014,141,49.12891986,287,11,298,0,420,70.95238095
南投縣,魚池鄉,頭社村,335,203,54.42359249,170,45.57640751,373,22,395,0,541,73.012939
南投縣,魚池鄉,武登村,336,141,45.92833876,166,54.07166124,307,4,311,0,438,71.00456621
南投縣,魚池鄉,武登村,337,117,53.42465753,102,46.57534247,219,7,226,0,311,72.66881029
南投縣,魚池鄉,日月村,333,243,46.19771863,283,53.80228137,526,20,546,0,722,75.6232687
南投縣,國姓鄉,國姓村,338,315,48.38709677,336,51.61290323,651,14,665,0,880,75.56818182
南投縣,國姓鄉,國姓村,339,268,49.26470588,276,50.73529412,544,20,564,0,760,74.21052632
南投縣,國姓鄉,石門村,340,279,44.28571429,351,55.71428571,630,27,657,0,892,73.65470852
南投縣,國姓鄉,石門村,341,220,40.21937843,327,59.78062157,547,27,574,0,792,72.47474747
南投縣,國姓鄉,大旗村,342,297,55.51401869,238,44.48598131,535,16,551,0,755,72.98013245
南投縣,國姓鄉,北港村,346,351,46.49006623,404,53.50993377,755,42,797,0,1095,72.78538813
南投縣,國姓鄉,北港村,347,331,52.20820189,303,47.79179811,634,31,665,0,922,72.12581345
南投縣,國姓鄉,長流村,343,452,42.52116651,611,57.47883349,1063,34,1097,0,1512,72.55291005
南投縣,國姓鄉,長福村,344,229,46.3562753,265,53.6437247,494,29,523,0,703,74.39544808
南投縣,國姓鄉,福龜村,348,289,42.5,391,57.5,680,24,704,0,906,77.70419426
南投縣,國姓鄉,福龜村,349,330,46.54442877,379,53.45557123,709,22,731,0,946,77.27272727
南投縣,國姓鄉,乾溝村,350,289,47.1451876,324,52.8548124,613,17,630,0,866,72.7482679
南投縣,國姓鄉,柑林村,351,391,46.21749409,455,53.78250591,846,50,896,0,1205,74.35684647
南投縣,國姓鄉,北山村,353,391,50.51679587,383,49.48320413,774,32,806,0,1027,78.48101266
南投縣,國姓鄉,北山村,354,241,58.3535109,172,41.6464891,413,12,425,0,588,72.27891156
南投縣,國姓鄉,南港村,355,338,42.67676768,454,57.32323232,792,57,849,0,1226,69.24959217
南投縣,國姓鄉,南港村,356,230,46.74796748,262,53.25203252,492,22,514,0,700,73.42857143
南投縣,國姓鄉,大石村,352,284,52.39852399,258,47.60147601,542,28,570,0,759,75.09881423
南投縣,國姓鄉,長豐村,345,269,46.21993127,313,53.78006873,582,8,590,0,841,70.15457788
南投縣,水里鄉,水里村,357,272,42.7672956,364,57.2327044,636,27,663,0,908,73.01762115
南投縣,水里鄉,農富村,362,209,52.11970075,192,47.88029925,401,7,408,0,525,77.71428571
南投縣,水里鄉,新城村,358,212,49.64871194,215,50.35128806,427,2,429,0,574,74.73867596
南投縣,水里鄉,新城村,359,420,53.63984674,363,46.36015326,783,22,805,0,1090,73.85321101
南投縣,水里鄉,中央村,360,290,51.14638448,277,48.85361552,567,5,572,0,736,77.7173913
南投縣,水里鄉,城中村,361,347,44.94818653,425,55.05181347,772,18,790,0,1043,75.7430489
南投縣,水里鄉,北埔村,363,314,43.1911967,413,56.8088033,727,19,746,0,1004,74.30278884
南投縣,水里鄉,鉅工村,365,321,37.63188746,532,62.36811254,853,29,882,0,1078,81.81818182
南投縣,水里鄉,永豐村,366,538,51.58197507,505,48.41802493,1043,35,1078,1,1398,77.11015737
南投縣,水里鄉,頂崁村,368,385,46.32972323,446,53.67027677,831,27,858,0,1181,72.65029636
南投縣,水里鄉,車埕村,375,168,44.68085106,208,55.31914894,376,26,402,0,557,72.17235189
南投縣,水里鄉,新興村,376,203,42.64705882,273,57.35294118,476,18,494,0,689,71.69811321
南投縣,水里鄉,新山村,369,125,46.8164794,142,53.1835206,267,12,279,0,379,73.61477573
南投縣,水里鄉,郡坑村,370,118,46.64031621,135,53.35968379,253,11,264,0,368,71.73913043
南投縣,水里鄉,上安村,371,384,45.98802395,451,54.01197605,835,31,866,0,1171,73.95388557
南投縣,水里鄉,民和村,367,508,68.64864865,232,31.35135135,740,31,771,0,1049,73.49857007
南投縣,水里鄉,永興村,373,147,58.8,103,41.2,250,11,261,0,368,70.92391304
南投縣,水里鄉,玉峰村,374,467,67.1942446,228,32.8057554,695,24,719,1,920,78.15217391
南投縣,水里鄉,興隆村,372,151,62.39669421,91,37.60330579,242,0,242,0,353,68.55524079
南投縣,水里鄉,南光村,364,494,47.18242598,553,52.81757402,1047,11,1058,0,1379,76.72226251
南投縣,信義鄉,人和村,380,78,13.73239437,490,86.26760563,568,25,593,0,799,74.21777222
南投縣,信義鄉,人和村,381,71,42.51497006,96,57.48502994,167,16,183,0,268,68.28358209
南投縣,信義鄉,地利村,378,96,16.21621622,496,83.78378378,592,13,605,0,763,79.29226737
南投縣,信義鄉,潭南村,379,28,8.408408408,305,91.59159159,333,16,349,0,463,75.37796976
南投縣,信義鄉,明德村,382,330,39.80699638,499,60.19300362,829,10,839,0,1107,75.79042457
南投縣,信義鄉,明德村,383,154,55.59566787,123,44.40433213,277,5,282,0,389,72.49357326
南投縣,信義鄉,愛國村,386,176,45.71428571,209,54.28571429,385,21,406,0,541,75.04621072
南投縣,信義鄉,自強村,384,130,54.62184874,108,45.37815126,238,13,251,0,338,74.26035503
南投縣,信義鄉,自強村,385,149,49.17491749,154,50.82508251,303,21,324,0,415,78.07228916
南投縣,信義鄉,羅娜村,389,140,16.90821256,688,83.09178744,828,44,872,0,1164,74.91408935
南投縣,信義鄉,望美村,390,156,46.15384615,182,53.84615385,338,15,353,0,475,74.31578947
南投縣,信義鄉,望美村,391,180,29.60526316,428,70.39473684,608,14,622,0,824,75.48543689
南投縣,信義鄉,同富村,392,372,55.43964232,299,44.56035768,671,28,699,0,952,73.42436975
南投縣,信義鄉,同富村,393,172,56.39344262,133,43.60655738,305,12,317,0,451,70.28824834
南投縣,信義鄉,神木村,394,170,51.05105105,163,48.94894895,333,16,349,0,484,72.10743802
南投縣,信義鄉,神木村,395,58,31.69398907,125,68.30601093,183,12,195,0,272,71.69117647
南投縣,信義鄉,東埔村,396,190,32.04047218,403,67.95952782,593,10,603,0,809,74.53646477
南投縣,信義鄉,雙龍村,377,81,19.6125908,332,80.3874092,413,11,424,0,557,76.12208259
南投縣,信義鄉,新鄉村,388,74,20.38567493,289,79.61432507,363,11,374,0,470,79.57446809
南投縣,信義鄉,豐丘村,387,186,43.76470588,239,56.23529412,425,27,452,0,583,77.53001715
南投縣,仁愛鄉,法治村,411,52,12.23529412,373,87.76470588,425,6,431,0,603,71.47595357
南投縣,仁愛鄉,中正村,417,38,7.050092764,501,92.94990724,539,4,543,0,710,76.47887324
南投縣,仁愛鄉,互助村,420,43,10.26252983,376,89.73747017,419,15,434,0,574,75.6097561
南投縣,仁愛鄉,互助村,421,23,7.232704403,295,92.7672956,318,9,327,0,385,84.93506494
南投縣,仁愛鄉,新生村,406,27,10.34482759,234,89.65517241,261,10,271,0,327,82.87461774
南投縣,仁愛鄉,力行村,414,64,19.10447761,271,80.89552239,335,13,348,0,478,72.80334728
南投縣,仁愛鄉,發祥村,397,19,11.04651163,153,88.95348837,172,3,175,0,267,65.54307116
南投縣,仁愛鄉,發祥村,398,26,11.11111111,208,88.88888889,234,12,246,0,341,72.14076246
南投縣,仁愛鄉,發祥村,399,8,12.12121212,58,87.87878788,66,1,67,0,113,59.2920354
南投縣,仁愛鄉,合作村,419,58,14.87179487,332,85.12820513,390,18,408,0,537,75.97765363
南投縣,仁愛鄉,親愛村,402,26,5.909090909,414,94.09090909,440,13,453,0,627,72.24880383
南投縣,仁愛鄉,親愛村,403,47,18.359375,209,81.640625,256,9,265,0,330,80.3030303
南投縣,仁愛鄉,親愛村,404,11,12.79069767,75,87.20930233,86,0,86,0,114,75.43859649
南投縣,仁愛鄉,大同村,407,184,31.08108108,408,68.91891892,592,14,606,0,810,74.81481481
南投縣,仁愛鄉,大同村,408,44,14.81481481,253,85.18518519,297,12,309,0,399,77.44360902
南投縣,仁愛鄉,大同村,409,35,18.42105263,155,81.57894737,190,10,200,0,255,78.43137255
南投縣,仁愛鄉,南豐村,415,84,13.97670549,517,86.02329451,601,27,628,0,810,77.5308642
南投縣,仁愛鄉,南豐村,416,100,47.84688995,109,52.15311005,209,13,222,0,310,71.61290323
南投縣,仁愛鄉,春陽村,410,96,14.30700447,575,85.69299553,671,8,679,0,844,80.45023697
南投縣,仁愛鄉,精英村,400,15,3.537735849,409,96.46226415,424,12,436,0,588,74.14965986
南投縣,仁愛鄉,精英村,401,73,14.31372549,437,85.68627451,510,9,519,0,651,79.7235023
南投縣,仁愛鄉,萬豐村,405,47,12.36842105,333,87.63157895,380,8,388,0,531,73.06967985
南投縣,仁愛鄉,榮興村,418,8,13.1147541,53,86.8852459,61,1,62,0,83,74.69879518
南投縣,仁愛鄉,翠華村,412,24,21.23893805,89,78.76106195,113,11,124,0,191,64.92146597
南投縣,仁愛鄉,翠華村,413,55,24.01746725,174,75.98253275,229,12,241,0,354,68.07909605
雲林縣,斗六市,忠孝里,18,337,53.66242038,291,46.33757962,628,13,641,0,795,80.62893082
雲林縣,斗六市,忠孝里,19,293,53.17604356,258,46.82395644,551,13,564,0,677,83.30871492
雲林縣,斗六市,仁愛里,20,511,54.5357524,426,45.4642476,937,9,946,0,1156,81.83391003
雲林縣,斗六市,信義里,1,345,55.37720706,278,44.62279294,623,13,636,0,787,80.81321474
雲林縣,斗六市,四維里,2,312,53.1516184,275,46.8483816,587,14,601,0,720,83.47222222
雲林縣,斗六市,太平里,3,316,51.63398693,296,48.36601307,612,17,629,0,771,81.58236057
雲林縣,斗六市,中和里,4,445,58.39895013,317,41.60104987,762,20,782,0,937,83.45784418
雲林縣,斗六市,光興里,5,386,55.38020086,311,44.61979914,697,18,715,0,918,77.88671024
雲林縣,斗六市,三平里,11,493,45.94594595,580,54.05405405,1073,28,1101,0,1388,79.32276657
雲林縣,斗六市,三平里,12,565,43.12977099,745,56.87022901,1310,28,1338,1,1631,82.03556101
雲林縣,斗六市,八德里,21,598,55.78358209,474,44.21641791,1072,35,1107,0,1350,82
雲林縣,斗六市,八德里,22,513,50.19569472,509,49.80430528,1022,19,1041,0,1273,81.77533386
雲林縣,斗六市,鎮北里,15,542,59.17030568,374,40.82969432,916,22,938,0,1140,82.28070175
雲林縣,斗六市,鎮北里,16,420,42.90091931,559,57.09908069,979,16,995,0,1202,82.77870216
雲林縣,斗六市,龍潭里,37,511,57.15883669,383,42.84116331,894,21,915,0,1092,83.79120879
雲林縣,斗六市,鎮南里,32,413,46.50900901,475,53.49099099,888,18,906,0,1111,81.54815482
雲林縣,斗六市,鎮南里,33,398,45.64220183,474,54.35779817,872,15,887,0,1082,81.97781885
雲林縣,斗六市,鎮南里,34,334,40.83129584,484,59.16870416,818,21,839,0,1057,79.3755913
雲林縣,斗六市,林頭里,27,644,54.20875421,544,45.79124579,1188,15,1203,0,1480,81.28378378
雲林縣,斗六市,林頭里,28,384,45.22968198,465,54.77031802,849,24,873,0,1123,77.73820125
雲林縣,斗六市,林頭里,29,146,21.25181951,541,78.74818049,687,6,693,0,915,75.73770492
雲林縣,斗六市,重光里,25,433,59.31506849,297,40.68493151,730,25,755,0,903,83.61018826
雲林縣,斗六市,重光里,26,494,60.46511628,323,39.53488372,817,29,846,0,1117,75.7385855
雲林縣,斗六市,溝埧里,41,222,47.23404255,248,52.76595745,470,16,486,0,594,81.81818182
雲林縣,斗六市,江厝里,42,682,58.04255319,493,41.95744681,1175,47,1222,0,1553,78.68641339
雲林縣,斗六市,三光里,43,284,63.96396396,160,36.03603604,444,17,461,0,564,81.73758865
雲林縣,斗六市,崙峰里,39,352,40.97788126,507,59.02211874,859,10,869,0,1070,81.21495327
雲林縣,斗六市,崙峰里,40,263,48.52398524,279,51.47601476,542,14,556,0,678,82.00589971
雲林縣,斗六市,嘉東里,38,366,61.72006745,227,38.27993255,593,28,621,0,747,83.13253012
雲林縣,斗六市,久安里,44,515,53.09278351,455,46.90721649,970,41,1011,0,1211,83.48472337
雲林縣,斗六市,久安里,45,317,56.40569395,245,43.59430605,562,9,571,0,705,80.9929078
雲林縣,斗六市,長平里,51,738,60.7907743,476,39.2092257,1214,55,1269,0,1566,81.03448276
雲林縣,斗六市,保庄里,49,840,63.30067822,487,36.69932178,1327,57,1384,0,1685,82.13649852
雲林縣,斗六市,保庄里,50,532,48.10126582,574,51.89873418,1106,34,1140,0,1425,80
雲林縣,斗六市,虎溪里,46,472,44.15341441,597,55.84658559,1069,20,1089,0,1315,82.81368821
雲林縣,斗六市,虎溪里,47,604,49.63023829,613,50.36976171,1217,20,1237,0,1577,78.44007609
雲林縣,斗六市,虎溪里,48,691,57.10743802,519,42.89256198,1210,34,1244,0,1575,78.98412698
雲林縣,斗六市,梅林里,57,344,57.04809287,259,42.95190713,603,22,625,0,747,83.66800535
雲林縣,斗六市,梅林里,58,406,55.08819539,331,44.91180461,737,42,779,0,973,80.06166495
雲林縣,斗六市,湖山里,59,630,61.58357771,393,38.41642229,1023,22,1045,0,1269,82.34830575
雲林縣,斗六市,榴中里,52,603,65.68627451,315,34.31372549,918,38,956,0,1196,79.93311037
雲林縣,斗六市,榴中里,53,614,63.49534643,353,36.50465357,967,30,997,0,1224,81.45424837
雲林縣,斗六市,榴中里,54,563,54.44874275,471,45.55125725,1034,34,1068,0,1356,78.76106195
雲林縣,斗六市,榴北里,55,491,64.26701571,273,35.73298429,764,26,790,0,964,81.95020747
雲林縣,斗六市,榴南里,56,529,57.25108225,395,42.74891775,924,31,955,0,1180,80.93220339
雲林縣,斗六市,溪洲里,62,459,62.11096076,280,37.88903924,739,31,770,0,978,78.73210634
雲林縣,斗六市,溪洲里,63,637,55.53618134,510,44.46381866,1147,40,1187,0,1493,79.50435365
雲林縣,斗六市,長安里,60,509,62.83950617,301,37.16049383,810,40,850,0,1050,80.95238095
雲林縣,斗六市,長安里,61,667,58.66314864,470,41.33685136,1137,39,1176,0,1483,79.29871881
雲林縣,斗六市,十三里,64,616,67.76677668,293,32.23322332,909,40,949,0,1142,83.09982487
雲林縣,斗六市,鎮東里,8,384,43.24324324,504,56.75675676,888,26,914,0,1105,82.71493213
雲林縣,斗六市,鎮東里,9,489,53.21001088,430,46.78998912,919,22,941,0,1152,81.68402778
雲林縣,斗六市,鎮東里,10,472,44.27767355,594,55.72232645,1066,20,1086,0,1334,81.40929535
雲林縣,斗六市,鎮西里,6,454,46.85242518,515,53.14757482,969,31,1000,0,1231,81.23476848
雲林縣,斗六市,鎮西里,7,671,53.76602564,577,46.23397436,1248,25,1273,0,1690,75.32544379
雲林縣,斗六市,公正里,23,325,34.24657534,624,65.75342466,949,19,968,0,1228,78.82736156
雲林縣,斗六市,公正里,24,420,44.7761194,518,55.2238806,938,22,960,0,1174,81.77172061
雲林縣,斗六市,社口里,35,334,45.25745257,404,54.74254743,738,9,747,0,930,80.32258065
雲林縣,斗六市,社口里,36,448,47.65957447,492,52.34042553,940,19,959,0,1161,82.60120586
雲林縣,斗六市,公誠里,17,675,49.16241806,698,50.83758194,1373,32,1405,0,1773,79.24421884
雲林縣,斗六市,明德里,13,449,50.6772009,437,49.3227991,886,6,892,0,1107,80.57813911
雲林縣,斗六市,明德里,14,482,50.68349106,469,49.31650894,951,10,961,0,1224,78.5130719
雲林縣,斗六市,成功里,30,386,50.99075297,371,49.00924703,757,5,762,0,940,81.06382979
雲林縣,斗六市,成功里,31,415,48.59484778,439,51.40515222,854,14,868,1,1065,81.50234742
雲林縣,斗南鎮,東仁里,65,498,56.20767494,388,43.79232506,886,21,907,0,1131,80.19451813
雲林縣,斗南鎮,西岐里,66,654,52.02863962,603,47.97136038,1257,12,1269,0,1574,80.62261753
雲林縣,斗南鎮,西岐里,67,578,47.80810587,631,52.19189413,1209,20,1229,0,1506,81.60690571
雲林縣,斗南鎮,西岐里,68,549,50.3208066,542,49.6791934,1091,7,1098,0,1415,77.59717314
雲林縣,斗南鎮,南昌里,69,440,51.34189032,417,48.65810968,857,18,875,0,1106,79.11392405
雲林縣,斗南鎮,南昌里,70,420,57.37704918,312,42.62295082,732,24,756,0,928,81.46551724
雲林縣,斗南鎮,北銘里,71,504,47.77251185,551,52.22748815,1055,9,1064,0,1322,80.48411498
雲林縣,斗南鎮,中天里,72,543,55.57830092,434,44.42169908,977,20,997,0,1256,79.37898089
雲林縣,斗南鎮,舊社里,80,609,58,441,42,1050,18,1068,0,1356,78.76106195
雲林縣,斗南鎮,舊社里,81,290,64.58797327,159,35.41202673,449,17,466,0,621,75.04025765
雲林縣,斗南鎮,林子里,73,628,65.55323591,330,34.44676409,958,30,988,0,1252,78.91373802
雲林縣,斗南鎮,石龜里,74,402,58.00865801,291,41.99134199,693,24,717,0,888,80.74324324
雲林縣,斗南鎮,靖興里,76,419,60.46176046,274,39.53823954,693,29,722,0,903,79.95570321
雲林縣,斗南鎮,新南里,77,375,69.57328386,164,30.42671614,539,25,564,0,744,75.80645161
雲林縣,斗南鎮,阿丹里,78,594,61.875,366,38.125,960,42,1002,0,1177,85.13169074
雲林縣,斗南鎮,將軍里,79,660,58.5106383,468,41.4893617,1128,58,1186,0,1483,79.97302765
雲林縣,斗南鎮,東明里,90,440,58.12417437,317,41.87582563,757,29,786,0,994,79.07444668
雲林縣,斗南鎮,新光里,91,516,64.01985112,290,35.98014888,806,48,854,0,1050,81.33333333
雲林縣,斗南鎮,新光里,92,654,60.95060578,419,39.04939422,1073,45,1118,0,1364,81.96480938
雲林縣,斗南鎮,田頭里,93,493,59.04191617,342,40.95808383,835,37,872,1,1034,84.33268859
雲林縣,斗南鎮,田頭里,94,510,64.96815287,275,35.03184713,785,46,831,0,1024,81.15234375
雲林縣,斗南鎮,明昌里,82,571,50.48629531,560,49.51370469,1131,30,1161,0,1430,81.18881119
雲林縣,斗南鎮,明昌里,83,698,63.33938294,404,36.66061706,1102,43,1145,0,1408,81.32102273
雲林縣,斗南鎮,明昌里,84,605,51.09797297,579,48.90202703,1184,29,1213,0,1512,80.22486772
雲林縣,斗南鎮,大東里,85,405,58.18965517,291,41.81034483,696,40,736,0,933,78.88531618
雲林縣,斗南鎮,埤麻里,86,295,48.12398042,318,51.87601958,613,35,648,0,831,77.97833935
雲林縣,斗南鎮,西伯里,87,410,57.10306407,308,42.89693593,718,26,744,0,938,79.31769723
雲林縣,斗南鎮,新崙里,88,379,61.22778675,240,38.77221325,619,36,655,0,841,77.88347206
雲林縣,斗南鎮,新崙里,89,363,66,187,34,550,29,579,0,742,78.03234501
雲林縣,斗南鎮,小東里,95,899,72.79352227,336,27.20647773,1235,38,1273,1,1596,79.76190476
雲林縣,斗南鎮,石溪里,75,489,67.26272352,238,32.73727648,727,33,760,0,924,82.25108225
雲林縣,虎尾鎮,中山里,104,390,47.91154791,424,52.08845209,814,24,838,0,1071,78.24463119
雲林縣,虎尾鎮,新興里,98,279,51.95530726,258,48.04469274,537,7,544,0,690,78.84057971
雲林縣,虎尾鎮,新興里,99,370,48.05194805,400,51.94805195,770,20,790,0,1014,77.90927022
雲林縣,虎尾鎮,東仁里,96,409,45.90347924,482,54.09652076,891,19,910,0,1109,82.05590622
雲林縣,虎尾鎮,東仁里,97,424,46.95459579,479,53.04540421,903,19,922,0,1155,79.82683983
雲林縣,虎尾鎮,公安里,100,484,49.59016393,492,50.40983607,976,16,992,0,1233,80.4541768
雲林縣,虎尾鎮,公安里,101,535,46.20034542,623,53.79965458,1158,13,1171,0,1443,81.15038115
雲林縣,虎尾鎮,德興里,102,405,52.5974026,365,47.4025974,770,6,776,0,1009,76.90782953
雲林縣,虎尾鎮,德興里,103,463,43.27102804,607,56.72897196,1070,28,1098,0,1424,77.10674157
雲林縣,虎尾鎮,西安里,105,554,48.29991282,593,51.70008718,1147,15,1162,0,1432,81.1452514
雲林縣,虎尾鎮,西安里,106,548,46.91780822,620,53.08219178,1168,31,1199,0,1545,77.60517799
雲林縣,虎尾鎮,安慶里,109,456,42.18316374,625,57.81683626,1081,23,1104,0,1366,80.81991215
雲林縣,虎尾鎮,平和里,110,518,48.50187266,550,51.49812734,1068,23,1091,1,1423,76.66900914
雲林縣,虎尾鎮,興南里,111,693,51.10619469,663,48.89380531,1356,33,1389,0,1764,78.7414966
雲林縣,虎尾鎮,新吉里,112,608,53.52112676,528,46.47887324,1136,23,1159,0,1473,78.68295995
雲林縣,虎尾鎮,新吉里,113,425,53.93401015,363,46.06598985,788,18,806,0,1023,78.78787879
雲林縣,虎尾鎮,穎川里,114,729,57.26630008,544,42.73369992,1273,41,1314,1,1682,78.12128419
雲林縣,虎尾鎮,延平里,115,402,57.92507205,292,42.07492795,694,32,726,0,945,76.82539683
雲林縣,虎尾鎮,三合里,135,399,54.43383356,334,45.56616644,733,28,761,0,1029,73.9552964
雲林縣,虎尾鎮,北溪里,134,366,59.80392157,246,40.19607843,612,4,616,0,781,78.87323944
雲林縣,虎尾鎮,墾地里,133,492,69.49152542,216,30.50847458,708,37,745,0,979,76.09805924
雲林縣,虎尾鎮,西屯里,131,592,55.17241379,481,44.82758621,1073,55,1128,0,1515,74.45544554
雲林縣,虎尾鎮,芳草里,132,459,74.03225806,161,25.96774194,620,42,662,0,870,76.09195402
雲林縣,虎尾鎮,埒內里,117,597,60.98059244,382,39.01940756,979,13,992,1,1255,79.0438247
雲林縣,虎尾鎮,埒內里,118,593,68.63425926,271,31.36574074,864,24,888,0,1104,80.43478261
雲林縣,虎尾鎮,堀頭里,119,399,64.87804878,216,35.12195122,615,8,623,0,778,80.07712082
雲林縣,虎尾鎮,安溪里,120,781,58.67768595,550,41.32231405,1331,63,1394,0,1715,81.28279883
雲林縣,虎尾鎮,興中里,121,708,58.85286783,495,41.14713217,1203,55,1258,0,1589,79.16928886
雲林縣,虎尾鎮,廉使里,122,666,62.24299065,404,37.75700935,1070,37,1107,0,1398,79.18454936
雲林縣,虎尾鎮,廉使里,123,667,59.60679178,452,40.39320822,1119,33,1152,0,1483,77.68037761
雲林縣,虎尾鎮,惠來里,124,422,45.5231931,505,54.4768069,927,9,936,0,1244,75.24115756
雲林縣,虎尾鎮,惠來里,125,486,62.62886598,290,37.37113402,776,50,826,0,1044,79.11877395
雲林縣,虎尾鎮,頂溪里,126,611,64.18067227,341,35.81932773,952,39,991,0,1216,81.49671053
雲林縣,虎尾鎮,頂溪里,127,604,64.66809422,330,35.33190578,934,44,978,0,1248,78.36538462
雲林縣,虎尾鎮,中溪里,128,591,59.15915916,408,40.84084084,999,39,1038,0,1299,79.90762125
雲林縣,虎尾鎮,下溪里,129,541,53.3530572,473,46.6469428,1014,52,1066,0,1307,81.56082632
雲林縣,虎尾鎮,建國里,116,142,27.04761905,383,72.95238095,525,28,553,0,758,72.95514512
雲林縣,虎尾鎮,立仁里,107,566,43.0418251,749,56.9581749,1315,11,1326,0,1619,81.90240889
雲林縣,虎尾鎮,立仁里,108,677,47.74330042,741,52.25669958,1418,30,1448,0,1900,76.21052632
雲林縣,虎尾鎮,東屯里,130,493,57.86384977,359,42.13615023,852,35,887,0,1161,76.39965547
雲林縣,西螺鎮,振興里,136,884,71.46321746,353,28.53678254,1237,49,1286,0,1595,80.62695925
雲林縣,西螺鎮,大園里,137,742,64.3538595,411,35.6461405,1153,46,1199,0,1505,79.66777409
雲林縣,西螺鎮,廣福里,138,726,56.54205607,558,43.45794393,1284,42,1326,0,1642,80.75517661
雲林縣,西螺鎮,正興里,139,523,52.88169869,466,47.11830131,989,23,1012,0,1289,78.51047324
雲林縣,西螺鎮,正興里,140,676,53.95051875,577,46.04948125,1253,37,1290,0,1610,80.1242236
雲林縣,西螺鎮,永安里,141,201,57.10227273,151,42.89772727,352,8,360,0,458,78.60262009
雲林縣,西螺鎮,中和里,142,321,58.04701627,232,41.95298373,553,11,564,0,703,80.22759602
雲林縣,西螺鎮,福興里,143,294,61.37787056,185,38.62212944,479,16,495,0,645,76.74418605
雲林縣,西螺鎮,光華里,144,473,61.83006536,292,38.16993464,765,18,783,0,990,79.09090909
雲林縣,西螺鎮,中興里,145,480,58.89570552,335,41.10429448,815,8,823,0,1052,78.23193916
雲林縣,西螺鎮,中興里,146,613,65.42155816,324,34.57844184,937,29,966,0,1184,81.58783784
雲林縣,西螺鎮,漢光里,147,780,61.27258445,493,38.72741555,1273,37,1310,0,1714,76.4294049
雲林縣,西螺鎮,漢光里,148,849,64.85867074,460,35.14132926,1309,40,1349,0,1737,77.66263673
雲林縣,西螺鎮,新安里,149,788,77.63546798,227,22.36453202,1015,48,1063,0,1295,82.08494208
雲林縣,西螺鎮,新豐里,150,853,74.43280977,293,25.56719023,1146,24,1170,0,1482,78.94736842
雲林縣,西螺鎮,詔安里,163,465,63.52459016,267,36.47540984,732,44,776,0,982,79.02240326
雲林縣,西螺鎮,河南里,164,457,65.00711238,246,34.99288762,703,25,728,0,924,78.78787879
雲林縣,西螺鎮,安定里,165,566,80.16997167,140,19.83002833,706,45,751,0,935,80.32085561
雲林縣,西螺鎮,安定里,166,495,80.22690438,122,19.77309562,617,45,662,0,870,76.09195402
雲林縣,西螺鎮,福田里,167,820,74.00722022,288,25.99277978,1108,58,1166,0,1422,81.99718706
雲林縣,西螺鎮,大新里,151,460,69.06906907,206,30.93093093,666,51,717,0,934,76.76659529
雲林縣,西螺鎮,大新里,152,414,67.4267101,200,32.5732899,614,38,652,0,821,79.41534714
雲林縣,西螺鎮,埤頭里,153,536,74.75592748,181,25.24407252,717,32,749,0,908,82.48898678
雲林縣,西螺鎮,東興里,154,657,76.84210526,198,23.15789474,855,39,894,0,1111,80.4680468
雲林縣,西螺鎮,廣興里,156,357,56.04395604,280,43.95604396,637,38,675,0,869,77.67548907
雲林縣,西螺鎮,鹿場里,155,810,70.92819615,332,29.07180385,1142,51,1193,0,1506,79.21646746
雲林縣,西螺鎮,頂湳里,157,513,69.70108696,223,30.29891304,736,40,776,0,978,79.34560327
雲林縣,西螺鎮,下湳里,160,253,42.59259259,341,57.40740741,594,28,622,0,813,76.50676507
雲林縣,西螺鎮,九隆里,159,404,68.35871404,187,31.64128596,591,31,622,0,763,81.52031455
雲林縣,西螺鎮,吳厝里,158,733,71.93326791,286,28.06673209,1019,47,1066,0,1359,78.44002943
雲林縣,西螺鎮,七座里,161,538,75.88152327,171,24.11847673,709,56,765,0,966,79.19254658
雲林縣,西螺鎮,公館里,162,737,74.14486922,257,25.85513078,994,51,1045,0,1390,75.17985612
雲林縣,土庫鎮,忠正里,168,391,55.53977273,313,44.46022727,704,13,717,0,937,76.5208111
雲林縣,土庫鎮,順天里,169,423,52.41635688,384,47.58364312,807,20,827,0,1017,81.31760079
雲林縣,土庫鎮,宮北里,170,545,53.06718598,482,46.93281402,1027,39,1066,0,1400,76.14285714
雲林縣,土庫鎮,越港里,171,347,51.10456554,332,48.89543446,679,21,700,0,921,76.00434311
雲林縣,土庫鎮,溪邊里,172,311,59.69289827,210,40.30710173,521,27,548,0,726,75.48209366
雲林縣,土庫鎮,溪邊里,173,190,58.28220859,136,41.71779141,326,18,344,0,444,77.47747748
雲林縣,土庫鎮,興新里,175,275,61.38392857,173,38.61607143,448,32,480,0,621,77.29468599
雲林縣,土庫鎮,興新里,176,324,62.66924565,193,37.33075435,517,15,532,0,712,74.71910112
雲林縣,土庫鎮,奮起里,177,391,72.40740741,149,27.59259259,540,19,559,0,829,67.43063932
雲林縣,土庫鎮,奮起里,178,219,52.14285714,201,47.85714286,420,23,443,0,607,72.98187809
雲林縣,土庫鎮,埤腳里,179,430,71.66666667,170,28.33333333,600,38,638,0,886,72.00902935
雲林縣,土庫鎮,埤腳里,180,215,54.15617128,182,45.84382872,397,19,416,0,560,74.28571429
雲林縣,土庫鎮,大荖里,185,361,56.8503937,274,43.1496063,635,23,658,0,875,75.2
雲林縣,土庫鎮,石廟里,174,674,58.35497835,481,41.64502165,1155,46,1201,0,1599,75.1094434
雲林縣,土庫鎮,東平里,186,521,69.46666667,229,30.53333333,750,18,768,0,1044,73.56321839
雲林縣,土庫鎮,東平里,187,459,74.03225806,161,25.96774194,620,28,648,0,848,76.41509434
雲林縣,土庫鎮,南平里,188,513,69.51219512,225,30.48780488,738,39,777,0,972,79.9382716
雲林縣,土庫鎮,南平里,189,417,69.61602671,182,30.38397329,599,32,631,0,845,74.67455621
雲林縣,土庫鎮,北平里,192,569,77.20488467,168,22.79511533,737,34,771,0,1003,76.86939182
雲林縣,土庫鎮,西平里,190,436,62.28571429,264,37.71428571,700,31,731,0,923,79.19826652
雲林縣,土庫鎮,西平里,191,404,68.12816189,189,31.87183811,593,29,622,0,863,72.07415991
雲林縣,土庫鎮,後埔里,181,590,64.76399561,321,35.23600439,911,46,957,0,1325,72.22641509
雲林縣,土庫鎮,後埔里,182,454,61.85286104,280,38.14713896,734,38,772,0,1022,75.53816047
雲林縣,土庫鎮,崙內里,183,378,67.25978648,184,32.74021352,562,35,597,0,832,71.75480769
雲林縣,土庫鎮,崙內里,184,291,60.87866109,187,39.12133891,478,19,497,0,716,69.41340782
雲林縣,土庫鎮,新庄里,193,697,65.75471698,363,34.24528302,1060,69,1129,0,1486,75.97577389
雲林縣,北港鎮,東陽里,194,422,68.28478964,196,31.71521036,618,30,648,0,823,78.7363305
雲林縣,北港鎮,光民里,195,401,66.39072848,203,33.60927152,604,32,636,0,783,81.22605364
雲林縣,北港鎮,東華里,196,274,68.84422111,124,31.15577889,398,8,406,0,518,78.37837838
雲林縣,北港鎮,南安里,197,578,71.27003699,233,28.72996301,811,20,831,0,1021,81.39079334
雲林縣,北港鎮,中和里,198,192,60.37735849,126,39.62264151,318,12,330,0,424,77.83018868
雲林縣,北港鎮,義民里,199,215,60.56338028,140,39.43661972,355,8,363,0,449,80.84632517
雲林縣,北港鎮,共榮里,200,238,68.3908046,110,31.6091954,348,10,358,0,436,82.11009174
雲林縣,北港鎮,西勢里,201,433,58.75169607,304,41.24830393,737,11,748,0,947,78.98627244
雲林縣,北港鎮,仁和里,202,266,59.90990991,178,40.09009009,444,14,458,0,548,83.57664234
雲林縣,北港鎮,賜福里,203,204,64.76190476,111,35.23809524,315,8,323,0,408,79.16666667
雲林縣,北港鎮,公館里,204,352,69.01960784,158,30.98039216,510,11,521,0,668,77.99401198
雲林縣,北港鎮,大同里,205,290,67.75700935,138,32.24299065,428,7,435,0,538,80.85501859
雲林縣,北港鎮,大同里,206,378,62.58278146,226,37.41721854,604,20,624,0,801,77.90262172
雲林縣,北港鎮,仁安里,207,219,52.01900238,202,47.98099762,421,14,435,0,530,82.0754717
雲林縣,北港鎮,華勝里,208,471,58.22002472,338,41.77997528,809,10,819,0,1026,79.8245614
雲林縣,北港鎮,華勝里,209,705,64.03269755,396,35.96730245,1101,29,1130,0,1425,79.29824561
雲林縣,北港鎮,華勝里,210,510,62.42350061,307,37.57649939,817,35,852,0,1062,80.2259887
雲林縣,北港鎮,華勝里,211,640,61.95546951,393,38.04453049,1033,21,1054,0,1356,77.72861357
雲林縣,北港鎮,光復里,212,538,54.12474849,456,45.87525151,994,24,1018,0,1339,76.02688574
雲林縣,北港鎮,新街里,213,697,62.79279279,413,37.20720721,1110,30,1140,0,1487,76.66442502
雲林縣,北港鎮,新街里,214,517,62.28915663,313,37.71084337,830,13,843,0,1054,79.98102467
雲林縣,北港鎮,新街里,215,587,51.90097259,544,48.09902741,1131,16,1147,0,1404,81.6951567
雲林縣,北港鎮,新街里,216,455,56.17283951,355,43.82716049,810,28,838,0,1070,78.31775701
雲林縣,北港鎮,劉厝里,217,597,66.48106904,301,33.51893096,898,7,905,0,1195,75.73221757
雲林縣,北港鎮,府番里,221,352,60.37735849,231,39.62264151,583,27,610,0,855,71.34502924
雲林縣,北港鎮,草湖里,222,769,73.0294397,284,26.9705603,1053,47,1100,0,1438,76.49513213
雲林縣,北港鎮,溝皂里,223,549,67.77777778,261,32.22222222,810,61,871,0,1216,71.62828947
雲林縣,北港鎮,後溝里,218,286,69.24939467,127,30.75060533,413,17,430,0,584,73.63013699
雲林縣,北港鎮,後溝里,219,230,73.24840764,84,26.75159236,314,10,324,0,397,81.61209068
雲林縣,北港鎮,番溝里,224,526,72.95423024,195,27.04576976,721,10,731,0,1035,70.62801932
雲林縣,北港鎮,大北里,225,299,72.57281553,113,27.42718447,412,22,434,0,642,67.60124611
雲林縣,北港鎮,好收里,226,481,63.70860927,274,36.29139073,755,45,800,0,1044,76.62835249
雲林縣,北港鎮,好收里,227,269,61.55606407,168,38.44393593,437,24,461,0,608,75.82236842
雲林縣,北港鎮,樹腳里,228,735,83.71298405,143,16.28701595,878,63,941,0,1217,77.32128184
雲林縣,北港鎮,樹腳里,229,694,59.36698033,475,40.63301967,1169,21,1190,0,1553,76.62588538
雲林縣,北港鎮,扶朝里,230,645,85.7712766,107,14.2287234,752,41,793,0,1030,76.99029126
雲林縣,北港鎮,水埔里,231,316,76.88564477,95,23.11435523,411,20,431,0,581,74.18244406
雲林縣,北港鎮,新厝里,220,225,67.97583082,106,32.02416918,331,17,348,0,436,79.81651376
雲林縣,古坑鄉,水碓村,240,563,61.93619362,346,38.06380638,909,38,947,0,1215,77.94238683
雲林縣,古坑鄉,田心村,241,470,62.08718626,287,37.91281374,757,20,777,0,979,79.36670072
雲林縣,古坑鄉,高林村,239,601,67.60404949,288,32.39595051,889,36,925,0,1176,78.65646259
雲林縣,古坑鄉,荷苞村,237,569,65.93279258,294,34.06720742,863,44,907,1,1133,80.05295675
雲林縣,古坑鄉,荷苞村,238,141,65.27777778,75,34.72222222,216,20,236,0,316,74.6835443
雲林縣,古坑鄉,東和村,235,618,60.82677165,398,39.17322835,1016,8,1024,0,1298,78.89060092
雲林縣,古坑鄉,東和村,236,701,60.48317515,458,39.51682485,1159,52,1211,0,1549,78.17947063
雲林縣,古坑鄉,新庄村,234,827,71.41623489,331,28.58376511,1158,61,1219,1,1560,78.14102564
雲林縣,古坑鄉,棋盤村,232,587,69.79785969,254,30.20214031,841,64,905,0,1139,79.45566286
雲林縣,古坑鄉,棋盤村,233,539,72.34899329,206,27.65100671,745,30,775,0,952,81.40756303
雲林縣,古坑鄉,華山村,255,374,67.75362319,178,32.24637681,552,22,574,0,781,73.49551857
雲林縣,古坑鄉,華南村,254,157,61.81102362,97,38.18897638,254,16,270,0,326,82.82208589
雲林縣,古坑鄉,永光村,248,459,63.39779006,265,36.60220994,724,35,759,0,996,76.20481928
雲林縣,古坑鄉,永光村,249,429,61.99421965,263,38.00578035,692,38,730,0,921,79.2616721
雲林縣,古坑鄉,桂林村,256,635,73.92316647,224,26.07683353,859,44,903,0,1176,76.78571429
雲林縣,古坑鄉,崁腳村,253,573,61.81229773,354,38.18770227,927,39,966,0,1288,75
雲林縣,古坑鄉,樟湖村,257,266,68.20512821,124,31.79487179,390,29,419,0,534,78.46441948
雲林縣,古坑鄉,草嶺村,258,376,68.61313869,172,31.38686131,548,23,571,0,692,82.51445087
雲林縣,古坑鄉,永昌村,250,521,66.62404092,261,33.37595908,782,25,807,0,1063,75.91721543
雲林縣,古坑鄉,永昌村,251,416,60.11560694,276,39.88439306,692,29,721,0,954,75.57651992
雲林縣,古坑鄉,麻園村,252,393,77.97619048,111,22.02380952,504,15,519,0,660,78.63636364
雲林縣,古坑鄉,古坑村,242,423,59.24369748,291,40.75630252,714,17,731,0,925,79.02702703
雲林縣,古坑鄉,古坑村,243,502,60.5548854,327,39.4451146,829,34,863,0,1126,76.64298401
雲林縣,古坑鄉,朝陽村,244,414,59.48275862,282,40.51724138,696,27,723,0,922,78.4164859
雲林縣,古坑鄉,朝陽村,245,454,55.56915545,363,44.43084455,817,8,825,0,1041,79.25072046
雲林縣,古坑鄉,西平村,246,677,60.77199282,437,39.22800718,1114,30,1144,0,1419,80.62015504
雲林縣,古坑鄉,湳仔村,247,348,67.44186047,168,32.55813953,516,26,542,0,682,79.47214076
雲林縣,大埤鄉,北和村,259,363,63.79613357,206,36.20386643,569,34,603,0,787,76.62007624
雲林縣,大埤鄉,南和村,260,699,60.94158675,448,39.05841325,1147,46,1193,0,1512,78.9021164
雲林縣,大埤鄉,南和村,261,276,61.74496644,171,38.25503356,447,13,460,0,590,77.96610169
雲林縣,大埤鄉,大德村,262,506,62.70136307,301,37.29863693,807,29,836,0,1104,75.72463768
雲林縣,大埤鄉,松竹村,263,521,72.86713287,194,27.13286713,715,44,759,0,1000,75.9
雲林縣,大埤鄉,尚義村,264,715,67.77251185,340,32.22748815,1055,36,1091,0,1399,77.98427448
雲林縣,大埤鄉,尚義村,265,219,63.29479769,127,36.70520231,346,25,371,0,484,76.65289256
雲林縣,大埤鄉,嘉興村,266,644,63.44827586,371,36.55172414,1015,44,1059,0,1327,79.80406933
雲林縣,大埤鄉,嘉興村,267,257,66.92708333,127,33.07291667,384,2,386,0,495,77.97979798
雲林縣,大埤鄉,豐田村,268,609,58.4452975,433,41.5547025,1042,27,1069,0,1372,77.9154519
雲林縣,大埤鄉,三結村,269,629,68.7431694,286,31.2568306,915,47,962,0,1262,76.22820919
雲林縣,大埤鄉,吉田村,270,435,71.31147541,175,28.68852459,610,28,638,0,823,77.52126367
雲林縣,大埤鄉,豐岡村,271,283,55.92885375,223,44.07114625,506,31,537,0,691,77.71345876
雲林縣,大埤鄉,聯美村,272,536,63.28217237,311,36.71782763,847,62,909,1,1238,73.42487884
雲林縣,大埤鄉,怡然村,273,360,57.23370429,269,42.76629571,629,36,665,0,847,78.51239669
雲林縣,大埤鄉,北鎮村,274,361,69.15708812,161,30.84291188,522,27,549,0,721,76.14424411
雲林縣,大埤鄉,興安村,275,361,64.23487544,201,35.76512456,562,34,596,0,804,74.12935323
雲林縣,大埤鄉,西鎮村,276,307,55.01792115,251,44.98207885,558,40,598,0,794,75.31486146
雲林縣,莿桐鄉,莿桐村,277,621,61.48514851,389,38.51485149,1010,34,1044,0,1313,79.51256664
雲林縣,莿桐鄉,莿桐村,278,570,61.35629709,359,38.64370291,929,13,942,2,1156,81.48788927
雲林縣,莿桐鄉,莿桐村,279,564,66.74556213,281,33.25443787,845,17,862,0,1071,80.48552754
雲林縣,莿桐鄉,甘厝村,280,568,77.70177839,163,22.29822161,731,37,768,0,934,82.22698073
雲林縣,莿桐鄉,甘西村,281,950,78.125,266,21.875,1216,51,1267,0,1625,77.96923077
雲林縣,莿桐鄉,興桐村,282,312,68.72246696,142,31.27753304,454,24,478,0,580,82.4137931
雲林縣,莿桐鄉,興桐村,283,363,66.12021858,186,33.87978142,549,33,582,0,691,84.22575977
雲林縣,莿桐鄉,義和村,284,697,77.87709497,198,22.12290503,895,41,936,0,1160,80.68965517
雲林縣,莿桐鄉,埔子村,285,453,65.46242775,239,34.53757225,692,22,714,0,849,84.09893993
雲林縣,莿桐鄉,埔子村,286,536,72.92517007,199,27.07482993,735,23,758,0,918,82.5708061
雲林縣,莿桐鄉,大美村,287,652,62.81310212,386,37.18689788,1038,39,1077,0,1351,79.71872687
雲林縣,莿桐鄉,大美村,288,531,57.65472313,390,42.34527687,921,38,959,0,1161,82.60120586
雲林縣,莿桐鄉,埔尾村,289,586,58.01980198,424,41.98019802,1010,49,1059,0,1271,83.3202203
雲林縣,莿桐鄉,饒平村,292,577,66.55132641,290,33.44867359,867,32,899,0,1168,76.96917808
雲林縣,莿桐鄉,興貴村,290,398,57.51445087,294,42.48554913,692,32,724,0,894,80.98434004
雲林縣,莿桐鄉,興貴村,291,548,70.25641026,232,29.74358974,780,27,807,0,1010,79.9009901
雲林縣,莿桐鄉,四合村,293,849,64.0754717,476,35.9245283,1325,59,1384,0,1775,77.97183099
雲林縣,莿桐鄉,麻園村,294,832,69.10299003,372,30.89700997,1204,63,1267,0,1587,79.83616887
雲林縣,莿桐鄉,五華村,295,723,69.99031946,310,30.00968054,1033,40,1073,0,1347,79.65850037
雲林縣,莿桐鄉,六合村,296,642,73.45537757,232,26.54462243,874,39,913,0,1162,78.57142857
雲林縣,莿桐鄉,六合村,297,291,62.71551724,173,37.28448276,464,18,482,0,609,79.14614122
雲林縣,林內鄉,林南村,298,357,44.12855377,452,55.87144623,809,29,838,0,1049,79.88560534
雲林縣,林內鄉,林中村,299,843,61.39839767,530,38.60160233,1373,41,1414,0,1743,81.12449799
雲林縣,林內鄉,林中村,300,635,49.57064793,646,50.42935207,1281,31,1312,0,1686,77.8173191
雲林縣,林內鄉,林北村,301,585,55.03292568,478,44.96707432,1063,39,1102,0,1422,77.49648383
雲林縣,林內鄉,林北村,302,387,71.53419593,154,28.46580407,541,28,569,0,734,77.52043597
雲林縣,林內鄉,坪頂村,303,240,52.74725275,215,47.25274725,455,28,483,0,611,79.0507365
雲林縣,林內鄉,林茂村,304,449,63.4180791,259,36.5819209,708,15,723,1,932,77.5751073
雲林縣,林內鄉,九芎村,305,492,59.56416465,334,40.43583535,826,23,849,0,1040,81.63461538
雲林縣,林內鄉,九芎村,306,698,61.38962181,439,38.61037819,1137,30,1167,0,1497,77.95591182
雲林縣,林內鄉,湖本村,307,332,68.3127572,154,31.6872428,486,23,509,0,652,78.06748466
雲林縣,林內鄉,烏塗村,308,512,57.33482643,381,42.66517357,893,10,903,0,1115,80.98654709
雲林縣,林內鄉,烏麻村,309,437,52.71411339,392,47.28588661,829,24,853,0,1038,82.17726397
雲林縣,林內鄉,重興村,310,462,66.28407461,235,33.71592539,697,31,728,0,919,79.21653972
雲林縣,林內鄉,重興村,311,438,66.87022901,217,33.12977099,655,43,698,0,863,80.8806489
雲林縣,二崙鄉,崙東村,312,637,59.1457753,440,40.8542247,1077,45,1122,0,1435,78.18815331
雲林縣,二崙鄉,崙西村,313,816,64.60807601,447,35.39192399,1263,56,1319,0,1662,79.3622142
雲林縣,二崙鄉,來惠村,314,349,68.7007874,159,31.2992126,508,30,538,0,709,75.88152327
雲林縣,二崙鄉,來惠村,315,593,76.31917632,184,23.68082368,777,45,822,0,1081,76.04070305
雲林縣,二崙鄉,三和村,316,286,71.85929648,112,28.14070352,398,11,409,0,498,82.12851406
雲林縣,二崙鄉,三和村,317,604,74.66007417,205,25.33992583,809,36,845,0,1134,74.51499118
雲林縣,二崙鄉,湳仔村,318,599,64.20150054,334,35.79849946,933,34,967,0,1256,76.99044586
雲林縣,二崙鄉,田尾村,319,487,63.16472114,284,36.83527886,771,27,798,0,1040,76.73076923
雲林縣,二崙鄉,田尾村,320,464,63.04347826,272,36.95652174,736,32,768,0,976,78.68852459
雲林縣,二崙鄉,定安村,321,548,74.96580027,183,25.03419973,731,35,766,0,968,79.1322314
雲林縣,二崙鄉,大華村,323,510,76.92307692,153,23.07692308,663,52,715,0,930,76.88172043
雲林縣,二崙鄉,義庄村,324,474,79.13188648,125,20.86811352,599,31,630,0,792,79.54545455
雲林縣,二崙鄉,楊賢村,325,847,75.55753791,274,24.44246209,1121,76,1197,0,1537,77.87898504
雲林縣,二崙鄉,港後村,326,729,81,171,19,900,53,953,1,1242,76.7310789
雲林縣,二崙鄉,港後村,327,358,63.70106762,204,36.29893238,562,22,584,0,731,79.89056088
雲林縣,二崙鄉,大義村,328,507,73.79912664,180,26.20087336,687,39,726,0,934,77.73019272
雲林縣,二崙鄉,油車村,329,537,64.00476758,302,35.99523242,839,30,869,0,1105,78.64253394
雲林縣,二崙鄉,油車村,330,374,73.18982387,137,26.81017613,511,23,534,0,690,77.39130435
雲林縣,二崙鄉,大庄村,331,740,70.81339713,305,29.18660287,1045,51,1096,0,1432,76.53631285
雲林縣,二崙鄉,庄西村,332,484,68.07313643,227,31.92686357,711,50,761,0,1012,75.19762846
雲林縣,二崙鄉,大同村,333,426,68.05111821,200,31.94888179,626,35,661,0,860,76.86046512
雲林縣,二崙鄉,復興村,334,500,66.75567423,249,33.24432577,749,50,799,0,1062,75.2354049
雲林縣,二崙鄉,永定村,322,779,76.90029615,234,23.09970385,1013,56,1069,0,1366,78.25768668
雲林縣,崙背鄉,東明村,335,502,52.12876428,461,47.87123572,963,43,1006,0,1293,77.80355762
雲林縣,崙背鄉,西榮村,336,617,57.9342723,448,42.0657277,1065,43,1108,0,1435,77.21254355
雲林縣,崙背鄉,南陽村,337,425,57.35492578,316,42.64507422,741,33,774,0,993,77.94561934
雲林縣,崙背鄉,南陽村,338,507,53.48101266,441,46.51898734,948,38,986,0,1277,77.21221613
雲林縣,崙背鄉,崙前村,339,589,69.62174941,257,30.37825059,846,8,854,0,1085,78.70967742
雲林縣,崙背鄉,崙前村,340,481,71.68405365,190,28.31594635,671,43,714,0,973,73.38129496
雲林縣,崙背鄉,羅厝村,341,424,61.36034732,267,38.63965268,691,36,727,0,972,74.79423868
雲林縣,崙背鄉,羅厝村,342,566,66.82408501,281,33.17591499,847,32,879,0,1084,81.08856089
雲林縣,崙背鄉,港尾村,343,686,69.85743381,296,30.14256619,982,64,1046,0,1378,75.90711176
雲林縣,崙背鄉,阿勸村,344,411,53.58539765,356,46.41460235,767,52,819,0,1078,75.97402597
雲林縣,崙背鄉,阿勸村,345,524,68.94736842,236,31.05263158,760,8,768,0,981,78.28746177
雲林縣,崙背鄉,五魁村,346,216,31.71806167,465,68.28193833,681,12,693,1,922,75.1626898
雲林縣,崙背鄉,大有村,347,342,60,228,40,570,35,605,0,815,74.23312883
雲林縣,崙背鄉,大有村,348,402,61.00151745,257,38.99848255,659,41,700,0,963,72.68951194
雲林縣,崙背鄉,豐榮村,349,420,62.40713224,253,37.59286776,673,28,701,0,992,70.66532258
雲林縣,崙背鄉,豐榮村,350,432,60.93088858,277,39.06911142,709,28,737,0,1088,67.73897059
雲林縣,崙背鄉,草湖村,351,602,57.11574953,452,42.88425047,1054,54,1108,0,1504,73.67021277
雲林縣,崙背鄉,舊庄村,352,525,61.47540984,329,38.52459016,854,49,903,0,1216,74.25986842
雲林縣,崙背鄉,水尾村,353,677,68.73096447,308,31.26903553,985,36,1021,0,1296,78.7808642
雲林縣,崙背鄉,枋南村,354,394,61.94968553,242,38.05031447,636,39,675,0,851,79.31844888
雲林縣,麥寮鄉,麥津村,358,418,47.5,462,52.5,880,31,911,0,1247,73.0553328
雲林縣,麥寮鄉,麥津村,359,432,44.44444444,540,55.55555556,972,34,1006,0,1385,72.63537906
雲林縣,麥寮鄉,麥豐村,355,221,49.44071588,226,50.55928412,447,16,463,0,644,71.89440994
雲林縣,麥寮鄉,麥豐村,356,514,44.5407279,640,55.4592721,1154,34,1188,3,1621,73.28809377
雲林縣,麥寮鄉,麥豐村,357,300,35.16998828,553,64.83001172,853,27,880,0,1170,75.21367521
雲林縣,麥寮鄉,瓦窯村,360,179,57.92880259,130,42.07119741,309,12,321,0,509,63.06483301
雲林縣,麥寮鄉,瓦窯村,361,339,58.24742268,243,41.75257732,582,27,609,0,866,70.32332564
雲林縣,麥寮鄉,興華村,362,289,58.14889336,208,41.85110664,497,28,525,0,729,72.01646091
雲林縣,麥寮鄉,興華村,363,369,50.34106412,364,49.65893588,733,30,763,0,1114,68.49192101
雲林縣,麥寮鄉,崙後村,370,226,38.37011885,363,61.62988115,589,33,622,0,913,68.12705367
雲林縣,麥寮鄉,崙後村,371,292,45.34161491,352,54.65838509,644,35,679,0,957,70.95088819
雲林縣,麥寮鄉,後安村,366,253,36.03988604,449,63.96011396,702,24,726,0,1015,71.5270936
雲林縣,麥寮鄉,後安村,367,244,32.36074271,510,67.63925729,754,26,780,0,1140,68.42105263
雲林縣,麥寮鄉,海豐村,364,244,42.28769497,333,57.71230503,577,7,584,0,856,68.22429907
雲林縣,麥寮鄉,海豐村,365,189,46.21026895,220,53.78973105,409,17,426,0,621,68.59903382
雲林縣,麥寮鄉,三盛村,368,347,52.18045113,318,47.81954887,665,39,704,0,984,71.54471545
雲林縣,麥寮鄉,三盛村,369,501,60.43425814,328,39.56574186,829,41,870,0,1301,66.8716372
雲林縣,麥寮鄉,橋頭村,372,360,53.33333333,315,46.66666667,675,37,712,0,1012,70.35573123
雲林縣,麥寮鄉,橋頭村,373,603,53.69545859,520,46.30454141,1123,54,1177,0,1599,73.60850532
雲林縣,麥寮鄉,新吉村,374,327,61.35084428,206,38.64915572,533,31,564,0,794,71.03274559
雲林縣,麥寮鄉,施厝村,375,539,62.16839677,328,37.83160323,867,42,909,0,1251,72.6618705
雲林縣,麥寮鄉,施厝村,376,424,59.3006993,291,40.6993007,715,4,719,0,1023,70.28347996
雲林縣,麥寮鄉,雷厝村,377,540,56.96202532,408,43.03797468,948,58,1006,1,1483,67.83546864
雲林縣,東勢鄉,東南村,382,532,49.76613658,537,50.23386342,1069,36,1105,0,1457,75.8407687
雲林縣,東勢鄉,東北村,383,435,52.3465704,396,47.6534296,831,30,861,1,1209,71.21588089
雲林縣,東勢鄉,嘉隆村,380,449,69.6124031,196,30.3875969,645,45,690,0,1034,66.7311412
雲林縣,東勢鄉,嘉隆村,381,258,51.91146881,239,48.08853119,497,30,527,0,760,69.34210526
雲林縣,東勢鄉,復興村,379,186,53.60230548,161,46.39769452,347,21,368,0,494,74.49392713
雲林縣,東勢鄉,月眉村,378,538,65.45012165,284,34.54987835,822,49,871,0,1297,67.15497301
雲林縣,東勢鄉,程海村,385,224,57.43589744,166,42.56410256,390,29,419,0,604,69.37086093
雲林縣,東勢鄉,龍潭村,384,428,63.88059701,242,36.11940299,670,63,733,0,1017,72.0747296
雲林縣,東勢鄉,安南村,387,365,62.71477663,217,37.28522337,582,54,636,0,934,68.09421842
雲林縣,東勢鄉,昌南村,386,398,61.99376947,244,38.00623053,642,39,681,0,951,71.60883281
雲林縣,東勢鄉,同安村,388,314,50.97402597,302,49.02597403,616,40,656,0,1036,63.32046332
雲林縣,東勢鄉,同安村,389,405,53.28947368,355,46.71052632,760,43,803,0,1159,69.2838654
雲林縣,東勢鄉,新坤村,392,446,57.17948718,334,42.82051282,780,37,817,0,1268,64.43217666
雲林縣,東勢鄉,四美村,390,197,37.24007561,332,62.75992439,529,8,537,0,840,63.92857143
雲林縣,東勢鄉,四美村,391,238,76.28205128,74,23.71794872,312,20,332,0,471,70.48832272
雲林縣,褒忠鄉,中民村,393,396,59.10447761,274,40.89552239,670,42,712,0,965,73.78238342
雲林縣,褒忠鄉,中民村,394,344,52.12121212,316,47.87878788,660,32,692,0,933,74.1693462
雲林縣,褒忠鄉,埔姜村,395,480,49.12998976,497,50.87001024,977,50,1027,1,1407,72.99218195
雲林縣,褒忠鄉,中勝村,396,585,56.74102813,446,43.25897187,1031,44,1075,0,1444,74.44598338
雲林縣,褒忠鄉,新湖村,399,195,50.78125,189,49.21875,384,21,405,0,528,76.70454545
雲林縣,褒忠鄉,新湖村,400,397,75.18939394,131,24.81060606,528,38,566,0,783,72.28607918
雲林縣,褒忠鄉,馬鳴村,397,190,62.29508197,115,37.70491803,305,23,328,0,435,75.40229885
雲林縣,褒忠鄉,馬鳴村,398,447,67.31927711,217,32.68072289,664,51,715,0,981,72.88481142
雲林縣,褒忠鄉,有才村,401,429,66.82242991,213,33.17757009,642,43,685,0,969,70.69143447
雲林縣,褒忠鄉,田洋村,402,357,61.13013699,227,38.86986301,584,33,617,0,814,75.7985258
雲林縣,褒忠鄉,龍岩村,403,468,52.7621195,419,47.2378805,887,49,936,0,1286,72.78382582
雲林縣,褒忠鄉,潮厝村,404,483,70.61403509,201,29.38596491,684,44,728,0,989,73.60970677
雲林縣,台西鄉,臺西村,405,324,36.08017817,574,63.91982183,898,31,929,1,1257,73.9061257
雲林縣,台西鄉,海北村,407,295,44.62934947,366,55.37065053,661,34,695,0,1070,64.95327103
雲林縣,台西鄉,海南村,406,296,41.22562674,422,58.77437326,718,5,723,0,1056,68.46590909
雲林縣,台西鄉,海口村,408,297,46.91943128,336,53.08056872,633,34,667,1,1021,65.3281097
雲林縣,台西鄉,海口村,409,227,38.60544218,361,61.39455782,588,29,617,0,964,64.00414938
雲林縣,台西鄉,溪頂村,411,577,64.11111111,323,35.88888889,900,53,953,0,1550,61.48387097
雲林縣,台西鄉,牛厝村,412,505,67.42323097,244,32.57676903,749,89,838,0,1273,65.82875098
雲林縣,台西鄉,牛厝村,413,227,52.18390805,208,47.81609195,435,9,444,0,710,62.53521127
雲林縣,台西鄉,泉州村,414,215,55.12820513,175,44.87179487,390,26,416,0,653,63.70597243
雲林縣,台西鄉,光華村,416,241,53.200883,212,46.799117,453,24,477,0,699,68.24034335
雲林縣,台西鄉,五榔村,415,232,70.09063444,99,29.90936556,331,2,333,0,504,66.07142857
雲林縣,台西鄉,山寮村,410,318,58.24175824,228,41.75824176,546,52,598,0,928,64.43965517
雲林縣,台西鄉,富琦村,419,364,49.59128065,370,50.40871935,734,8,742,0,1059,70.06610009
雲林縣,台西鄉,富琦村,420,91,27.00296736,246,72.99703264,337,19,356,0,512,69.53125
雲林縣,台西鄉,永豐村,421,431,45.7537155,511,54.2462845,942,48,990,1,1472,67.25543478
雲林縣,台西鄉,和豐村,422,321,47.91044776,349,52.08955224,670,46,716,0,1065,67.23004695
雲林縣,台西鄉,和豐村,423,345,50.58651026,337,49.41348974,682,37,719,0,1068,67.32209738
雲林縣,台西鄉,和豐村,424,306,47.00460829,345,52.99539171,651,60,711,0,1153,61.66522116
雲林縣,台西鄉,蚊港村,425,452,51.36363636,428,48.63636364,880,71,951,0,1341,70.91722595
雲林縣,台西鄉,蚊港村,426,126,27.75330396,328,72.24669604,454,25,479,0,728,65.7967033
雲林縣,台西鄉,五港村,417,479,57.02380952,361,42.97619048,840,52,892,0,1371,65.06199854
雲林縣,台西鄉,五港村,418,148,40.65934066,216,59.34065934,364,32,396,0,575,68.86956522
雲林縣,元長鄉,長南村,427,742,56.51180503,571,43.48819497,1313,65,1378,0,1820,75.71428571
雲林縣,元長鄉,長南村,428,637,68.49462366,293,31.50537634,930,50,980,0,1383,70.8604483
雲林縣,元長鄉,長北村,429,410,69.13996627,183,30.86003373,593,44,637,0,847,75.20661157
雲林縣,元長鄉,長北村,430,374,64.26116838,208,35.73883162,582,5,587,0,834,70.38369305
雲林縣,元長鄉,子茂村,431,659,64.54456415,362,35.45543585,1021,46,1067,0,1513,70.52214144
雲林縣,元長鄉,後湖村,432,397,65.72847682,207,34.27152318,604,10,614,0,814,75.42997543
雲林縣,元長鄉,山內村,433,346,49.28774929,356,50.71225071,702,53,755,0,1061,71.15928369
雲林縣,元長鄉,合和村,434,596,69.78922717,258,30.21077283,854,5,859,0,1221,70.35217035
雲林縣,元長鄉,五塊村,435,365,52.82199711,326,47.17800289,691,32,723,0,1067,67.76007498
雲林縣,元長鄉,潭西村,436,396,73.06273063,146,26.93726937,542,41,583,0,926,62.95896328
雲林縣,元長鄉,潭東村,437,214,47.87472036,233,52.12527964,447,27,474,0,692,68.49710983
雲林縣,元長鄉,客厝村,438,395,65.07413509,212,34.92586491,607,46,653,0,883,73.95243488
雲林縣,元長鄉,卓運村,439,240,82.4742268,51,17.5257732,291,27,318,0,464,68.53448276
雲林縣,元長鄉,頂寮村,440,536,67.76232617,255,32.23767383,791,43,834,0,1248,66.82692308
雲林縣,元長鄉,下寮村,441,642,61.90935391,395,38.09064609,1037,64,1101,0,1533,71.81996086
雲林縣,元長鄉,龍岩村,442,557,77.1468144,165,22.8531856,722,65,787,0,1107,71.09304426
雲林縣,元長鄉,西莊村,443,444,71.26805778,179,28.73194222,623,49,672,0,927,72.49190939
雲林縣,元長鄉,鹿北村,444,598,67.04035874,294,32.95964126,892,53,945,0,1348,70.10385757
雲林縣,元長鄉,鹿南村,445,475,70.37037037,200,29.62962963,675,54,729,0,1049,69.49475691
雲林縣,元長鄉,瓦窯村,446,379,73.4496124,137,26.5503876,516,33,549,0,775,70.83870968
雲林縣,元長鄉,瓦窯村,447,425,68.99350649,191,31.00649351,616,41,657,0,885,74.23728814
雲林縣,元長鄉,內寮村,448,335,72.19827586,129,27.80172414,464,36,500,0,672,74.4047619
雲林縣,元長鄉,崙仔村,449,392,64.79338843,213,35.20661157,605,51,656,0,935,70.16042781
雲林縣,元長鄉,新吉村,450,319,61.70212766,198,38.29787234,517,37,554,0,739,74.9661705
雲林縣,四湖鄉,四湖村,451,447,62.60504202,267,37.39495798,714,4,718,0,1029,69.77648202
雲林縣,四湖鄉,四湖村,452,299,57.61078998,220,42.38921002,519,21,540,0,736,73.36956522
雲林縣,四湖鄉,新庄村,455,312,65.82278481,162,34.17721519,474,36,510,0,717,71.12970711
雲林縣,四湖鄉,溪底村,456,466,65.72637518,243,34.27362482,709,42,751,0,1086,69.15285451
雲林縣,四湖鄉,鹿場村,457,396,57.22543353,296,42.77456647,692,55,747,0,1119,66.75603217
雲林縣,四湖鄉,湖西村,453,553,47.75474957,605,52.24525043,1158,46,1204,0,1568,76.78571429
雲林縣,四湖鄉,湖西村,454,298,79.89276139,75,20.10723861,373,38,411,0,568,72.35915493
雲林縣,四湖鄉,施湖村,460,409,56.25859697,318,43.74140303,727,61,788,0,1228,64.16938111
雲林縣,四湖鄉,湖寮村,459,377,67.56272401,181,32.43727599,558,18,576,0,884,65.15837104
雲林縣,四湖鄉,蔡厝村,458,409,66.28849271,208,33.71150729,617,42,659,0,978,67.38241309
雲林縣,四湖鄉,飛沙村,464,255,45.29307282,308,54.70692718,563,5,568,0,995,57.08542714
雲林縣,四湖鄉,三姓村,465,119,51.73913043,111,48.26086957,230,23,253,0,423,59.8108747
雲林縣,四湖鄉,內湖村,462,344,64.66165414,188,35.33834586,532,38,570,0,969,58.82352941
雲林縣,四湖鄉,羊調村,461,383,56.15835777,299,43.84164223,682,65,747,0,1152,64.84375
雲林縣,四湖鄉,崙北村,466,342,58.56164384,242,41.43835616,584,10,594,0,981,60.55045872
雲林縣,四湖鄉,崙北村,467,274,51.79584121,255,48.20415879,529,46,575,0,841,68.37098692
雲林縣,四湖鄉,崙南村,468,303,57.06214689,228,42.93785311,531,44,575,0,928,61.9612069
雲林縣,四湖鄉,廣溝村,469,201,40.93686354,290,59.06313646,491,24,515,0,816,63.1127451
雲林縣,四湖鄉,箔子村,470,447,73.03921569,165,26.96078431,612,35,647,0,1050,61.61904762
雲林縣,四湖鄉,林厝村,472,477,58.88888889,333,41.11111111,810,70,880,0,1301,67.64027671
雲林縣,四湖鄉,林東村,473,329,54.02298851,280,45.97701149,609,69,678,0,1096,61.86131387
雲林縣,四湖鄉,溪尾村,474,223,45.23326572,270,54.76673428,493,45,538,0,852,63.14553991
雲林縣,四湖鄉,飛東村,463,216,55.38461538,174,44.61538462,390,27,417,0,654,63.76146789
雲林縣,四湖鄉,箔東村,471,548,77.95163585,155,22.04836415,703,45,748,0,1175,63.65957447
雲林縣,口湖鄉,湖東村,476,475,52.08333333,437,47.91666667,912,44,956,0,1306,73.20061256
雲林縣,口湖鄉,口湖村,475,438,57.85997358,319,42.14002642,757,35,792,0,1082,73.19778189
雲林縣,口湖鄉,頂湖村,477,244,55.5808656,195,44.4191344,439,27,466,0,706,66.00566572
雲林縣,口湖鄉,埔北村,479,364,70.13487476,155,29.86512524,519,43,562,0,934,60.17130621
雲林縣,口湖鄉,埔南村,478,313,64.27104723,174,35.72895277,487,26,513,0,682,75.21994135
雲林縣,口湖鄉,謝厝村,480,491,70.74927954,203,29.25072046,694,41,735,0,1018,72.20039293
雲林縣,口湖鄉,蚵寮村,481,720,73.69498465,257,26.30501535,977,75,1052,0,1467,71.71097478
雲林縣,口湖鄉,下崙村,482,370,70.34220532,156,29.65779468,526,33,559,0,906,61.69977925
雲林縣,口湖鄉,下崙村,483,500,66.22516556,255,33.77483444,755,38,793,0,1210,65.53719008
雲林縣,口湖鄉,崙中村,484,347,66.73076923,173,33.26923077,520,28,548,0,880,62.27272727
雲林縣,口湖鄉,崙中村,485,362,67.6635514,173,32.3364486,535,29,564,0,887,63.58511838
雲林縣,口湖鄉,崙東村,486,638,64.9694501,344,35.0305499,982,46,1028,0,1564,65.72890026
雲林縣,口湖鄉,青蚶村,487,270,70.86614173,111,29.13385827,381,23,404,0,580,69.65517241
雲林縣,口湖鄉,港東村,488,644,60.18691589,426,39.81308411,1070,11,1081,0,1517,71.25906394
雲林縣,口湖鄉,港西村,489,246,46.2406015,286,53.7593985,532,24,556,0,817,68.05385557
雲林縣,口湖鄉,臺子村,490,190,72.24334601,73,27.75665399,263,11,274,0,355,77.18309859
雲林縣,口湖鄉,臺子村,491,843,84.89425982,150,15.10574018,993,35,1028,0,1341,76.65920955
雲林縣,口湖鄉,成龍村,492,420,58.57740586,297,41.42259414,717,34,751,0,1045,71.86602871
雲林縣,口湖鄉,湖口村,498,516,72.57383966,195,27.42616034,711,48,759,0,1072,70.80223881
雲林縣,口湖鄉,水井村,496,444,65.29411765,236,34.70588235,680,60,740,0,1060,69.81132075
雲林縣,口湖鄉,後厝村,497,437,76.80140598,132,23.19859402,569,24,593,0,805,73.66459627
雲林縣,口湖鄉,梧南村,493,453,68.53252648,208,31.46747352,661,40,701,0,918,76.36165577
雲林縣,口湖鄉,梧南村,494,396,59.37031484,271,40.62968516,667,34,701,0,962,72.86902287
雲林縣,口湖鄉,梧北村,495,764,82.23896663,165,17.76103337,929,57,986,0,1325,74.41509434
雲林縣,口湖鄉,過港村,499,321,65.37678208,170,34.62321792,491,17,508,0,753,67.46347942
雲林縣,水林鄉,水北村,500,635,66.07700312,326,33.92299688,961,45,1006,0,1387,72.53064167
雲林縣,水林鄉,水北村,501,469,65.87078652,243,34.12921348,712,15,727,0,931,78.08807734
雲林縣,水林鄉,水南村,502,600,69.93006993,258,30.06993007,858,28,886,0,1139,77.78753292
雲林縣,水林鄉,水南村,503,425,73.27586207,155,26.72413793,580,24,604,0,802,75.3117207
雲林縣,水林鄉,海埔村,523,592,80,148,20,740,44,784,0,1082,72.45841035
雲林縣,水林鄉,土厝村,524,718,78.29880044,199,21.70119956,917,32,949,0,1254,75.67783094
雲林縣,水林鄉,春埔村,510,550,75.03410641,183,24.96589359,733,46,779,0,1076,72.39776952
雲林縣,水林鄉,西井村,511,309,64.91596639,167,35.08403361,476,35,511,0,763,66.97247706
雲林縣,水林鄉,車港村,512,367,79.60954447,94,20.39045553,461,33,494,0,693,71.28427128
雲林縣,水林鄉,蘇秦村,513,598,75.03136763,199,24.96863237,797,62,859,0,1227,70.00814996
雲林縣,水林鄉,灣東村,514,255,56.4159292,197,43.5840708,452,35,487,0,761,63.99474376
雲林縣,水林鄉,灣西村,515,421,62.27810651,255,37.72189349,676,47,723,0,1075,67.25581395
雲林縣,水林鄉,萬興村,504,401,74.25925926,139,25.74074074,540,34,574,0,770,74.54545455
雲林縣,水林鄉,尖山村,505,358,71.31474104,144,28.68525896,502,31,533,0,752,70.87765957
雲林縣,水林鄉,大山村,508,605,76.97201018,181,23.02798982,786,50,836,0,1174,71.20954003
雲林縣,水林鄉,大溝村,506,493,68.47222222,227,31.52777778,720,39,759,0,1081,70.21276596
雲林縣,水林鄉,順興村,507,521,80.15384615,129,19.84615385,650,37,687,0,933,73.63344051
雲林縣,水林鄉,蕃薯村,516,567,75.29880478,186,24.70119522,753,52,805,0,1065,75.58685446
雲林縣,水林鄉,山腳村,517,498,80.06430868,124,19.93569132,622,41,663,0,916,72.37991266
雲林縣,水林鄉,松北村,518,605,67.74916013,288,32.25083987,893,9,902,0,1230,73.33333333
雲林縣,水林鄉,松中村,519,350,73.52941176,126,26.47058824,476,3,479,0,611,78.39607201
雲林縣,水林鄉,松西村,520,458,82.37410072,98,17.62589928,556,37,593,0,802,73.94014963
雲林縣,水林鄉,舊埔村,521,458,81.34991119,105,18.65008881,563,33,596,0,867,68.74279123
雲林縣,水林鄉,塭底村,522,390,75.87548638,124,24.12451362,514,48,562,0,847,66.35182999
雲林縣,水林鄉,後寮村,509,372,73.51778656,134,26.48221344,506,41,547,0,804,68.03482587
雲林縣,水林鄉,溪墘村,525,408,70.58823529,170,29.41176471,578,39,617,0,842,73.27790974
嘉義縣,太保市,太保里,1,698,51.81885672,649,48.18114328,1347,31,1378,1,1791,76.94025684
嘉義縣,太保市,後庄里,2,261,68.68421053,119,31.31578947,380,17,397,0,498,79.7188755
嘉義縣,太保市,前潭里,3,794,71.21076233,321,28.78923767,1115,12,1127,1,1402,80.38516405
嘉義縣,太保市,後潭里,4,747,63.6286201,427,36.3713799,1174,31,1205,1,1528,78.86125654
嘉義縣,太保市,梅埔里,5,331,59.63963964,224,40.36036036,555,20,575,0,721,79.75034674
嘉義縣,太保市,梅埔里,6,174,57.61589404,128,42.38410596,302,11,313,0,379,82.58575198
嘉義縣,太保市,春珠里,7,466,68.52941176,214,31.47058824,680,24,704,0,870,80.91954023
嘉義縣,太保市,崙頂里,8,325,51.26182965,309,48.73817035,634,27,661,0,825,80.12121212
嘉義縣,太保市,東勢里,12,457,66.6180758,229,33.3819242,686,24,710,0,911,77.9363337
嘉義縣,太保市,新埤里,13,672,73.28244275,245,26.71755725,917,36,953,0,1206,79.02155887
嘉義縣,太保市,舊埤里,14,461,67.59530792,221,32.40469208,682,34,716,0,899,79.64404894
嘉義縣,太保市,舊埤里,15,434,60.44568245,284,39.55431755,718,5,723,0,937,77.16115261
嘉義縣,太保市,田尾里,16,263,68.84816754,119,31.15183246,382,18,400,0,502,79.6812749
嘉義縣,太保市,田尾里,17,85,51.20481928,81,48.79518072,166,8,174,0,219,79.45205479
嘉義縣,太保市,港尾里,18,179,71.8875502,70,28.1124498,249,9,258,0,307,84.03908795
嘉義縣,太保市,港尾里,19,117,61.57894737,73,38.42105263,190,11,201,0,261,77.01149425
嘉義縣,太保市,過溝里,20,271,58.78524946,190,41.21475054,461,12,473,0,608,77.79605263
嘉義縣,太保市,過溝里,21,815,66.2601626,415,33.7398374,1230,21,1251,0,1529,81.81818182
嘉義縣,太保市,麻寮里,22,686,59.03614458,476,40.96385542,1162,43,1205,0,1524,79.06824147
嘉義縣,太保市,麻寮里,23,688,59.46413137,469,40.53586863,1157,13,1170,0,1440,81.25
嘉義縣,太保市,南新里,24,937,66.88079943,464,33.11920057,1401,53,1454,0,1746,83.27605956
嘉義縣,太保市,北新里,25,633,72.84234753,236,27.15765247,869,10,879,0,1067,82.38050609
嘉義縣,太保市,北新里,26,557,60.08629989,370,39.91370011,927,35,962,0,1201,80.09991674
嘉義縣,太保市,埤鄉里,27,339,61.86131387,209,38.13868613,548,20,568,0,725,78.34482759
嘉義縣,太保市,安仁里,9,95,59.00621118,66,40.99378882,161,13,174,0,215,80.93023256
嘉義縣,太保市,安仁里,10,276,73.40425532,100,26.59574468,376,17,393,0,489,80.36809816
嘉義縣,太保市,安仁里,11,179,45.78005115,212,54.21994885,391,8,399,0,489,81.59509202
嘉義縣,朴子市,安福里,28,392,52.05843293,361,47.94156707,753,19,772,0,995,77.5879397
嘉義縣,朴子市,安福里,29,394,60.06097561,262,39.93902439,656,11,667,0,832,80.16826923
嘉義縣,朴子市,平和里,30,809,55.98615917,636,44.01384083,1445,35,1480,1,1855,79.78436658
嘉義縣,朴子市,內厝里,31,626,73.90791027,221,26.09208973,847,23,870,0,1114,78.09694794
嘉義縣,朴子市,開元里,32,255,64.23173804,142,35.76826196,397,6,403,0,492,81.91056911
嘉義縣,朴子市,順天里,33,346,63.02367942,203,36.97632058,549,13,562,1,725,77.51724138
嘉義縣,朴子市,中正里,34,355,62.72084806,211,37.27915194,566,9,575,0,719,79.97218359
嘉義縣,朴子市,博厚里,35,409,68.28046745,190,31.71953255,599,20,619,0,766,80.80939948
嘉義縣,朴子市,文化里,36,437,63.24167873,254,36.75832127,691,14,705,0,864,81.59722222
嘉義縣,朴子市,文化里,37,458,57.61006289,337,42.38993711,795,21,816,0,989,82.50758342
嘉義縣,朴子市,永和里,38,428,60.70921986,277,39.29078014,705,18,723,0,917,78.84405671
嘉義縣,朴子市,永和里,39,811,68.09403862,380,31.90596138,1191,23,1214,0,1527,79.50229208
嘉義縣,朴子市,竹圍里,40,944,57.59609518,695,42.40390482,1639,37,1676,0,2104,79.65779468
嘉義縣,朴子市,竹圍里,41,783,59.54372624,532,40.45627376,1315,19,1334,0,1679,79.45205479
嘉義縣,朴子市,新寮里,42,327,65.79476861,170,34.20523139,497,29,526,0,681,77.23935389
嘉義縣,朴子市,雙溪里,43,369,71.65048544,146,28.34951456,515,13,528,0,685,77.08029197
嘉義縣,朴子市,溪口里,44,407,65.22435897,217,34.77564103,624,22,646,0,827,78.11366385
嘉義縣,朴子市,德興里,45,666,75.94070696,211,24.05929304,877,14,891,0,1077,82.72980501
嘉義縣,朴子市,仁和里,46,309,64.91596639,167,35.08403361,476,25,501,0,637,78.64992151
嘉義縣,朴子市,大鄉里,47,738,69.62264151,322,30.37735849,1060,37,1097,0,1383,79.32031815
嘉義縣,朴子市,大鄉里,48,554,59.56989247,376,40.43010753,930,41,971,0,1271,76.39653816
嘉義縣,朴子市,大葛里,49,879,64.7275405,479,35.2724595,1358,51,1409,0,1810,77.84530387
嘉義縣,朴子市,佳禾里,50,307,67.17724289,150,32.82275711,457,21,478,1,598,79.93311037
嘉義縣,朴子市,竹村里,51,483,65.89358799,250,34.10641201,733,24,757,0,1000,75.7
嘉義縣,朴子市,崁前里,52,541,77.61836442,156,22.38163558,697,49,746,0,972,76.74897119
嘉義縣,朴子市,順安里,54,136,59.13043478,94,40.86956522,230,3,233,0,291,80.06872852
嘉義縣,朴子市,崁後里,53,437,73.81756757,155,26.18243243,592,31,623,0,841,74.078478
嘉義縣,朴子市,德家里,55,416,72.4738676,158,27.5261324,574,35,609,0,803,75.84059776
嘉義縣,朴子市,新庄里,56,316,66.80761099,157,33.19238901,473,3,476,1,616,77.27272727
嘉義縣,朴子市,梅華里,57,687,81.10979929,160,18.89020071,847,45,892,0,1135,78.59030837
嘉義縣,朴子市,松華里,58,820,80.8678501,194,19.1321499,1014,62,1076,0,1445,74.46366782
嘉義縣,朴子市,南竹里,59,347,82.03309693,76,17.96690307,423,13,436,0,565,77.16814159
嘉義縣,布袋鎮,岱江里,60,301,59.01960784,209,40.98039216,510,31,541,0,728,74.31318681
嘉義縣,布袋鎮,九龍里,61,185,59.29487179,127,40.70512821,312,11,323,0,444,72.74774775
嘉義縣,布袋鎮,岑海里,62,153,54.44839858,128,45.55160142,281,10,291,0,406,71.67487685
嘉義縣,布袋鎮,岑海里,63,547,56.04508197,429,43.95491803,976,21,997,0,1353,73.68810052
嘉義縣,布袋鎮,興中里,64,519,58.1838565,373,41.8161435,892,26,918,0,1213,75.6801319
嘉義縣,布袋鎮,光復里,65,524,62.75449102,311,37.24550898,835,19,854,0,1106,77.21518987
嘉義縣,布袋鎮,光復里,66,297,56.67938931,227,43.32061069,524,25,549,0,713,76.99859748
嘉義縣,布袋鎮,見龍里,67,485,68.2137834,226,31.7862166,711,15,726,0,979,74.15730337
嘉義縣,布袋鎮,新厝里,68,287,52.27686703,262,47.72313297,549,19,568,0,795,71.44654088
嘉義縣,布袋鎮,龍江里,69,356,59.73154362,240,40.26845638,596,27,623,0,837,74.43249701
嘉義縣,布袋鎮,新岑里,86,503,67.06666667,247,32.93333333,750,21,771,0,1048,73.56870229
嘉義縣,布袋鎮,新民里,87,561,61.3785558,353,38.6214442,914,21,935,0,1246,75.04012841
嘉義縣,布袋鎮,復興里,88,512,58.85057471,358,41.14942529,870,18,888,0,1156,76.816609
嘉義縣,布袋鎮,復興里,89,553,56.37104995,428,43.62895005,981,24,1005,0,1288,78.02795031
嘉義縣,布袋鎮,好美里,90,466,60.20671835,308,39.79328165,774,33,807,0,1118,72.18246869
嘉義縣,布袋鎮,永安里,77,453,54.97572816,371,45.02427184,824,30,854,0,1179,72.43426633
嘉義縣,布袋鎮,東港里,78,434,62.89855072,256,37.10144928,690,36,726,0,970,74.84536082
嘉義縣,布袋鎮,東港里,79,407,54.55764075,339,45.44235925,746,19,765,0,991,77.19475277
嘉義縣,布袋鎮,江山里,80,139,55.82329317,110,44.17670683,249,9,258,0,342,75.43859649
嘉義縣,布袋鎮,菜舖里,81,54,43.2,71,56.8,125,11,136,0,202,67.32673267
嘉義縣,布袋鎮,菜舖里,82,69,41.56626506,97,58.43373494,166,14,180,0,244,73.7704918
嘉義縣,布袋鎮,考試里,83,57,57.57575758,42,42.42424242,99,7,106,0,141,75.17730496
嘉義縣,布袋鎮,考試里,84,92,62.58503401,55,37.41496599,147,7,154,0,210,73.33333333
嘉義縣,布袋鎮,振寮里,85,297,50.16891892,295,49.83108108,592,8,600,0,824,72.81553398
嘉義縣,布袋鎮,西安里,70,583,59.36863544,399,40.63136456,982,44,1026,0,1382,74.24023155
嘉義縣,布袋鎮,東安里,72,777,68.39788732,359,31.60211268,1136,54,1190,1,1553,76.62588538
嘉義縣,布袋鎮,中安里,71,770,66.66666667,385,33.33333333,1155,57,1212,2,1622,74.72256473
嘉義縣,布袋鎮,樹林里,73,152,65.2360515,81,34.7639485,233,7,240,0,299,80.26755853
嘉義縣,布袋鎮,樹林里,74,130,67.70833333,62,32.29166667,192,4,196,0,269,72.86245353
嘉義縣,布袋鎮,貴舍里,75,252,68.10810811,118,31.89189189,370,13,383,0,496,77.21774194
嘉義縣,布袋鎮,貴舍里,76,104,54.45026178,87,45.54973822,191,9,200,0,273,73.26007326
嘉義縣,大林鎮,東林里,91,218,55.7544757,173,44.2455243,391,15,406,0,493,82.35294118
嘉義縣,大林鎮,西林里,92,895,56.46687697,690,43.53312303,1585,30,1615,0,1986,81.31923464
嘉義縣,大林鎮,吉林里,93,399,52.08877285,367,47.91122715,766,21,787,0,1013,77.69002962
嘉義縣,大林鎮,平林里,94,794,54.68319559,658,45.31680441,1452,25,1477,0,1855,79.62264151
嘉義縣,大林鎮,平林里,95,516,50.53868756,505,49.46131244,1021,28,1049,0,1348,77.8189911
嘉義縣,大林鎮,平林里,96,768,55.17241379,624,44.82758621,1392,40,1432,0,1810,79.1160221
嘉義縣,大林鎮,明華里,97,542,59.95575221,362,40.04424779,904,6,910,0,1151,79.06168549
嘉義縣,大林鎮,明和里,98,648,59.50413223,441,40.49586777,1089,27,1116,0,1398,79.82832618
嘉義縣,大林鎮,排路里,99,404,76.66034156,123,23.33965844,527,21,548,0,690,79.42028986
嘉義縣,大林鎮,西結里,100,419,74.68805704,142,25.31194296,561,40,601,0,819,73.38217338
嘉義縣,大林鎮,湖北里,101,309,64.10788382,173,35.89211618,482,30,512,0,681,75.1835536
嘉義縣,大林鎮,大糖里,102,89,39.38053097,137,60.61946903,226,6,232,0,314,73.88535032
嘉義縣,大林鎮,大美里,103,716,53.03703704,634,46.96296296,1350,56,1406,0,1770,79.43502825
嘉義縣,大林鎮,過溪里,104,670,60.79854809,432,39.20145191,1102,60,1162,0,1486,78.19650067
嘉義縣,大林鎮,中坑里,105,473,56.44391408,365,43.55608592,838,42,880,0,1109,79.35076646
嘉義縣,大林鎮,中坑里,106,201,67.90540541,95,32.09459459,296,10,306,0,405,75.55555556
嘉義縣,大林鎮,上林里,107,386,61.46496815,242,38.53503185,628,30,658,0,848,77.59433962
嘉義縣,大林鎮,中林里,108,852,74.54068241,291,25.45931759,1143,70,1213,0,1529,79.33289732
嘉義縣,大林鎮,三和里,109,833,55.60747664,665,44.39252336,1498,36,1534,0,1915,80.10443864
嘉義縣,大林鎮,溝背里,110,518,69.06666667,232,30.93333333,750,41,791,0,984,80.38617886
嘉義縣,大林鎮,義和里,111,281,53.21969697,247,46.78030303,528,20,548,1,677,80.94534712
嘉義縣,大林鎮,內林里,112,316,55.92920354,249,44.07079646,565,19,584,0,730,80
嘉義縣,大林鎮,三角里,113,375,56.99088146,283,43.00911854,658,5,663,0,863,76.82502897
嘉義縣,大林鎮,三村里,114,376,62.66666667,224,37.33333333,600,14,614,0,768,79.94791667
嘉義縣,民雄鄉,東榮村,115,504,57.73195876,369,42.26804124,873,31,904,0,1101,82.1071753
嘉義縣,民雄鄉,東榮村,116,427,58.49315068,303,41.50684932,730,22,752,0,970,77.5257732
嘉義縣,民雄鄉,中樂村,117,720,54.96183206,590,45.03816794,1310,28,1338,0,1637,81.73488088
嘉義縣,民雄鄉,西安村,118,747,65.87301587,387,34.12698413,1134,51,1185,0,1496,79.21122995
嘉義縣,民雄鄉,西安村,119,752,61.4379085,472,38.5620915,1224,24,1248,0,1499,83.25550367
嘉義縣,民雄鄉,寮頂村,120,570,71.0723192,232,28.9276808,802,14,816,0,974,83.77823409
嘉義縣,民雄鄉,寮頂村,121,463,56.12121212,362,43.87878788,825,16,841,0,1070,78.59813084
嘉義縣,民雄鄉,福權村,122,786,73.52666043,283,26.47333957,1069,34,1103,0,1357,81.28224024
嘉義縣,民雄鄉,東湖村,123,785,56.96661829,593,43.03338171,1378,57,1435,0,1806,79.45736434
嘉義縣,民雄鄉,頂崙村,124,621,61.00196464,397,38.99803536,1018,36,1054,0,1366,77.15959004
嘉義縣,民雄鄉,菁埔村,125,1034,79.84555985,261,20.15444015,1295,57,1352,0,1684,80.28503563
嘉義縣,民雄鄉,中和村,126,373,64.31034483,207,35.68965517,580,26,606,0,755,80.26490066
嘉義縣,民雄鄉,平和村,127,369,65.19434629,197,34.80565371,566,18,584,0,738,79.13279133
嘉義縣,民雄鄉,西昌村,128,444,72.31270358,170,27.68729642,614,26,640,0,776,82.4742268
嘉義縣,民雄鄉,豊收村,129,683,59.3397046,468,40.6602954,1151,45,1196,0,1494,80.05354752
嘉義縣,民雄鄉,豊收村,130,207,67.86885246,98,32.13114754,305,26,331,0,408,81.12745098
嘉義縣,民雄鄉,三興村,131,453,65.84302326,235,34.15697674,688,27,715,0,864,82.75462963
嘉義縣,民雄鄉,東興村,132,289,71.18226601,117,28.81773399,406,28,434,0,572,75.87412587
嘉義縣,民雄鄉,鎮北村,133,430,58.90410959,300,41.09589041,730,23,753,0,926,81.3174946
嘉義縣,民雄鄉,興中村,146,799,58.66372981,563,41.33627019,1362,39,1401,0,1744,80.33256881
嘉義縣,民雄鄉,興南村,147,546,58.96328294,380,41.03671706,926,26,952,0,1171,81.29803587
嘉義縣,民雄鄉,興南村,148,473,60.17811705,313,39.82188295,786,21,807,0,1060,76.13207547
嘉義縣,民雄鄉,福興村,151,855,61.42241379,537,38.57758621,1392,41,1433,0,1758,81.51308305
嘉義縣,民雄鄉,文隆村,152,918,57.73584906,672,42.26415094,1590,50,1640,1,2006,81.75473579
嘉義縣,民雄鄉,山中村,153,910,70.65217391,378,29.34782609,1288,52,1340,0,1614,83.02354399
嘉義縣,民雄鄉,山中村,154,853,59.19500347,588,40.80499653,1441,45,1486,0,1878,79.12673056
嘉義縣,民雄鄉,中央村,155,720,73.9979445,253,26.0020555,973,28,1001,0,1243,80.53097345
嘉義縣,民雄鄉,北斗村,134,941,61.223162,596,38.776838,1537,39,1576,0,1993,79.07676869
嘉義縣,民雄鄉,北斗村,135,364,62.97577855,214,37.02422145,578,5,583,0,729,79.97256516
嘉義縣,民雄鄉,北斗村,136,418,64.11042945,234,35.88957055,652,20,672,0,843,79.71530249
嘉義縣,民雄鄉,雙福村,137,705,53.0873494,623,46.9126506,1328,40,1368,0,1680,81.42857143
嘉義縣,民雄鄉,大崎村,141,517,66.70967742,258,33.29032258,775,28,803,0,1022,78.57142857
嘉義縣,民雄鄉,大崎村,142,459,51.98187995,424,48.01812005,883,24,907,0,1126,80.55062167
嘉義縣,民雄鄉,秀林村,143,707,66.32270169,359,33.67729831,1066,39,1105,0,1377,80.24691358
嘉義縣,民雄鄉,秀林村,144,382,59.78090767,257,40.21909233,639,13,652,0,838,77.80429594
嘉義縣,民雄鄉,松山村,145,742,61.73044925,460,38.26955075,1202,56,1258,0,1640,76.70731707
嘉義縣,民雄鄉,金興村,149,529,55.45073375,425,44.54926625,954,27,981,0,1225,80.08163265
嘉義縣,民雄鄉,金興村,150,569,54.60652591,473,45.39347409,1042,22,1064,0,1377,77.26942629
嘉義縣,民雄鄉,福樂村,138,609,51.61016949,571,48.38983051,1180,12,1192,0,1445,82.49134948
嘉義縣,民雄鄉,福樂村,139,515,50.53974485,504,49.46025515,1019,20,1039,0,1292,80.41795666
嘉義縣,民雄鄉,福樂村,140,771,63.30049261,447,36.69950739,1218,35,1253,1,1581,79.25363694
嘉義縣,溪口鄉,溪東村,156,741,67.42493176,358,32.57506824,1099,42,1141,0,1420,80.35211268
嘉義縣,溪口鄉,溪西村,157,381,69.27272727,169,30.72727273,550,24,574,0,735,78.0952381
嘉義縣,溪口鄉,溪北村,158,203,69.28327645,90,30.71672355,293,6,299,0,400,74.75
嘉義縣,溪口鄉,溪北村,159,158,67.8111588,75,32.1888412,233,2,235,0,299,78.59531773
嘉義縣,溪口鄉,游東村,166,648,77.69784173,186,22.30215827,834,40,874,2,1101,79.38237965
嘉義縣,溪口鄉,游西村,167,446,79.92831541,112,20.07168459,558,34,592,0,783,75.60664112
嘉義縣,溪口鄉,柴林村,160,464,75.20259319,153,24.79740681,617,5,622,0,821,75.76126675
嘉義縣,溪口鄉,林腳村,161,503,79.33753943,131,20.66246057,634,38,672,0,880,76.36363636
嘉義縣,溪口鄉,美南村,162,706,75.50802139,229,24.49197861,935,45,980,0,1235,79.35222672
嘉義縣,溪口鄉,美北村,163,481,69.81132075,208,30.18867925,689,38,727,0,946,76.84989429
嘉義縣,溪口鄉,本厝村,164,327,75.69444444,105,24.30555556,432,24,456,0,598,76.2541806
嘉義縣,溪口鄉,本厝村,165,221,73.17880795,81,26.82119205,302,16,318,0,399,79.69924812
嘉義縣,溪口鄉,柳溝村,168,474,71.06446777,193,28.93553223,667,34,701,0,895,78.32402235
嘉義縣,溪口鄉,柳溝村,169,208,72.4738676,79,27.5261324,287,11,298,0,378,78.83597884
嘉義縣,溪口鄉,疊溪村,170,595,74.375,205,25.625,800,17,817,0,1015,80.49261084
嘉義縣,溪口鄉,妙崙村,171,373,71.59309021,148,28.40690979,521,34,555,0,743,74.69717362
嘉義縣,溪口鄉,坪頂村,172,529,74.19354839,184,25.80645161,713,8,721,0,888,81.19369369
嘉義縣,新港鄉,宮前村,173,438,64.41176471,242,35.58823529,680,12,692,0,840,82.38095238
嘉義縣,新港鄉,宮前村,174,467,62.0185923,286,37.9814077,753,20,773,0,917,84.29661941
嘉義縣,新港鄉,宮後村,175,418,67.09470305,205,32.90529695,623,14,637,0,823,77.39975699
嘉義縣,新港鄉,宮後村,176,436,67.38794436,211,32.61205564,647,25,672,0,859,78.23050058
嘉義縣,新港鄉,大興村,177,788,69.92014197,339,30.07985803,1127,18,1145,0,1440,79.51388889
嘉義縣,新港鄉,福德村,178,739,63.05460751,433,36.94539249,1172,40,1212,0,1529,79.26749509
嘉義縣,新港鄉,古民村,179,688,77.21661055,203,22.78338945,891,32,923,0,1188,77.69360269
嘉義縣,新港鄉,中庄村,180,466,78.84940778,125,21.15059222,591,24,615,0,789,77.94676806
嘉義縣,新港鄉,中庄村,181,415,75.59198543,134,24.40801457,549,22,571,0,738,77.37127371
嘉義縣,新港鄉,大潭村,182,430,77.75768535,123,22.24231465,553,5,558,0,728,76.64835165
嘉義縣,新港鄉,大潭村,183,540,75.84269663,172,24.15730337,712,11,723,0,900,80.33333333
嘉義縣,新港鄉,西庄村,184,442,62.87339972,261,37.12660028,703,34,737,0,974,75.66735113
嘉義縣,新港鄉,埤子村,197,358,78.50877193,98,21.49122807,456,25,481,0,602,79.90033223
嘉義縣,新港鄉,南崙村,198,628,86.74033149,96,13.25966851,724,30,754,0,938,80.38379531
嘉義縣,新港鄉,北崙村,199,328,79.8053528,83,20.1946472,411,25,436,0,601,72.54575707
嘉義縣,新港鄉,海瀛村,200,271,70.94240838,111,29.05759162,382,22,404,0,507,79.68441815
嘉義縣,新港鄉,月眉村,185,469,71.49390244,187,28.50609756,656,17,673,0,887,75.87373168
嘉義縣,新港鄉,月眉村,186,471,71.36363636,189,28.63636364,660,20,680,0,832,81.73076923
嘉義縣,新港鄉,月潭村,187,779,70.94717668,319,29.05282332,1098,40,1138,0,1437,79.1927627
嘉義縣,新港鄉,溪北村,188,796,72.2323049,306,27.7676951,1102,57,1159,0,1437,80.65414057
嘉義縣,新港鄉,三間村,191,550,69.18238994,245,30.81761006,795,20,815,0,975,83.58974359
嘉義縣,新港鄉,中洋村,190,507,66.79841897,252,33.20158103,759,30,789,0,998,79.05811623
嘉義縣,新港鄉,菜公村,189,488,67.31034483,237,32.68965517,725,30,755,0,950,79.47368421
嘉義縣,新港鄉,安和村,192,555,69.46182728,244,30.53817272,799,50,849,0,1131,75.066313
嘉義縣,新港鄉,潭大村,193,639,73.87283237,226,26.12716763,865,43,908,0,1162,78.14113597
嘉義縣,新港鄉,南港村,194,597,72.53948967,226,27.46051033,823,50,873,0,1119,78.01608579
嘉義縣,新港鄉,板頭村,195,366,75.15400411,121,24.84599589,487,8,495,0,606,81.68316832
嘉義縣,新港鄉,共和村,196,467,72.17928903,180,27.82071097,647,31,678,0,857,79.11318553
嘉義縣,六腳鄉,蒜頭村,201,567,59.49632739,386,40.50367261,953,29,982,0,1284,76.47975078
嘉義縣,六腳鄉,蒜東村,202,439,67.43471582,212,32.56528418,651,31,682,0,945,72.16931217
嘉義縣,六腳鄉,蒜南村,203,446,67.1686747,218,32.8313253,664,28,692,0,900,76.88888889
嘉義縣,六腳鄉,工廠村,204,82,34.59915612,155,65.40084388,237,8,245,0,305,80.32786885
嘉義縣,六腳鄉,灣南村,205,605,68.59410431,277,31.40589569,882,43,925,1,1239,74.65698144
嘉義縣,六腳鄉,灣北村,206,548,61.22905028,347,38.77094972,895,44,939,0,1306,71.89892802
嘉義縣,六腳鄉,雙涵村,207,481,73.4351145,174,26.5648855,655,29,684,0,914,74.83588621
嘉義縣,六腳鄉,塗師村,208,429,80.63909774,103,19.36090226,532,21,553,0,740,74.72972973
嘉義縣,六腳鄉,三義村,209,308,72.64150943,116,27.35849057,424,19,443,0,591,74.95769882
嘉義縣,六腳鄉,三義村,210,97,70.80291971,40,29.19708029,137,6,143,0,196,72.95918367
嘉義縣,六腳鄉,港美村,216,478,82.84228769,99,17.15771231,577,23,600,0,777,77.22007722
嘉義縣,六腳鄉,豐美村,217,566,73.03225806,209,26.96774194,775,40,815,0,1096,74.36131387
嘉義縣,六腳鄉,六斗村,218,472,71.62367223,187,28.37632777,659,29,688,0,921,74.70141151
嘉義縣,六腳鄉,崙陽村,219,569,73.51421189,205,26.48578811,774,25,799,1,1014,78.79684418
嘉義縣,六腳鄉,蘇厝村,220,769,71.53488372,306,28.46511628,1075,41,1116,0,1460,76.43835616
嘉義縣,六腳鄉,竹本村,221,385,75.04873294,128,24.95126706,513,29,542,0,735,73.7414966
嘉義縣,六腳鄉,永賢村,222,298,77.20207254,88,22.79792746,386,27,413,0,558,74.01433692
嘉義縣,六腳鄉,魚寮村,223,403,77.20306513,119,22.79693487,522,34,556,0,766,72.5848564
嘉義縣,六腳鄉,潭墘村,224,409,62.34756098,247,37.65243902,656,41,697,0,980,71.12244898
嘉義縣,六腳鄉,正義村,211,157,83.5106383,31,16.4893617,188,6,194,0,252,76.98412698
嘉義縣,六腳鄉,正義村,212,182,85.04672897,32,14.95327103,214,11,225,0,289,77.85467128
嘉義縣,六腳鄉,正義村,213,221,76.73611111,67,23.26388889,288,13,301,0,381,79.00262467
嘉義縣,六腳鄉,正義村,214,303,76.13065327,95,23.86934673,398,6,404,0,506,79.84189723
嘉義縣,六腳鄉,溪厝村,215,299,67.49435666,144,32.50564334,443,13,456,0,628,72.61146497
嘉義縣,六腳鄉,六腳村,225,395,63.09904153,231,36.90095847,626,33,659,0,893,73.79619261
嘉義縣,六腳鄉,六南村,226,305,74.93857494,102,25.06142506,407,36,443,0,629,70.42925278
嘉義縣,六腳鄉,崩山村,227,438,77.24867725,129,22.75132275,567,51,618,0,796,77.63819095
嘉義縣,六腳鄉,古林村,228,481,78.9819376,128,21.0180624,609,32,641,0,842,76.12826603
嘉義縣,六腳鄉,更寮村,229,234,75.72815534,75,24.27184466,309,18,327,0,434,75.34562212
嘉義縣,六腳鄉,更寮村,230,66,55.46218487,53,44.53781513,119,3,122,0,190,64.21052632
嘉義縣,東石鄉,東石村,231,835,64.62848297,457,35.37151703,1292,45,1337,0,1827,73.18007663
嘉義縣,東石鄉,猿樹村,232,404,57.38636364,300,42.61363636,704,30,734,0,1003,73.18045862
嘉義縣,東石鄉,型厝村,234,636,61.92794547,391,38.07205453,1027,40,1067,0,1481,72.04591492
嘉義縣,東石鄉,塭港村,233,652,55.25423729,528,44.74576271,1180,59,1239,0,1636,75.73349633
嘉義縣,東石鄉,三家村,235,499,57.48847926,369,42.51152074,868,45,913,0,1261,72.40285488
嘉義縣,東石鄉,永屯村,236,304,57.57575758,224,42.42424242,528,18,546,0,728,75
嘉義縣,東石鄉,海埔村,237,216,67.9245283,102,32.0754717,318,19,337,0,456,73.90350877
嘉義縣,東石鄉,龍港村,238,362,52.23665224,331,47.76334776,693,37,730,0,988,73.88663968
嘉義縣,東石鄉,副瀨村,239,563,71.17572693,228,28.82427307,791,55,846,0,1157,73.12013829
嘉義縣,東石鄉,下揖村,240,446,71.1323764,181,28.8676236,627,35,662,0,878,75.39863326
嘉義縣,東石鄉,頂揖村,241,96,76.19047619,30,23.80952381,126,8,134,0,192,69.79166667
嘉義縣,東石鄉,頂揖村,242,116,73.41772152,42,26.58227848,158,6,164,0,243,67.48971193
嘉義縣,東石鄉,溪下村,243,403,56.20641562,314,43.79358438,717,47,764,0,1104,69.20289855
嘉義縣,東石鄉,港墘村,247,650,64.1025641,364,35.8974359,1014,46,1060,0,1325,80
嘉義縣,東石鄉,蔦松村,248,442,64.52554745,243,35.47445255,685,37,722,0,917,78.73500545
嘉義縣,東石鄉,圍潭村,249,365,66.84981685,181,33.15018315,546,19,565,0,788,71.70050761
嘉義縣,東石鄉,洲仔村,250,412,61.67664671,256,38.32335329,668,43,711,1,961,73.98543184
嘉義縣,東石鄉,東崙村,251,175,65.29850746,93,34.70149254,268,19,287,0,407,70.51597052
嘉義縣,東石鄉,東崙村,252,175,60.76388889,113,39.23611111,288,9,297,0,413,71.91283293
嘉義縣,東石鄉,西崙村,253,503,63.11166876,294,36.88833124,797,39,836,0,1139,73.3977173
嘉義縣,東石鄉,塭仔村,254,469,64.07103825,263,35.92896175,732,38,770,0,1008,76.38888889
嘉義縣,東石鄉,網寮村,255,546,60.13215859,362,39.86784141,908,32,940,0,1316,71.42857143
嘉義縣,東石鄉,掌潭村,256,227,70.0617284,97,29.9382716,324,14,338,0,446,75.78475336
嘉義縣,東石鄉,掌潭村,257,103,37.72893773,170,62.27106227,273,3,276,0,370,74.59459459
嘉義縣,東石鄉,港口村,244,132,51.3618677,125,48.6381323,257,10,267,0,388,68.81443299
嘉義縣,東石鄉,鰲鼓村,245,515,64.61731493,282,35.38268507,797,8,805,1,1085,74.19354839
嘉義縣,東石鄉,鰲鼓村,246,137,66.18357488,70,33.81642512,207,13,220,0,291,75.60137457
嘉義縣,義竹鄉,岸腳村,258,259,63.01703163,152,36.98296837,411,27,438,0,580,75.51724138
嘉義縣,義竹鄉,岸腳村,259,119,68.3908046,55,31.6091954,174,10,184,0,224,82.14285714
嘉義縣,義竹鄉,義竹村,260,772,64.71081308,421,35.28918692,1193,42,1235,0,1543,80.03888529
嘉義縣,義竹鄉,六桂村,261,571,59.41727367,390,40.58272633,961,47,1008,0,1317,76.53758542
嘉義縣,義竹鄉,仁里村,262,406,58,294,42,700,33,733,0,903,81.17386489
嘉義縣,義竹鄉,傳芳村,263,330,61.91369606,203,38.08630394,533,23,556,0,739,75.2368065
嘉義縣,義竹鄉,頭竹村,264,640,65.17311609,342,34.82688391,982,52,1034,0,1308,79.05198777
嘉義縣,義竹鄉,五厝村,265,213,67.19242902,104,32.80757098,317,9,326,0,437,74.59954233
嘉義縣,義竹鄉,中平村,266,163,60.59479554,106,39.40520446,269,18,287,0,351,81.76638177
嘉義縣,義竹鄉,中平村,267,35,37.23404255,59,62.76595745,94,3,97,1,131,74.04580153
嘉義縣,義竹鄉,埤前村,268,313,53.32197615,274,46.67802385,587,40,627,0,802,78.17955112
嘉義縣,義竹鄉,平溪村,269,226,67.86786787,107,32.13213213,333,13,346,0,449,77.06013363
嘉義縣,義竹鄉,後鎮村,270,219,61.34453782,138,38.65546218,357,20,377,0,491,76.78207739
嘉義縣,義竹鄉,北華村,271,308,71.13163972,125,28.86836028,433,16,449,0,598,75.08361204
嘉義縣,義竹鄉,新店村,272,748,65.9030837,387,34.0969163,1135,54,1189,0,1547,76.85843568
嘉義縣,義竹鄉,東過村,273,371,58.24175824,266,41.75824176,637,18,655,0,867,75.54786621
嘉義縣,義竹鄉,西過村,274,424,70.66666667,176,29.33333333,600,29,629,0,890,70.6741573
嘉義縣,義竹鄉,官和村,275,487,76.3322884,151,23.6677116,638,25,663,0,874,75.85812357
嘉義縣,義竹鄉,官順村,276,253,67.10875332,124,32.89124668,377,12,389,0,536,72.57462687
嘉義縣,義竹鄉,新富村,277,243,57.99522673,176,42.00477327,419,21,440,0,577,76.25649913
嘉義縣,義竹鄉,東光村,278,353,66.22889306,180,33.77110694,533,29,562,0,689,81.56748911
嘉義縣,義竹鄉,東光村,279,88,80,22,20,110,9,119,0,166,71.68674699
嘉義縣,義竹鄉,東榮村,280,244,72.18934911,94,27.81065089,338,19,357,0,480,74.375
嘉義縣,義竹鄉,龍蛟村,281,300,64.1025641,168,35.8974359,468,27,495,0,680,72.79411765
嘉義縣,義竹鄉,溪洲村,282,440,78.57142857,120,21.42857143,560,31,591,0,748,79.01069519
嘉義縣,鹿草鄉,後寮村,283,259,71.74515235,102,28.25484765,361,23,384,0,511,75.14677104
嘉義縣,鹿草鄉,鹿東村,284,375,74.5526839,128,25.4473161,503,23,526,0,659,79.81790592
嘉義縣,鹿草鄉,鹿草村,285,631,63.28986961,366,36.71013039,997,49,1046,0,1346,77.71173848
嘉義縣,鹿草鄉,西井村,286,518,60.72684642,335,39.27315358,853,44,897,0,1151,77.93223284
嘉義縣,鹿草鄉,豊稠村,287,137,61.71171171,85,38.28828829,222,10,232,0,301,77.07641196
嘉義縣,鹿草鄉,豊稠村,288,50,47.61904762,55,52.38095238,105,2,107,0,144,74.30555556
嘉義縣,鹿草鄉,重寮村,289,614,73.88688327,217,26.11311673,831,45,876,0,1154,75.90987868
嘉義縣,鹿草鄉,施家村,290,258,68.43501326,119,31.56498674,377,18,395,0,508,77.75590551
嘉義縣,鹿草鄉,下潭村,291,511,77.77777778,146,22.22222222,657,44,701,1,901,77.80244173
嘉義縣,鹿草鄉,光潭村,292,619,74.84885127,208,25.15114873,827,40,867,0,1141,75.98597721
嘉義縣,鹿草鄉,碧潭村,293,457,60.05256242,304,39.94743758,761,60,821,0,1098,74.7723133
嘉義縣,鹿草鄉,松竹村,294,359,56.53543307,276,43.46456693,635,38,673,0,930,72.3655914
嘉義縣,鹿草鄉,竹山村,295,349,70.50505051,146,29.49494949,495,31,526,0,712,73.87640449
嘉義縣,鹿草鄉,竹山村,296,134,79.76190476,34,20.23809524,168,8,176,0,231,76.19047619
嘉義縣,鹿草鄉,後堀村,297,494,66.75675676,246,33.24324324,740,28,768,0,970,79.17525773
嘉義縣,鹿草鄉,後堀村,298,159,62.109375,97,37.890625,256,6,262,0,329,79.63525836
嘉義縣,鹿草鄉,三角村,299,633,74.9112426,212,25.0887574,845,48,893,1,1146,77.92321117
嘉義縣,鹿草鄉,三角村,300,168,56.56565657,129,43.43434343,297,18,315,0,392,80.35714286
嘉義縣,鹿草鄉,下麻村,301,146,62.12765957,89,37.87234043,235,10,245,0,286,85.66433566
嘉義縣,鹿草鄉,下麻村,302,114,58.46153846,81,41.53846154,195,16,211,0,283,74.55830389
嘉義縣,水上鄉,水上村,303,243,52.14592275,223,47.85407725,466,14,480,0,612,78.43137255
嘉義縣,水上鄉,水上村,304,434,66.15853659,222,33.84146341,656,11,667,0,815,81.8404908
嘉義縣,水上鄉,水上村,305,766,56.53136531,589,43.46863469,1355,40,1395,0,1726,80.82271147
嘉義縣,水上鄉,水頭村,306,685,53.39049104,598,46.60950896,1283,37,1320,0,1607,82.14063472
嘉義縣,水上鄉,水頭村,307,252,60.57692308,164,39.42307692,416,11,427,0,517,82.59187621
嘉義縣,水上鄉,大堀村,315,292,65.61797753,153,34.38202247,445,3,448,0,537,83.4264432
嘉義縣,水上鄉,大堀村,316,348,72.19917012,134,27.80082988,482,9,491,0,582,84.36426117
嘉義縣,水上鄉,大堀村,317,219,77.93594306,62,22.06405694,281,12,293,0,360,81.38888889
嘉義縣,水上鄉,大崙村,318,964,65.6228727,505,34.3771273,1469,58,1527,0,1945,78.50899743
嘉義縣,水上鄉,塗溝村,319,429,66,221,34,650,23,673,0,843,79.83392645
嘉義縣,水上鄉,粗溪村,308,528,60.96997691,338,39.03002309,866,28,894,0,1145,78.07860262
嘉義縣,水上鄉,粗溪村,309,166,60.36363636,109,39.63636364,275,16,291,0,352,82.67045455
嘉義縣,水上鄉,下寮村,310,236,63.95663957,133,36.04336043,369,14,383,0,488,78.48360656
嘉義縣,水上鄉,下寮村,311,517,56.81318681,393,43.18681319,910,27,937,0,1151,81.40747176
嘉義縣,水上鄉,三和村,312,354,39.37708565,545,60.62291435,899,26,925,0,1163,79.53568358
嘉義縣,水上鄉,三和村,313,329,59.92714026,220,40.07285974,549,15,564,0,673,83.8038633
嘉義縣,水上鄉,回歸村,314,157,31.33732535,344,68.66267465,501,18,519,0,654,79.35779817
嘉義縣,水上鄉,三鎮村,322,247,47.77562863,270,52.22437137,517,23,540,0,678,79.6460177
嘉義縣,水上鄉,靖和村,323,178,41.98113208,246,58.01886792,424,21,445,1,527,84.4402277
嘉義縣,水上鄉,南和村,324,364,58.14696486,262,41.85303514,626,23,649,0,805,80.62111801
嘉義縣,水上鄉,南和村,325,220,59.29919137,151,40.70080863,371,19,390,0,489,79.75460123
嘉義縣,水上鄉,龍德村,320,1011,69.3891558,446,30.6108442,1457,66,1523,0,1844,82.59219089
嘉義縣,水上鄉,溪洲村,321,570,66.43356643,288,33.56643357,858,24,882,0,1109,79.53110911
嘉義縣,水上鄉,柳林村,328,832,61.76688938,515,38.23311062,1347,46,1393,1,1782,78.17059484
嘉義縣,水上鄉,柳鄉村,329,997,67.82312925,473,32.17687075,1470,44,1514,0,1862,81.3104189
嘉義縣,水上鄉,柳新村,326,335,30.79044118,753,69.20955882,1088,30,1118,0,1401,79.80014276
嘉義縣,水上鄉,柳新村,327,251,40.35369775,371,59.64630225,622,24,646,0,841,76.81331748
嘉義縣,水上鄉,寬士村,331,893,63.69472183,509,36.30527817,1402,35,1437,0,1838,78.1828074
嘉義縣,水上鄉,寬士村,332,813,57.65957447,597,42.34042553,1410,38,1448,0,1871,77.39176911
嘉義縣,水上鄉,民生村,333,575,55.66311713,458,44.33688287,1033,21,1054,0,1340,78.65671642
嘉義縣,水上鄉,民生村,334,730,58.82352941,511,41.17647059,1241,22,1263,0,1602,78.83895131
嘉義縣,水上鄉,忠和村,337,707,50,707,50,1414,58,1472,0,1872,78.63247863
嘉義縣,水上鄉,中庄村,336,700,50.21520803,694,49.78479197,1394,52,1446,0,1856,77.90948276
嘉義縣,水上鄉,南鄉村,338,404,63.72239748,230,36.27760252,634,26,660,0,817,80.78335373
嘉義縣,水上鄉,三界村,339,518,67.7124183,247,32.2875817,765,39,804,0,1033,77.83155857
嘉義縣,水上鄉,國姓村,340,686,70.72164948,284,29.27835052,970,43,1013,0,1305,77.62452107
嘉義縣,水上鄉,內溪村,330,462,62.18034993,281,37.81965007,743,41,784,0,993,78.95266868
嘉義縣,水上鄉,義興村,335,375,59.52380952,255,40.47619048,630,5,635,0,761,83.44283837
嘉義縣,中埔鄉,中埔村,341,766,60.60126582,498,39.39873418,1264,46,1310,0,1637,80.02443494
嘉義縣,中埔鄉,鹽館村,342,401,61.88271605,247,38.11728395,648,29,677,0,861,78.62950058
嘉義縣,中埔鄉,龍門村,343,269,47.61061947,296,52.38938053,565,18,583,0,749,77.83711615
嘉義縣,中埔鄉,裕民村,344,536,78.70778267,145,21.29221733,681,28,709,0,890,79.66292135
嘉義縣,中埔鄉,金蘭村,345,697,64.95806151,376,35.04193849,1073,35,1108,0,1381,80.23171615
嘉義縣,中埔鄉,富收村,346,525,63.79100851,298,36.20899149,823,37,860,0,1070,80.37383178
嘉義縣,中埔鄉,富收村,347,778,64.51077944,428,35.48922056,1206,37,1243,0,1577,78.82054534
嘉義縣,中埔鄉,和睦村,348,716,63.4751773,412,36.5248227,1128,37,1165,0,1534,75.9452412
嘉義縣,中埔鄉,和睦村,349,542,59.23497268,373,40.76502732,915,22,937,0,1180,79.40677966
嘉義縣,中埔鄉,和美村,350,799,55.17955801,649,44.82044199,1448,33,1481,0,1840,80.48913043
嘉義縣,中埔鄉,和美村,351,778,56.21387283,606,43.78612717,1384,40,1424,0,1793,79.41996654
嘉義縣,中埔鄉,和美村,352,819,54.31034483,689,45.68965517,1508,29,1537,0,2003,76.73489765
嘉義縣,中埔鄉,和興村,353,1008,60.03573556,671,39.96426444,1679,53,1732,0,2290,75.63318777
嘉義縣,中埔鄉,和興村,354,670,56.16093881,523,43.83906119,1193,37,1230,0,1577,77.99619531
嘉義縣,中埔鄉,和興村,355,550,62.85714286,325,37.14285714,875,31,906,0,1153,78.57762359
嘉義縣,中埔鄉,隆興村,356,789,60.2750191,520,39.7249809,1309,46,1355,0,1701,79.6590241
嘉義縣,中埔鄉,義仁村,357,708,67.36441484,343,32.63558516,1051,37,1088,0,1360,80
嘉義縣,中埔鄉,社口村,358,705,59.39342881,482,40.60657119,1187,36,1223,0,1610,75.96273292
嘉義縣,中埔鄉,社口村,359,222,63.42857143,128,36.57142857,350,19,369,0,478,77.19665272
嘉義縣,中埔鄉,灣潭村,360,460,56.51105651,354,43.48894349,814,31,845,2,1093,77.31015554
嘉義縣,中埔鄉,石弄村,361,394,57.51824818,291,42.48175182,685,23,708,0,899,78.7541713
嘉義縣,中埔鄉,石弄村,362,128,55.89519651,101,44.10480349,229,12,241,0,303,79.5379538
嘉義縣,中埔鄉,頂埔村,363,491,66.98499318,242,33.01500682,733,23,756,0,945,80
嘉義縣,中埔鄉,同仁村,364,648,67.71159875,309,32.28840125,957,41,998,0,1295,77.06563707
嘉義縣,中埔鄉,同仁村,365,351,74.52229299,120,25.47770701,471,24,495,0,677,73.11669129
嘉義縣,中埔鄉,瑞豐村,368,320,57.2450805,239,42.7549195,559,24,583,0,732,79.64480874
嘉義縣,中埔鄉,沄水村,369,306,73.91304348,108,26.08695652,414,16,430,0,549,78.32422587
嘉義縣,中埔鄉,沄水村,370,243,59.55882353,165,40.44117647,408,19,427,0,566,75.44169611
嘉義縣,中埔鄉,三層村,367,315,66.17647059,161,33.82352941,476,13,489,0,632,77.37341772
嘉義縣,中埔鄉,深坑村,366,376,64.38356164,208,35.61643836,584,22,606,0,737,82.22523745
嘉義縣,中埔鄉,東興村,371,140,52.63157895,126,47.36842105,266,4,270,0,335,80.59701493
嘉義縣,中埔鄉,中崙村,372,136,53.54330709,118,46.45669291,254,15,269,0,329,81.76291793
嘉義縣,竹崎鄉,竹崎村,373,607,65.40948276,321,34.59051724,928,25,953,0,1226,77.7324633
嘉義縣,竹崎鄉,竹崎村,374,490,57.37704918,364,42.62295082,854,28,882,0,1089,80.99173554
嘉義縣,竹崎鄉,和平村,375,946,64.3537415,524,35.6462585,1470,45,1515,0,1910,79.31937173
嘉義縣,竹崎鄉,坑頭村,376,374,65.49912434,197,34.50087566,571,29,600,0,775,77.41935484
嘉義縣,竹崎鄉,沙坑村,377,514,75.03649635,171,24.96350365,685,33,718,0,884,81.22171946
嘉義縣,竹崎鄉,獅埜村,378,691,66.6988417,345,33.3011583,1036,47,1083,0,1313,82.48286367
嘉義縣,竹崎鄉,義和村,379,283,62.88888889,167,37.11111111,450,21,471,0,558,84.40860215
嘉義縣,竹崎鄉,義仁村,380,523,66.20253165,267,33.79746835,790,28,818,0,1056,77.46212121
嘉義縣,竹崎鄉,灣橋村,381,603,65.25974026,321,34.74025974,924,26,950,0,1217,78.06080526
嘉義縣,竹崎鄉,灣橋村,382,764,55.32223027,617,44.67776973,1381,37,1418,2,1818,77.99779978
嘉義縣,竹崎鄉,灣橋村,383,752,55.41635962,605,44.58364038,1357,39,1396,0,1754,79.58950969
嘉義縣,竹崎鄉,灣橋村,396,746,66.48841355,376,33.51158645,1122,39,1161,1,1481,78.39297772
嘉義縣,竹崎鄉,鹿滿村,384,636,64.83180428,345,35.16819572,981,30,1011,0,1281,78.92271663
嘉義縣,竹崎鄉,紫雲村,385,579,57.32673267,431,42.67326733,1010,35,1045,0,1334,78.33583208
嘉義縣,竹崎鄉,內埔村,386,792,63.92251816,447,36.07748184,1239,40,1279,0,1601,79.88757027
嘉義縣,竹崎鄉,昇平村,387,263,54.45134576,220,45.54865424,483,31,514,0,694,74.06340058
嘉義縣,竹崎鄉,昇平村,388,521,65.94936709,269,34.05063291,790,23,813,0,1060,76.69811321
嘉義縣,竹崎鄉,白杞村,391,300,54.94505495,246,45.05494505,546,26,572,0,779,73.42747112
嘉義縣,竹崎鄉,桃源村,389,341,61.77536232,211,38.22463768,552,17,569,0,711,80.0281294
嘉義縣,竹崎鄉,桃源村,390,168,65.88235294,87,34.11764706,255,13,268,0,353,75.92067989
嘉義縣,竹崎鄉,塘興村,392,227,55.77395577,180,44.22604423,407,11,418,0,523,79.92351816
嘉義縣,竹崎鄉,塘興村,393,144,48.16053512,155,51.83946488,299,14,313,0,407,76.9041769
嘉義縣,竹崎鄉,義隆村,394,238,55.22041763,193,44.77958237,431,14,445,0,562,79.18149466
嘉義縣,竹崎鄉,龍山村,395,129,69.72972973,56,30.27027027,185,2,187,0,240,77.91666667
嘉義縣,竹崎鄉,文峰村,397,400,70.92198582,164,29.07801418,564,40,604,0,762,79.26509186
嘉義縣,竹崎鄉,金獅村,398,210,59.49008499,143,40.50991501,353,23,376,0,478,78.66108787
嘉義縣,竹崎鄉,復金村,399,509,72.71428571,191,27.28571429,700,36,736,0,954,77.14884696
嘉義縣,竹崎鄉,復金村,400,428,60.11235955,284,39.88764045,712,33,745,0,939,79.33972311
嘉義縣,竹崎鄉,緞繻村,401,388,60.0619195,258,39.9380805,646,29,675,0,896,75.33482143
嘉義縣,竹崎鄉,緞繻村,402,44,50.57471264,43,49.42528736,87,1,88,0,129,68.21705426
嘉義縣,竹崎鄉,仁壽村,403,137,70.6185567,57,29.3814433,194,10,204,0,298,68.45637584
嘉義縣,竹崎鄉,中和村,404,147,51.3986014,139,48.6013986,286,9,295,0,431,68.44547564
嘉義縣,竹崎鄉,中和村,405,202,64.95176849,109,35.04823151,311,10,321,0,394,81.47208122
嘉義縣,竹崎鄉,光華村,406,219,62.39316239,132,37.60683761,351,2,353,1,462,76.40692641
嘉義縣,竹崎鄉,光華村,407,108,49.5412844,110,50.4587156,218,2,220,0,301,73.089701
嘉義縣,梅山鄉,梅東村,408,497,57.39,369,42.61,866,32,898,0,1127,79.68
嘉義縣,梅山鄉,梅東村,409,619,67.87,293,32.13,912,37,949,0,1217,77.98
嘉義縣,梅山鄉,梅南村,410,443,56.22,345,43.78,788,21,809,0,1028,78.7
嘉義縣,梅山鄉,過山村,414,271,57.66,199,42.34,470,2,472,0,583,80.96
嘉義縣,梅山鄉,梅北村,411,583,63.93,329,36.07,912,26,938,0,1171,80.1
嘉義縣,梅山鄉,梅北村,412,619,64.48,341,35.52,960,33,993,0,1245,79.76
嘉義縣,梅山鄉,梅北村,413,740,65.2,395,34.8,1135,41,1176,0,1459,80.6
嘉義縣,梅山鄉,圳南村,415,261,67.79,124,32.21,385,17,402,0,512,78.52
嘉義縣,梅山鄉,永興村,420,248,64.42,137,35.58,385,25,410,0,521,78.69
嘉義縣,梅山鄉,半天村,421,233,67.93,110,32.07,343,12,355,0,452,78.54
嘉義縣,梅山鄉,圳北村,416,280,54.05,238,45.95,518,18,536,0,679,78.94
嘉義縣,梅山鄉,大南村,418,806,61.76,499,38.24,1305,47,1352,0,1710,79.06
嘉義縣,梅山鄉,雙溪村,417,276,60,184,40,460,11,471,0,565,83.36
嘉義縣,梅山鄉,安靖村,419,414,59.74,279,40.26,693,31,724,0,948,76.37
嘉義縣,梅山鄉,太平村,422,207,58.81,145,41.19,352,14,366,0,496,73.79
嘉義縣,梅山鄉,碧湖村,425,125,58.41,89,41.59,214,3,217,1,293,74.06
嘉義縣,梅山鄉,太興村,423,154,48.28,165,51.72,319,3,322,0,393,81.93
嘉義縣,梅山鄉,瑞峰村,426,387,71.14,157,28.86,544,18,562,0,760,73.95
嘉義縣,梅山鄉,瑞里村,427,303,54.2,256,45.8,559,29,588,0,736,79.89
嘉義縣,梅山鄉,太和村,428,258,60.56,168,39.44,426,16,442,0,601,73.54
嘉義縣,梅山鄉,太和村,429,195,58.73,137,41.27,332,14,346,0,454,76.21
嘉義縣,梅山鄉,龍眼村,424,265,73.82,94,26.18,359,10,369,0,475,77.68
嘉義縣,番路鄉,江西村,430,494,59.95145631,330,40.04854369,824,36,860,0,1047,82.13944604
嘉義縣,番路鄉,內甕村,431,181,60.13289037,120,39.86710963,301,13,314,0,414,75.84541063
嘉義縣,番路鄉,新福村,432,435,65.80937973,226,34.19062027,661,2,663,0,810,81.85185185
嘉義縣,番路鄉,下坑村,433,808,62.78166278,479,37.21833722,1287,54,1341,0,1666,80.49219688
嘉義縣,番路鄉,番路村,434,399,63.33333333,231,36.66666667,630,22,652,1,832,78.36538462
嘉義縣,番路鄉,民和村,435,364,62.01022147,223,37.98977853,587,39,626,0,803,77.95765878
嘉義縣,番路鄉,觸口村,436,152,47.35202492,169,52.64797508,321,8,329,0,428,76.86915888
嘉義縣,番路鄉,觸口村,437,296,87.05882353,44,12.94117647,340,13,353,0,397,88.91687657
嘉義縣,番路鄉,大湖村,438,351,59.19055649,242,40.80944351,593,23,616,0,836,73.68421053
嘉義縣,番路鄉,公田村,439,212,66.45768025,107,33.54231975,319,1,320,0,413,77.48184019
嘉義縣,番路鄉,公田村,440,241,59.95024876,161,40.04975124,402,10,412,0,546,75.45787546
嘉義縣,番路鄉,公興村,441,213,51.95121951,197,48.04878049,410,14,424,0,550,77.09090909
嘉義縣,番路鄉,草山村,442,64,48.85496183,67,51.14503817,131,5,136,0,171,79.53216374
嘉義縣,番路鄉,草山村,443,77,45.56213018,92,54.43786982,169,3,172,0,234,73.5042735
嘉義縣,大埔鄉,大埔村,444,323,49.61597542,328,50.38402458,651,25,676,0,999,67.66766767
嘉義縣,大埔鄉,和平村,445,50,32.25806452,105,67.74193548,155,5,160,0,237,67.51054852
嘉義縣,大埔鄉,和平村,446,103,60.94674556,66,39.05325444,169,4,173,0,242,71.48760331
嘉義縣,大埔鄉,永樂村,447,43,43,57,57,100,3,103,0,159,64.77987421
嘉義縣,大埔鄉,永樂村,448,43,37.06896552,73,62.93103448,116,0,116,0,154,75.32467532
嘉義縣,大埔鄉,茄苳村,449,98,45.58139535,117,54.41860465,215,9,224,1,325,68.92307692
嘉義縣,大埔鄉,茄苳村,450,39,36.79245283,67,63.20754717,106,1,107,0,155,69.03225806
嘉義縣,大埔鄉,茄苳村,451,39,31.70731707,84,68.29268293,123,8,131,0,231,56.70995671
嘉義縣,大埔鄉,西興村,452,75,30.12048193,174,69.87951807,249,5,254,0,377,67.37400531
嘉義縣,阿里山鄉,中山村,453,122,51.2605042,116,48.7394958,238,6,244,0,353,69.12181303
嘉義縣,阿里山鄉,中正村,454,55,41.04477612,79,58.95522388,134,4,138,0,194,71.13402062
嘉義縣,阿里山鄉,香林村,455,44,30.55555556,100,69.44444444,144,2,146,0,232,62.93103448
嘉義縣,阿里山鄉,十字村,456,86,53.75,74,46.25,160,11,171,0,243,70.37037037
嘉義縣,阿里山鄉,十字村,457,19,39.58333333,29,60.41666667,48,0,48,0,78,61.53846154
嘉義縣,阿里山鄉,來吉村,459,56,23.43096234,183,76.56903766,239,0,239,1,328,72.86585366
嘉義縣,阿里山鄉,豐山村,458,126,61.16504854,80,38.83495146,206,12,218,0,293,74.40273038
嘉義縣,阿里山鄉,達邦村,461,71,11.67763158,537,88.32236842,608,6,614,0,846,72.57683215
嘉義縣,阿里山鄉,樂野村,460,160,28.11950791,409,71.88049209,569,24,593,0,760,78.02631579
嘉義縣,阿里山鄉,里佳村,462,38,19.48717949,157,80.51282051,195,8,203,0,270,75.18518519
嘉義縣,阿里山鄉,山美村,463,64,18.65889213,279,81.34110787,343,9,352,0,483,72.87784679
嘉義縣,阿里山鄉,新美村,464,30,14.21800948,181,85.78199052,211,9,220,0,301,73.089701
嘉義縣,阿里山鄉,茶山村,465,94,40.51724138,138,59.48275862,232,7,239,0,327,73.08868502
臺南縣,新營市,忠政里,1,562,47.87052811,612,52.12947189,1174,8,1182,1,1520,77.76315789
臺南縣,新營市,忠政里,2,519,47.39726027,576,52.60273973,1095,19,1114,0,1402,79.45791726
臺南縣,新營市,忠政里,3,624,51.35802469,591,48.64197531,1215,20,1235,0,1548,79.78036176
臺南縣,新營市,民權里,4,534,55.50935551,428,44.49064449,962,19,981,0,1214,80.80724876
臺南縣,新營市,民權里,5,503,52.61506276,453,47.38493724,956,24,980,0,1209,81.05872622
臺南縣,新營市,三仙里,6,669,65.14118793,358,34.85881207,1027,27,1054,0,1340,78.65671642
臺南縣,新營市,三仙里,7,536,50.56603774,524,49.43396226,1060,28,1088,0,1348,80.71216617
臺南縣,新營市,好平里,8,420,64.61538462,230,35.38461538,650,28,678,0,863,78.5631518
臺南縣,新營市,延平里,9,624,65,336,35,960,34,994,0,1269,78.32939322
臺南縣,新營市,永生里,10,427,56.48148148,329,43.51851852,756,17,773,0,968,79.8553719
臺南縣,新營市,大宏里,11,451,58.1185567,325,41.8814433,776,30,806,0,1062,75.89453861
臺南縣,新營市,大宏里,12,409,56.25859697,318,43.74140303,727,19,746,0,946,78.85835095
臺南縣,新營市,大宏里,13,516,57.65363128,379,42.34636872,895,19,914,0,1173,77.9198636
臺南縣,新營市,王公里,14,541,59.71302428,365,40.28697572,906,25,931,0,1164,79.98281787
臺南縣,新營市,王公里,15,538,58.41476656,383,41.58523344,921,25,946,0,1199,78.89908257
臺南縣,新營市,王公里,16,495,54.5154185,413,45.4845815,908,28,936,0,1184,79.05405405
臺南縣,新營市,王公里,17,529,52.06692913,487,47.93307087,1016,17,1033,0,1308,78.97553517
臺南縣,新營市,王公里,18,606,48.21002387,651,51.78997613,1257,19,1276,0,1548,82.42894057
臺南縣,新營市,中營里,19,488,57.68321513,358,42.31678487,846,16,862,0,1085,79.44700461
臺南縣,新營市,土庫里,20,778,70.40723982,327,29.59276018,1105,39,1144,0,1434,79.77684798
臺南縣,新營市,興安里,21,203,57.02247191,153,42.97752809,356,3,359,0,451,79.60088692
臺南縣,新營市,南興里,22,536,58.13449024,386,41.86550976,922,25,947,0,1151,82.27628149
臺南縣,新營市,南興里,23,509,53.29842932,446,46.70157068,955,23,978,0,1231,79.44760357
臺南縣,新營市,興業里,24,569,47.69488684,624,52.30511316,1193,28,1221,0,1526,80.01310616
臺南縣,新營市,民生里,25,686,58.9347079,478,41.0652921,1164,35,1199,0,1517,79.03757416
臺南縣,新營市,民生里,26,755,63.23283082,439,36.76716918,1194,35,1229,0,1565,78.53035144
臺南縣,新營市,民榮里,31,549,68.625,251,31.375,800,30,830,0,1059,78.37582625
臺南縣,新營市,民榮里,32,528,57.26681128,394,42.73318872,922,36,958,0,1212,79.04290429
臺南縣,新營市,民榮里,33,778,59.89222479,521,40.10777521,1299,20,1319,0,1696,77.77122642
臺南縣,新營市,埤寮里,34,824,65.08688784,442,34.91311216,1266,36,1302,0,1616,80.56930693
臺南縣,新營市,護鎮里,35,678,69.68139774,295,30.31860226,973,40,1013,0,1278,79.26447574
臺南縣,新營市,太南里,36,862,75.08710801,286,24.91289199,1148,53,1201,0,1484,80.92991914
臺南縣,新營市,太北里,37,927,72.87735849,345,27.12264151,1272,47,1319,1,1589,83.00818125
臺南縣,新營市,南紙里,38,646,59.59409594,438,40.40590406,1084,26,1110,0,1424,77.9494382
臺南縣,新營市,南紙里,39,673,52.00927357,621,47.99072643,1294,31,1325,0,1707,77.62155829
臺南縣,新營市,嘉芳里,40,793,69.62247586,346,30.37752414,1139,40,1179,0,1497,78.75751503
臺南縣,新營市,舊埔里,41,207,77.23880597,61,22.76119403,268,17,285,0,367,77.65667575
臺南縣,新營市,角帶里,42,228,68.26347305,106,31.73652695,334,19,353,0,441,80.04535147
臺南縣,新營市,鐵線里,43,429,72.83531409,160,27.16468591,589,24,613,0,741,82.72604588
臺南縣,新營市,五興里,44,542,74.45054945,186,25.54945055,728,44,772,0,1009,76.51139742
臺南縣,新營市,姑爺里,45,396,83.36842105,79,16.63157895,475,18,493,0,593,83.13659359
臺南縣,新營市,新北里,27,621,51.62094763,582,48.37905237,1203,27,1230,0,1569,78.39388145
臺南縣,新營市,新北里,28,793,52.8314457,708,47.1685543,1501,16,1517,0,1873,80.99305926
臺南縣,新營市,新南里,29,561,55.93220339,442,44.06779661,1003,23,1026,0,1246,82.3434992
臺南縣,新營市,新南里,30,688,55.79886456,545,44.20113544,1233,13,1246,0,1540,80.90909091
臺南縣,永康市,五王里,737,535,52.70935961,480,47.29064039,1015,17,1032,0,1291,79.93803253
臺南縣,永康市,五王里,738,592,57.6436222,435,42.3563778,1027,18,1045,0,1299,80.44649731
臺南縣,永康市,五王里,739,692,53.56037152,600,46.43962848,1292,30,1322,0,1655,79.87915408
臺南縣,永康市,網寮里,746,683,60.17621145,452,39.82378855,1135,30,1165,0,1414,82.3903819
臺南縣,永康市,網寮里,747,633,60,422,40,1055,18,1073,0,1313,81.72124905
臺南縣,永康市,網寮里,748,731,56.88715953,554,43.11284047,1285,15,1300,0,1614,80.54522924
臺南縣,永康市,永康里,754,504,60.72289157,326,39.27710843,830,23,853,0,1022,83.46379648
臺南縣,永康市,永康里,755,608,68.08510638,285,31.91489362,893,18,911,0,1113,81.85085355
臺南縣,永康市,永康里,756,535,57.71305286,392,42.28694714,927,20,947,0,1208,78.39403974
臺南縣,永康市,永康里,757,746,63.70623399,425,36.29376601,1171,30,1201,0,1507,79.6947578
臺南縣,永康市,永康里,758,504,55.38461538,406,44.61538462,910,16,926,0,1286,72.00622084
臺南縣,永康市,埔園里,759,655,63.96484375,369,36.03515625,1024,27,1051,0,1321,79.56093868
臺南縣,永康市,埔園里,760,732,63.26707001,425,36.73292999,1157,19,1176,0,1430,82.23776224
臺南縣,永康市,埔園里,761,757,64.64560205,414,35.35439795,1171,36,1207,0,1453,83.06951136
臺南縣,永康市,埔園里,762,837,66.27078385,426,33.72921615,1263,21,1284,0,1584,81.06060606
臺南縣,永康市,大橋里,768,711,59.20066611,490,40.79933389,1201,24,1225,0,1530,80.06535948
臺南縣,永康市,大橋里,769,703,57.52864157,519,42.47135843,1222,14,1236,0,1503,82.23552894
臺南縣,永康市,大橋里,770,557,52.64650284,501,47.35349716,1058,25,1083,0,1339,80.88125467
臺南縣,永康市,王行里,804,808,74.4014733,278,25.5985267,1086,25,1111,0,1323,83.97581255
臺南縣,永康市,王行里,805,308,68.75,140,31.25,448,5,453,0,556,81.47482014
臺南縣,永康市,烏竹里,806,479,72.57575758,181,27.42424242,660,19,679,0,817,83.10893513
臺南縣,永康市,烏竹里,807,425,59.52380952,289,40.47619048,714,13,727,0,895,81.22905028
臺南縣,永康市,蔦松里,779,459,65.94827586,237,34.05172414,696,17,713,0,858,83.1002331
臺南縣,永康市,蔦松里,780,343,62.36363636,207,37.63636364,550,18,568,0,692,82.08092486
臺南縣,永康市,三民里,781,321,61.73076923,199,38.26923077,520,15,535,0,644,83.07453416
臺南縣,永康市,三民里,782,247,71.1815562,100,28.8184438,347,10,357,0,419,85.20286396
臺南縣,永康市,鹽行里,783,694,67.18296225,339,32.81703775,1033,10,1043,0,1311,79.55758963
臺南縣,永康市,鹽行里,784,655,65.43456543,346,34.56543457,1001,18,1019,0,1274,79.98430141
臺南縣,永康市,鹽行里,785,686,68.12313803,321,31.87686197,1007,12,1019,0,1252,81.38977636
臺南縣,永康市,鹽行里,786,564,53.56125356,489,46.43874644,1053,21,1074,0,1370,78.39416058
臺南縣,永康市,鹽行里,787,592,61.7954071,366,38.2045929,958,21,979,0,1223,80.04905969
臺南縣,永康市,甲頂里,792,307,49.2776886,316,50.7223114,623,11,634,0,780,81.28205128
臺南縣,永康市,甲頂里,793,551,70.46035806,231,29.53964194,782,6,788,0,940,83.82978723
臺南縣,永康市,甲頂里,794,238,53.6036036,206,46.3963964,444,16,460,0,538,85.50185874
臺南縣,永康市,大灣里,813,608,74.41860465,209,25.58139535,817,35,852,0,1042,81.76583493
臺南縣,永康市,大灣里,814,489,68.67977528,223,31.32022472,712,19,731,0,863,84.70451912
臺南縣,永康市,大灣里,815,619,65.64156946,324,34.35843054,943,14,957,0,1120,85.44642857
臺南縣,永康市,東灣里,816,623,75.15078408,206,24.84921592,829,24,853,0,985,86.59898477
臺南縣,永康市,東灣里,817,676,70.85953878,278,29.14046122,954,21,975,0,1170,83.33333333
臺南縣,永康市,東灣里,818,519,58.38020247,370,41.61979753,889,11,900,0,1069,84.19083255
臺南縣,永康市,西灣里,819,732,74.54175153,250,25.45824847,982,39,1021,0,1247,81.87650361
臺南縣,永康市,西灣里,820,754,62.62458472,450,37.37541528,1204,19,1223,0,1474,82.97150611
臺南縣,永康市,西灣里,821,729,64.5704163,400,35.4295837,1129,15,1144,0,1343,85.1824274
臺南縣,永康市,西灣里,822,653,58.04444444,472,41.95555556,1125,8,1133,0,1340,84.55223881
臺南縣,永康市,南灣里,823,714,65.32479414,379,34.67520586,1093,28,1121,0,1369,81.88458729
臺南縣,永康市,南灣里,824,755,76.72764228,229,23.27235772,984,27,1011,0,1187,85.1727043
臺南縣,永康市,南灣里,825,616,76.90387016,185,23.09612984,801,25,826,0,985,83.85786802
臺南縣,永康市,崑山里,826,541,56.76810073,412,43.23189927,953,16,969,0,1176,82.39795918
臺南縣,永康市,崑山里,827,739,65.80587711,384,34.19412289,1123,11,1134,0,1359,83.44370861
臺南縣,永康市,崑山里,828,677,61.15627823,430,38.84372177,1107,7,1114,0,1346,82.76374443
臺南縣,永康市,崑山里,829,818,67.21446179,399,32.78553821,1217,16,1233,0,1500,82.2
臺南縣,永康市,北灣里,830,604,66.30076839,307,33.69923161,911,21,932,0,1124,82.91814947
臺南縣,永康市,北灣里,831,562,66.9047619,278,33.0952381,840,21,861,0,1038,82.94797688
臺南縣,永康市,北灣里,832,682,62.51145738,409,37.48854262,1091,21,1112,0,1369,81.22717312
臺南縣,永康市,北灣里,833,523,62.93622142,308,37.06377858,831,24,855,0,1045,81.81818182
臺南縣,永康市,北灣里,834,653,65.8266129,339,34.1733871,992,16,1008,0,1232,81.81818182
臺南縣,永康市,新樹里,812,749,74.60159363,255,25.39840637,1004,29,1033,0,1290,80.07751938
臺南縣,永康市,復興里,835,147,24.70588235,448,75.29411765,595,26,621,0,805,77.14285714
臺南縣,永康市,復興里,836,189,25.23364486,560,74.76635514,749,22,771,0,949,81.24341412
臺南縣,永康市,復國里,840,370,43.63207547,478,56.36792453,848,10,858,1,1046,82.02676864
臺南縣,永康市,復國里,841,379,42.11111111,521,57.88888889,900,21,921,0,1102,83.5753176
臺南縣,永康市,建國里,838,89,11.83510638,663,88.16489362,752,9,761,0,996,76.40562249
臺南縣,永康市,建國里,839,149,20.98591549,561,79.01408451,710,22,732,0,910,80.43956044
臺南縣,永康市,神洲里,851,127,16.91078562,624,83.08921438,751,15,766,0,903,84.82834994
臺南縣,永康市,神洲里,852,211,34.53355155,400,65.46644845,611,10,621,0,790,78.60759494
臺南縣,永康市,西勢里,808,519,67.3151751,252,32.6848249,771,21,792,0,944,83.89830508
臺南縣,永康市,西勢里,809,614,70.49368542,257,29.50631458,871,26,897,0,1076,83.36431227
臺南縣,永康市,西勢里,810,538,62.05305652,329,37.94694348,867,13,880,0,1056,83.33333333
臺南縣,永康市,西勢里,811,527,57.91208791,383,42.08791209,910,17,927,0,1150,80.60869565
臺南縣,永康市,成功里,853,93,11.65413534,705,88.34586466,798,12,810,0,995,81.40703518
臺南縣,永康市,成功里,854,298,34.57076566,564,65.42923434,862,8,870,0,1092,79.67032967
臺南縣,永康市,中興里,857,496,46.52908068,570,53.47091932,1066,30,1096,0,1331,82.34410218
臺南縣,永康市,中興里,858,559,46.12211221,653,53.87788779,1212,18,1230,0,1449,84.88612836
臺南縣,永康市,勝利里,859,393,45.32871972,474,54.67128028,867,13,880,0,1128,78.0141844
臺南縣,永康市,勝利里,860,436,52.59348613,393,47.40651387,829,14,843,0,1087,77.55289788
臺南縣,永康市,勝利里,861,369,48.74504624,388,51.25495376,757,17,774,0,980,78.97959184
臺南縣,永康市,勝利里,862,458,51.51856018,431,48.48143982,889,19,908,0,1087,83.53265869
臺南縣,永康市,勝利里,863,384,44.29065744,483,55.70934256,867,14,881,0,1100,80.09090909
臺南縣,永康市,龍潭里,798,595,74.28214732,206,25.71785268,801,32,833,0,1021,81.58667973
臺南縣,永康市,龍潭里,799,549,73.10252996,202,26.89747004,751,27,778,0,956,81.38075314
臺南縣,永康市,龍潭里,800,642,69.48051948,282,30.51948052,924,18,942,0,1173,80.30690537
臺南縣,永康市,龍潭里,801,558,64.43418014,308,35.56581986,866,12,878,0,1080,81.2962963
臺南縣,永康市,龍潭里,802,578,60.02076843,385,39.97923157,963,12,975,0,1213,80.37922506
臺南縣,永康市,龍潭里,803,476,53.78531073,409,46.21468927,885,9,894,0,1089,82.09366391
臺南縣,永康市,光復里,837,109,12.44292237,767,87.55707763,876,31,907,0,1128,80.40780142
臺南縣,永康市,鹽洲里,788,448,58.33333333,320,41.66666667,768,19,787,0,949,82.92939937
臺南縣,永康市,鹽洲里,789,594,61.2371134,376,38.7628866,970,7,977,0,1148,85.10452962
臺南縣,永康市,鹽洲里,790,557,67.35187424,270,32.64812576,827,22,849,0,1035,82.02898551
臺南縣,永康市,鹽洲里,791,732,67.96657382,345,32.03342618,1077,25,1102,0,1307,84.31522571
臺南縣,永康市,二王里,749,491,57.69682726,360,42.30317274,851,12,863,0,1122,76.91622103
臺南縣,永康市,二王里,750,687,51.42215569,649,48.57784431,1336,17,1353,0,1730,78.20809249
臺南縣,永康市,二王里,751,432,55.03184713,353,44.96815287,785,10,795,0,931,85.39205156
臺南縣,永康市,二王里,752,403,50,403,50,806,12,818,0,1020,80.19607843
臺南縣,永康市,二王里,753,515,53.98322851,439,46.01677149,954,18,972,0,1192,81.54362416
臺南縣,永康市,六合里,742,367,62.3089983,222,37.6910017,589,6,595,1,720,82.63888889
臺南縣,永康市,六合里,743,227,35.97464342,404,64.02535658,631,7,638,0,778,82.00514139
臺南縣,永康市,六合里,744,542,61.24293785,343,38.75706215,885,20,905,0,1160,78.01724138
臺南縣,永康市,六合里,745,317,40.69319641,462,59.30680359,779,13,792,0,1005,78.80597015
臺南縣,永康市,三合里,740,595,54.23883318,502,45.76116682,1097,26,1123,0,1395,80.50179211
臺南縣,永康市,三合里,741,702,56.65859564,537,43.34140436,1239,23,1262,0,1585,79.6214511
臺南縣,永康市,東橋里,771,348,54.29017161,293,45.70982839,641,11,652,0,794,82.11586902
臺南縣,永康市,東橋里,772,306,54.64285714,254,45.35714286,560,9,569,0,682,83.43108504
臺南縣,永康市,東橋里,773,350,63.29113924,203,36.70886076,553,10,563,0,702,80.1994302
臺南縣,永康市,安康里,776,526,54.96342738,431,45.03657262,957,22,979,0,1219,80.31173093
臺南縣,永康市,安康里,777,598,56.20300752,466,43.79699248,1064,25,1089,0,1331,81.81818182
臺南縣,永康市,安康里,778,518,51.9558676,479,48.0441324,997,7,1004,0,1318,76.17602428
臺南縣,永康市,西橋里,774,529,52.48015873,479,47.51984127,1008,28,1036,0,1271,81.51062156
臺南縣,永康市,西橋里,775,542,54.91388045,445,45.08611955,987,24,1011,0,1297,77.94911334
臺南縣,永康市,尚頂里,795,665,69.48798328,292,30.51201672,957,19,976,0,1142,85.46409807
臺南縣,永康市,尚頂里,796,595,65.89147287,308,34.10852713,903,23,926,0,1108,83.57400722
臺南縣,永康市,尚頂里,797,526,54.67775468,436,45.32224532,962,17,979,0,1216,80.50986842
臺南縣,永康市,復華里,842,439,49.10514541,455,50.89485459,894,21,915,0,1181,77.47671465
臺南縣,永康市,復華里,843,570,49.91243433,572,50.08756567,1142,15,1157,0,1469,78.76106195
臺南縣,永康市,復華里,844,386,43.12849162,509,56.87150838,895,18,913,0,1109,82.3264202
臺南縣,永康市,復華里,845,408,45.68868981,485,54.31131019,893,11,904,0,1119,80.78641644
臺南縣,永康市,復華里,846,405,44.70198675,501,55.29801325,906,10,916,0,1162,78.82960413
臺南縣,永康市,復華里,847,447,49.17491749,462,50.82508251,909,27,936,0,1177,79.5242141
臺南縣,永康市,復華里,848,340,43.31210191,445,56.68789809,785,10,795,0,1025,77.56097561
臺南縣,永康市,復華里,849,286,39.88842399,431,60.11157601,717,12,729,0,891,81.81818182
臺南縣,永康市,復華里,850,379,39.97890295,569,60.02109705,948,15,963,0,1201,80.18318068
臺南縣,永康市,正強里,763,680,65.70048309,355,34.29951691,1035,14,1049,0,1274,82.33908948
臺南縣,永康市,正強里,764,596,60.50761421,389,39.49238579,985,32,1017,0,1247,81.55573376
臺南縣,永康市,正強里,765,550,66.26506024,280,33.73493976,830,17,847,0,1022,82.87671233
臺南縣,永康市,正強里,766,598,61.52263374,374,38.47736626,972,17,989,0,1210,81.73553719
臺南縣,永康市,正強里,767,418,51.1002445,400,48.8997555,818,15,833,0,1056,78.88257576
臺南縣,永康市,中華里,855,417,49.82078853,420,50.17921147,837,15,852,0,1010,84.35643564
臺南縣,永康市,中華里,856,390,45.72098476,463,54.27901524,853,9,862,0,1088,79.22794118
臺南縣,鹽水鎮,水秀里,46,544,75.76601671,174,24.23398329,718,14,732,0,934,78.37259101
臺南縣,鹽水鎮,水秀里,47,223,61.26373626,141,38.73626374,364,8,372,0,466,79.82832618
臺南縣,鹽水鎮,福得里,48,315,66.87898089,156,33.12101911,471,17,488,0,622,78.45659164
臺南縣,鹽水鎮,三生里,49,199,67.45762712,96,32.54237288,295,15,310,0,382,81.15183246
臺南縣,鹽水鎮,武廟里,50,302,68.94977169,136,31.05022831,438,9,447,0,551,81.12522686
臺南縣,鹽水鎮,中境里,51,218,50.93457944,210,49.06542056,428,6,434,0,534,81.27340824
臺南縣,鹽水鎮,水仙里,52,205,65.70512821,107,34.29487179,312,9,321,0,397,80.85642317
臺南縣,鹽水鎮,水正里,53,371,60.81967213,239,39.18032787,610,18,628,0,791,79.3931732
臺南縣,鹽水鎮,橋南里,54,347,60.03460208,231,39.96539792,578,21,599,0,772,77.59067358
臺南縣,鹽水鎮,橋南里,55,573,65.336374,304,34.663626,877,30,907,0,1183,76.66948436
臺南縣,鹽水鎮,橋南里,56,640,64.77732794,348,35.22267206,988,19,1007,0,1299,77.52117013
臺南縣,鹽水鎮,舊營里,57,516,83.63047002,101,16.36952998,617,15,632,0,766,82.50652742
臺南縣,鹽水鎮,汫水里,58,588,81.78025035,131,18.21974965,719,43,762,0,982,77.59674134
臺南縣,鹽水鎮,岸內里,59,489,60.82089552,315,39.17910448,804,11,815,0,1060,76.88679245
臺南縣,鹽水鎮,岸內里,60,578,61.95069668,355,38.04930332,933,30,963,0,1197,80.45112782
臺南縣,鹽水鎮,岸內里,61,506,62.16216216,308,37.83783784,814,28,842,0,1028,81.90661479
臺南縣,鹽水鎮,義稠里,62,397,71.53153153,158,28.46846847,555,19,574,0,772,74.35233161
臺南縣,鹽水鎮,下中里,63,457,76.54941374,140,23.45058626,597,31,628,0,780,80.51282051
臺南縣,鹽水鎮,歡雅里,64,486,70.12987013,207,29.87012987,693,20,713,0,881,80.9307605
臺南縣,鹽水鎮,歡雅里,65,436,76.22377622,136,23.77622378,572,33,605,0,754,80.23872679
臺南縣,鹽水鎮,大莊里,66,308,82.35294118,66,17.64705882,374,21,395,0,498,79.31726908
臺南縣,鹽水鎮,桐寮里,67,183,77.54237288,53,22.45762712,236,11,247,0,290,85.17241379
臺南縣,鹽水鎮,後宅里,68,376,74.45544554,129,25.54455446,505,32,537,0,687,78.16593886
臺南縣,鹽水鎮,孫厝里,69,245,72.4852071,93,27.5147929,338,20,358,0,475,75.36842105
臺南縣,鹽水鎮,竹埔里,70,493,79.51612903,127,20.48387097,620,23,643,0,784,82.01530612
臺南縣,鹽水鎮,下林里,71,251,80.44871795,61,19.55128205,312,21,333,0,431,77.26218097
臺南縣,鹽水鎮,田寮里,72,173,78.63636364,47,21.36363636,220,13,233,0,281,82.91814947
臺南縣,鹽水鎮,大豐里,73,230,76.66666667,70,23.33333333,300,7,307,0,375,81.86666667
臺南縣,鹽水鎮,飯店里,74,217,68.88888889,98,31.11111111,315,15,330,0,420,78.57142857
臺南縣,鹽水鎮,河南里,75,320,76.37231504,99,23.62768496,419,15,434,0,552,78.62318841
臺南縣,鹽水鎮,南港里,76,545,73.94843962,192,26.05156038,737,36,773,0,947,81.62618796
臺南縣,白河鎮,白河里,77,605,66.12021858,310,33.87978142,915,37,952,0,1216,78.28947368
臺南縣,白河鎮,白河里,78,283,62.33480176,171,37.66519824,454,11,465,0,597,77.88944724
臺南縣,白河鎮,永安里,79,396,66.22073579,202,33.77926421,598,18,616,0,789,78.07351077
臺南縣,白河鎮,永安里,80,529,61.51162791,331,38.48837209,860,14,874,0,1091,80.10999083
臺南縣,白河鎮,永安里,81,517,70.7250342,214,29.2749658,731,13,744,0,938,79.31769723
臺南縣,白河鎮,外角里,82,807,72.50673854,306,27.49326146,1113,38,1151,0,1476,77.98102981
臺南縣,白河鎮,庄內里,83,418,72.19343696,161,27.80656304,579,27,606,0,744,81.4516129
臺南縣,白河鎮,庄內里,84,402,64.73429952,219,35.26570048,621,25,646,0,830,77.8313253
臺南縣,白河鎮,秀祐里,85,429,66.61490683,215,33.38509317,644,44,688,0,866,79.44572748
臺南縣,白河鎮,河東里,86,395,64.75409836,215,35.24590164,610,27,637,0,828,76.93236715
臺南縣,白河鎮,河東里,87,279,73.03664921,103,26.96335079,382,15,397,0,543,73.11233886
臺南縣,白河鎮,虎山里,88,225,67.36526946,109,32.63473054,334,22,356,1,462,77.05627706
臺南縣,白河鎮,大林里,89,330,75.51487414,107,24.48512586,437,22,459,0,640,71.71875
臺南縣,白河鎮,崁頭里,90,244,72.61904762,92,27.38095238,336,29,365,0,458,79.69432314
臺南縣,白河鎮,六溪里,91,342,76.16926503,107,23.83073497,449,14,463,0,650,71.23076923
臺南縣,白河鎮,仙草里,94,364,64.53900709,200,35.46099291,564,30,594,0,752,78.9893617
臺南縣,白河鎮,仙草里,95,248,64.08268734,139,35.91731266,387,23,410,0,558,73.47670251
臺南縣,白河鎮,仙草里,96,34,9.88372093,310,90.11627907,344,39,383,0,614,62.37785016
臺南縣,白河鎮,關嶺里,92,377,65.11226252,202,34.88773748,579,19,598,0,810,73.82716049
臺南縣,白河鎮,關嶺里,93,215,65.74923547,112,34.25076453,327,3,330,0,439,75.17084282
臺南縣,白河鎮,玉豐里,97,614,66.88453159,304,33.11546841,918,34,952,0,1235,77.08502024
臺南縣,白河鎮,大竹里,98,723,68.79162702,328,31.20837298,1051,52,1103,0,1396,79.01146132
臺南縣,白河鎮,詔安里,99,512,75.51622419,166,24.48377581,678,30,708,0,882,80.27210884
臺南縣,白河鎮,廣安里,100,386,73.24478178,141,26.75521822,527,16,543,0,683,79.50219619
臺南縣,白河鎮,蓮潭里,101,459,68.8155922,208,31.1844078,667,35,702,0,890,78.87640449
臺南縣,白河鎮,竹門里,102,498,69.35933148,220,30.64066852,718,24,742,0,952,77.94117647
臺南縣,白河鎮,崎內里,103,343,58.03722504,248,41.96277496,591,8,599,0,785,76.30573248
臺南縣,白河鎮,昇安里,104,686,71.68234065,271,28.31765935,957,51,1008,0,1270,79.37007874
臺南縣,白河鎮,汴頭里,105,418,76.69724771,127,23.30275229,545,29,574,0,708,81.07344633
臺南縣,白河鎮,內角里,106,445,75.55178268,144,24.44821732,589,27,616,0,791,77.87610619
臺南縣,白河鎮,草店里,107,408,59.82404692,274,40.17595308,682,20,702,0,918,76.47058824
臺南縣,白河鎮,甘宅里,108,364,77.44680851,106,22.55319149,470,25,495,0,662,74.7734139
臺南縣,柳營鄉,士林村,109,432,70.24390244,183,29.75609756,615,3,618,0,796,77.63819095
臺南縣,柳營鄉,士林村,110,392,66.44067797,198,33.55932203,590,14,604,0,745,81.0738255
臺南縣,柳營鄉,光福村,111,410,63.36939722,237,36.63060278,647,25,672,0,819,82.05128205
臺南縣,柳營鄉,光福村,112,547,67.36453202,265,32.63546798,812,25,837,0,988,84.71659919
臺南縣,柳營鄉,中埕村,113,369,66.60649819,185,33.39350181,554,17,571,0,712,80.19662921
臺南縣,柳營鄉,東昇村,114,667,70.35864979,281,29.64135021,948,44,992,0,1240,80
臺南縣,柳營鄉,東昇村,115,655,64.98015873,353,35.01984127,1008,32,1040,0,1300,80
臺南縣,柳營鄉,八翁村,116,651,64.39169139,360,35.60830861,1011,42,1053,0,1276,82.52351097
臺南縣,柳營鄉,人和村,117,243,64.45623342,134,35.54376658,377,9,386,0,479,80.58455115
臺南縣,柳營鄉,人和村,118,147,60.99585062,94,39.00414938,241,12,253,0,315,80.31746032
臺南縣,柳營鄉,太康村,119,415,67.58957655,199,32.41042345,614,31,645,0,800,80.625
臺南縣,柳營鄉,太康村,120,423,75.40106952,138,24.59893048,561,27,588,0,708,83.05084746
臺南縣,柳營鄉,重溪村,121,391,66.95205479,193,33.04794521,584,39,623,0,760,81.97368421
臺南縣,柳營鄉,重溪村,122,363,62.26415094,220,37.73584906,583,24,607,0,731,83.0369357
臺南縣,柳營鄉,重溪村,123,145,65.31531532,77,34.68468468,222,11,233,0,285,81.75438596
臺南縣,柳營鄉,篤農村,124,327,65.13944223,175,34.86055777,502,24,526,2,698,75.35816619
臺南縣,柳營鄉,篤農村,125,388,69.03914591,174,30.96085409,562,22,584,0,718,81.33704735
臺南縣,柳營鄉,大農村,126,350,67.43737958,169,32.56262042,519,22,541,0,672,80.50595238
臺南縣,柳營鄉,神農村,127,657,73.90326209,232,26.09673791,889,39,928,0,1179,78.71077184
臺南縣,柳營鄉,神農村,128,130,78.31325301,36,21.68674699,166,11,177,0,217,81.56682028
臺南縣,柳營鄉,果毅村,129,628,75.02986858,209,24.97013142,837,35,872,0,1095,79.6347032
臺南縣,柳營鄉,果毅村,130,90,76.27118644,28,23.72881356,118,4,122,0,156,78.20512821
臺南縣,柳營鄉,旭山村,131,432,61.53846154,270,38.46153846,702,29,731,0,975,74.97435897
臺南縣,柳營鄉,旭山村,132,254,67.55319149,122,32.44680851,376,15,391,0,514,76.07003891
臺南縣,柳營鄉,旭山村,133,114,69.09090909,51,30.90909091,165,3,168,0,200,84
臺南縣,後壁鄉,後壁村,134,329,61.03896104,210,38.96103896,539,13,552,0,684,80.70175439
臺南縣,後壁鄉,後壁村,135,409,61.13602392,260,38.86397608,669,20,689,0,831,82.91215403
臺南縣,後壁鄉,侯伯村,136,433,72.77310924,162,27.22689076,595,22,617,0,761,81.07752957
臺南縣,後壁鄉,侯伯村,137,314,75.29976019,103,24.70023981,417,15,432,0,543,79.55801105
臺南縣,後壁鄉,嘉苳村,138,518,65.98726115,267,34.01273885,785,32,817,0,1029,79.39747328
臺南縣,後壁鄉,嘉苳村,139,123,71.51162791,49,28.48837209,172,16,188,0,242,77.68595041
臺南縣,後壁鄉,土溝村,140,331,73.71937639,118,26.28062361,449,20,469,0,596,78.69127517
臺南縣,後壁鄉,土溝村,141,414,72.88732394,154,27.11267606,568,19,587,0,728,80.63186813
臺南縣,後壁鄉,嘉田村,142,688,75.52140505,223,24.47859495,911,47,958,0,1179,81.2553011
臺南縣,後壁鄉,嘉民村,143,740,75.51020408,240,24.48979592,980,41,1021,0,1280,79.765625
臺南縣,後壁鄉,菁豊村,144,436,70.20933977,185,29.79066023,621,20,641,0,815,78.65030675
臺南縣,後壁鄉,崁頂村,145,311,77.55610973,90,22.44389027,401,12,413,0,483,85.50724638
臺南縣,後壁鄉,仕安村,153,353,77.4122807,103,22.5877193,456,22,478,0,575,83.13043478
臺南縣,後壁鄉,竹新村,154,673,83.70646766,131,16.29353234,804,20,824,0,990,83.23232323
臺南縣,後壁鄉,竹新村,155,287,76.32978723,89,23.67021277,376,15,391,0,458,85.37117904
臺南縣,後壁鄉,新東村,156,418,79.16666667,110,20.83333333,528,23,551,0,650,84.76923077
臺南縣,後壁鄉,新東村,157,494,73.18518519,181,26.81481481,675,15,690,0,880,78.40909091
臺南縣,後壁鄉,頂安村,158,571,61.06951872,364,38.93048128,935,31,966,0,1215,79.50617284
臺南縣,後壁鄉,長安村,159,326,62.45210728,196,37.54789272,522,18,540,0,680,79.41176471
臺南縣,後壁鄉,長安村,160,350,69.44444444,154,30.55555556,504,14,518,0,657,78.84322679
臺南縣,後壁鄉,福安村,161,602,65.93647317,311,34.06352683,913,19,932,0,1166,79.93138937
臺南縣,後壁鄉,烏樹村,162,469,75.64516129,151,24.35483871,620,27,647,0,817,79.19216646
臺南縣,後壁鄉,後部村,146,262,73.59550562,94,26.40449438,356,28,384,0,555,69.18918919
臺南縣,後壁鄉,墨林村,147,400,68.49315068,184,31.50684932,584,41,625,0,791,79.01390645
臺南縣,後壁鄉,菁寮村,148,233,68.93491124,105,31.06508876,338,19,357,0,450,79.33333333
臺南縣,後壁鄉,新嘉村,149,373,83.07349666,76,16.92650334,449,26,475,0,586,81.05802048
臺南縣,後壁鄉,新嘉村,150,327,78.60576923,89,21.39423077,416,26,442,0,555,79.63963964
臺南縣,後壁鄉,頂長村,151,330,76.74418605,100,23.25581395,430,25,455,0,552,82.42753623
臺南縣,後壁鄉,平安村,152,585,74.05063291,205,25.94936709,790,45,835,0,1060,78.77358491
臺南縣,東山鄉,東山村,163,629,60.5973025,409,39.4026975,1038,47,1085,0,1485,73.06397306
臺南縣,東山鄉,東中村,164,534,59.73154362,360,40.26845638,894,30,924,0,1169,79.04191617
臺南縣,東山鄉,東中村,165,559,64.25287356,311,35.74712644,870,41,911,0,1165,78.19742489
臺南縣,東山鄉,東正村,166,740,68.7093779,337,31.2906221,1077,71,1148,0,1552,73.96907216
臺南縣,東山鄉,三榮村,167,492,72.56637168,186,27.43362832,678,37,715,0,928,77.04741379
臺南縣,東山鄉,大客村,168,500,63.45177665,288,36.54822335,788,53,841,0,1162,72.37521515
臺南縣,東山鄉,科里村,169,303,56.42458101,234,43.57541899,537,34,571,0,767,74.44589309
臺南縣,東山鄉,科里村,170,327,71.39737991,131,28.60262009,458,32,490,0,594,82.49158249
臺南縣,東山鄉,東河村,171,508,74.59618209,173,25.40381791,681,36,717,0,906,79.13907285
臺南縣,東山鄉,南溪村,175,260,70.27027027,110,29.72972973,370,20,390,0,511,76.32093933
臺南縣,東山鄉,水雲村,176,244,76.97160883,73,23.02839117,317,14,331,0,472,70.12711864
臺南縣,東山鄉,林安村,177,211,73.26388889,77,26.73611111,288,25,313,0,410,76.34146341
臺南縣,東山鄉,東原村,178,409,60.77265973,264,39.22734027,673,47,720,0,1010,71.28712871
臺南縣,東山鄉,東原村,179,510,59.71896956,344,40.28103044,854,52,906,0,1296,69.90740741
臺南縣,東山鄉,嶺南村,180,344,66.92607004,170,33.07392996,514,28,542,0,790,68.60759494
臺南縣,東山鄉,南勢村,181,470,60.10230179,312,39.89769821,782,47,829,0,1151,72.02432667
臺南縣,東山鄉,青山村,182,464,58.95806861,323,41.04193139,787,36,823,0,1130,72.83185841
臺南縣,東山鄉,高原村,183,356,53.61445783,308,46.38554217,664,47,711,0,965,73.67875648
臺南縣,東山鄉,聖賢村,172,454,74.06199021,159,25.93800979,613,13,626,0,778,80.46272494
臺南縣,東山鄉,聖賢村,173,267,70.63492063,111,29.36507937,378,8,386,0,479,80.58455115
臺南縣,東山鄉,聖賢村,174,338,70.12448133,144,29.87551867,482,25,507,0,639,79.342723
臺南縣,麻豆鎮,穀興里,184,430,78.75457875,116,21.24542125,546,6,552,0,645,85.58139535
臺南縣,麻豆鎮,保安里,185,364,75.36231884,119,24.63768116,483,12,495,0,586,84.47098976
臺南縣,麻豆鎮,東角里,186,658,66.93794507,325,33.06205493,983,20,1003,0,1188,84.42760943
臺南縣,麻豆鎮,東角里,187,498,68.3127572,231,31.6872428,729,12,741,0,892,83.07174888
臺南縣,麻豆鎮,晉江里,188,711,75.39766702,232,24.60233298,943,20,963,0,1140,84.47368421
臺南縣,麻豆鎮,晉江里,189,695,73.54497354,250,26.45502646,945,27,972,0,1187,81.88711036
臺南縣,麻豆鎮,巷口里,190,807,69.32989691,357,30.67010309,1164,21,1185,0,1424,83.21629213
臺南縣,麻豆鎮,中興里,191,528,67.09021601,259,32.90978399,787,20,807,0,965,83.62694301
臺南縣,麻豆鎮,中興里,192,547,71.69069463,216,28.30930537,763,12,775,0,933,83.06538049
臺南縣,麻豆鎮,興農里,193,849,77.74725275,243,22.25274725,1092,31,1123,0,1322,84.94704992
臺南縣,麻豆鎮,新建里,194,649,77.7245509,186,22.2754491,835,17,852,0,1009,84.44003964
臺南縣,麻豆鎮,油車里,195,919,77.68385461,264,22.31614539,1183,29,1212,0,1459,83.0705963
臺南縣,麻豆鎮,油車里,196,937,77.43801653,273,22.56198347,1210,25,1235,0,1472,83.89945652
臺南縣,麻豆鎮,北勢里,197,829,88.19148936,111,11.80851064,940,29,969,0,1161,83.4625323
臺南縣,麻豆鎮,大埕里,198,812,72.04968944,315,27.95031056,1127,32,1159,0,1404,82.54985755
臺南縣,麻豆鎮,大埕里,199,695,75.708061,223,24.291939,918,19,937,0,1107,84.64317977
臺南縣,麻豆鎮,總榮里,200,358,68.0608365,168,31.9391635,526,20,546,0,660,82.72727273
臺南縣,麻豆鎮,龍泉里,201,518,85.33772652,89,14.66227348,607,14,621,0,735,84.48979592
臺南縣,麻豆鎮,南勢里,202,373,72.42718447,142,27.57281553,515,22,537,0,658,81.61094225
臺南縣,麻豆鎮,南勢里,203,834,64.45131376,460,35.54868624,1294,17,1311,0,1598,82.04005006
臺南縣,麻豆鎮,寮部里,204,1076,83.54037267,212,16.45962733,1288,48,1336,0,1562,85.53137004
臺南縣,麻豆鎮,小埤里,205,635,81.09833972,148,18.90166028,783,15,798,0,944,84.53389831
臺南縣,麻豆鎮,埤頭里,206,896,81.01265823,210,18.98734177,1106,28,1134,1,1325,85.58490566
臺南縣,麻豆鎮,大山里,207,378,82.71334792,79,17.28665208,457,10,467,0,524,89.1221374
臺南縣,麻豆鎮,海埔里,208,624,78.68852459,169,21.31147541,793,33,826,0,972,84.97942387
臺南縣,麻豆鎮,莊禮里,209,357,85.40669856,61,14.59330144,418,21,439,0,528,83.14393939
臺南縣,麻豆鎮,港尾里,210,750,83.14855876,152,16.85144124,902,26,928,0,1101,84.28701181
臺南縣,麻豆鎮,麻口里,211,711,83.06074766,145,16.93925234,856,15,871,0,1045,83.3492823
臺南縣,麻豆鎮,安東里,212,369,75,123,25,492,13,505,0,629,80.28616852
臺南縣,麻豆鎮,安業里,213,446,81.09090909,104,18.90909091,550,15,565,0,674,83.82789318
臺南縣,麻豆鎮,安西里,214,529,86.15635179,85,13.84364821,614,27,641,0,746,85.92493298
臺南縣,麻豆鎮,謝安里,215,636,81.64313222,143,18.35686778,779,16,795,0,927,85.7605178
臺南縣,麻豆鎮,中民里,216,631,88.12849162,85,11.87150838,716,6,722,0,846,85.3427896
臺南縣,麻豆鎮,安正里,217,586,83.35704125,117,16.64295875,703,11,714,1,833,85.71428571
臺南縣,麻豆鎮,磚井里,218,786,83.43949045,156,16.56050955,942,24,966,0,1123,86.01959038
臺南縣,下營鄉,下營村,219,471,62.38410596,284,37.61589404,755,26,781,0,970,80.51546392
臺南縣,下營鄉,仁里村,220,662,64.33430515,367,35.66569485,1029,33,1062,0,1327,80.03014318
臺南縣,下營鄉,仁里村,221,562,57.52302968,415,42.47697032,977,20,997,1,1292,77.16718266
臺南縣,下營鄉,宅內村,222,515,60.44600939,337,39.55399061,852,37,889,1,1146,77.57417103
臺南縣,下營鄉,後街村,223,719,59.47063689,490,40.52936311,1209,15,1224,0,1534,79.79139505
臺南縣,下營鄉,新興村,224,491,59.87804878,329,40.12195122,820,25,845,0,1072,78.82462687
臺南縣,下營鄉,新興村,225,587,67.47126437,283,32.52873563,870,25,895,0,1108,80.77617329
臺南縣,下營鄉,營前村,226,474,59.32415519,325,40.67584481,799,25,824,0,1049,78.55100095
臺南縣,下營鄉,營前村,227,553,64.45221445,305,35.54778555,858,24,882,0,1085,81.29032258
臺南縣,下營鄉,大屯村,228,456,71.25,184,28.75,640,28,668,0,804,83.08457711
臺南縣,下營鄉,大埤村,229,371,61.93656093,228,38.06343907,599,20,619,0,761,81.34034166
臺南縣,下營鄉,茅港村,230,754,76.62601626,230,23.37398374,984,35,1019,0,1218,83.66174056
臺南縣,下營鄉,中營村,231,714,78.46153846,196,21.53846154,910,32,942,0,1140,82.63157895
臺南縣,下營鄉,開化村,232,653,78.20359281,182,21.79640719,835,11,846,0,991,85.36831483
臺南縣,下營鄉,開化村,233,497,73.7388724,177,26.2611276,674,23,697,0,866,80.48498845
臺南縣,下營鄉,西連村,234,581,81.25874126,134,18.74125874,715,20,735,0,891,82.49158249
臺南縣,下營鄉,賀建村,235,750,73.45739471,271,26.54260529,1021,32,1053,0,1328,79.29216867
臺南縣,下營鄉,甲中村,236,756,80,189,20,945,13,958,0,1185,80.84388186
臺南縣,下營鄉,紅厝村,237,816,82.75862069,170,17.24137931,986,47,1033,0,1254,82.37639553
臺南縣,六甲鄉,六甲村,238,775,66.01362862,399,33.98637138,1174,29,1203,0,1466,82.06002729
臺南縣,六甲鄉,六甲村,239,709,66.94995279,350,33.05004721,1059,30,1089,0,1339,81.32935026
臺南縣,六甲鄉,甲東村,240,700,67.11409396,343,32.88590604,1043,36,1079,0,1350,79.92592593
臺南縣,六甲鄉,甲東村,241,670,73.70737074,239,26.29262926,909,35,944,0,1186,79.59527825
臺南縣,六甲鄉,甲南村,242,742,71.34615385,298,28.65384615,1040,21,1061,0,1323,80.19652305
臺南縣,六甲鄉,龍湖村,243,610,74.57212714,208,25.42787286,818,12,830,0,1041,79.73102786
臺南縣,六甲鄉,七甲村,244,555,76.97642164,166,23.02357836,721,22,743,0,883,84.14496036
臺南縣,六甲鄉,二甲村,245,523,72.53814147,198,27.46185853,721,20,741,0,910,81.42857143
臺南縣,六甲鄉,二甲村,246,556,69.67418546,242,30.32581454,798,10,808,0,997,81.04312939
臺南縣,六甲鄉,二甲村,247,569,69.3902439,251,30.6097561,820,30,850,0,1033,82.28460794
臺南縣,六甲鄉,水林村,248,568,69.43765281,250,30.56234719,818,17,835,0,997,83.75125376
臺南縣,六甲鄉,水林村,249,489,65.46184739,258,34.53815261,747,13,760,0,945,80.42328042
臺南縣,六甲鄉,中社村,250,476,77.39837398,139,22.60162602,615,17,632,0,763,82.83093054
臺南縣,六甲鄉,中社村,251,405,63.38028169,234,36.61971831,639,26,665,0,817,81.39534884
臺南縣,六甲鄉,龜港村,252,578,68.72770511,263,31.27229489,841,42,883,0,1093,80.78682525
臺南縣,六甲鄉,菁埔村,253,324,67.08074534,159,32.91925466,483,15,498,0,597,83.41708543
臺南縣,六甲鄉,王爺村,254,461,71.91887676,180,28.08112324,641,37,678,0,840,80.71428571
臺南縣,六甲鄉,大丘村,255,373,68.06569343,175,31.93430657,548,28,576,0,736,78.26086957
臺南縣,官田鄉,官田村,256,499,64.38709677,276,35.61290323,775,33,808,0,963,83.90446521
臺南縣,官田鄉,官田村,257,590,76.52399481,181,23.47600519,771,28,799,0,975,81.94871795
臺南縣,官田鄉,二鎮村,258,852,82.55813953,180,17.44186047,1032,30,1062,0,1281,82.90398126
臺南縣,官田鄉,二鎮村,259,769,80.02081165,192,19.97918835,961,18,979,0,1167,83.89031705
臺南縣,官田鄉,湖山村,260,668,82.98136646,137,17.01863354,805,33,838,0,995,84.22110553
臺南縣,官田鄉,嘉南村,261,150,62.2406639,91,37.7593361,241,2,243,0,317,76.65615142
臺南縣,官田鄉,大崎村,262,278,70.91836735,114,29.08163265,392,18,410,0,482,85.06224066
臺南縣,官田鄉,隆田村,263,423,58.02469136,306,41.97530864,729,29,758,0,917,82.6608506
臺南縣,官田鄉,隆田村,264,419,55.64409031,334,44.35590969,753,19,772,0,918,84.09586057
臺南縣,官田鄉,隆本村,265,381,58.43558282,271,41.56441718,652,26,678,0,826,82.08232446
臺南縣,官田鄉,隆本村,266,456,52.17391304,418,47.82608696,874,25,899,0,1055,85.21327014
臺南縣,官田鄉,隆本村,267,411,49.63768116,417,50.36231884,828,13,841,1,1022,82.28962818
臺南縣,官田鄉,南部村,268,640,73.64787112,229,26.35212888,869,28,897,0,1120,80.08928571
臺南縣,官田鄉,東庄村,269,1134,94.5,66,5.5,1200,62,1262,0,1392,90.66091954
臺南縣,官田鄉,西庄村,270,599,97.55700326,15,2.442996743,614,22,636,0,699,90.98712446
臺南縣,官田鄉,拔林村,271,344,70.34764826,145,29.65235174,489,16,505,0,600,84.16666667
臺南縣,官田鄉,渡頭村,272,451,72.27564103,173,27.72435897,624,28,652,0,786,82.95165394
臺南縣,官田鄉,渡頭村,273,514,75.14619883,170,24.85380117,684,24,708,0,832,85.09615385
臺南縣,官田鄉,渡頭村,274,285,65.06849315,153,34.93150685,438,24,462,0,579,79.79274611
臺南縣,官田鄉,社子村,275,620,84.23913043,116,15.76086957,736,32,768,0,923,83.20693391
臺南縣,大內鄉,石湖村,276,539,81.1746988,125,18.8253012,664,28,692,0,848,81.60377358
臺南縣,大內鄉,石湖村,277,97,46.19047619,113,53.80952381,210,11,221,0,275,80.36363636
臺南縣,大內鄉,石林村,278,476,75.67567568,153,24.32432432,629,26,655,0,791,82.80657396
臺南縣,大內鄉,石城村,279,837,69.75,363,30.25,1200,49,1249,0,1526,81.84796855
臺南縣,大內鄉,內江村,280,564,64.23690205,314,35.76309795,878,37,915,0,1104,82.88043478
臺南縣,大內鄉,大內村,281,454,64.12429379,254,35.87570621,708,18,726,0,846,85.81560284
臺南縣,大內鄉,內郭村,282,392,74.1020794,137,25.8979206,529,42,571,0,702,81.33903134
臺南縣,大內鄉,頭社村,283,570,68.01909308,268,31.98090692,838,34,872,0,1070,81.4953271
臺南縣,大內鄉,環湖村,284,391,55.46099291,314,44.53900709,705,27,732,0,917,79.82551799
臺南縣,大內鄉,二溪村,285,467,65.8674189,242,34.1325811,709,39,748,0,945,79.15343915
臺南縣,大內鄉,曲溪村,286,366,69.18714556,163,30.81285444,529,25,554,0,647,85.625966
臺南縣,佳里鎮,東寧里,287,454,63.4965035,261,36.5034965,715,7,722,0,885,81.5819209
臺南縣,佳里鎮,東寧里,288,462,62.94277929,272,37.05722071,734,18,752,0,897,83.83500557
臺南縣,佳里鎮,忠仁里,289,635,64.99488229,342,35.00511771,977,27,1004,0,1226,81.89233279
臺南縣,佳里鎮,忠仁里,290,802,65.15028432,429,34.84971568,1231,21,1252,0,1555,80.51446945
臺南縣,佳里鎮,鎮山里,291,517,59.90730012,346,40.09269988,863,22,885,0,1091,81.11824015
臺南縣,佳里鎮,鎮山里,292,628,65.41666667,332,34.58333333,960,22,982,1,1219,80.55783429
臺南縣,佳里鎮,鎮山里,293,596,67.88154897,282,32.11845103,878,25,903,0,1113,81.13207547
臺南縣,佳里鎮,鎮山里,294,771,71.85461323,302,28.14538677,1073,22,1095,0,1337,81.89977562
臺南縣,佳里鎮,建南里,295,701,62.20053239,426,37.79946761,1127,20,1147,0,1447,79.2674499
臺南縣,佳里鎮,建南里,296,736,65.48042705,388,34.51957295,1124,19,1143,0,1392,82.11206897
臺南縣,佳里鎮,建南里,297,662,66.66666667,331,33.33333333,993,27,1020,0,1265,80.63241107
臺南縣,佳里鎮,建南里,298,1042,70.6440678,433,29.3559322,1475,31,1506,1,1863,80.8373591
臺南縣,佳里鎮,安西里,299,614,61.83282981,379,38.16717019,993,16,1009,0,1252,80.59105431
臺南縣,佳里鎮,安西里,300,609,61.14457831,387,38.85542169,996,13,1009,0,1236,81.63430421
臺南縣,佳里鎮,安西里,301,650,62.1414914,396,37.8585086,1046,23,1069,0,1314,81.35464231
臺南縣,佳里鎮,安西里,302,896,66.86567164,444,33.13432836,1340,34,1374,0,1688,81.39810427
臺南縣,佳里鎮,安西里,303,614,63.42975207,354,36.57024793,968,5,973,0,1196,81.35451505
臺南縣,佳里鎮,安西里,304,1097,61.38780078,690,38.61219922,1787,30,1817,0,2317,78.42037117
臺南縣,佳里鎮,六安里,305,595,69.83568075,257,30.16431925,852,12,864,0,1065,81.12676056
臺南縣,佳里鎮,六安里,306,529,61.79906542,327,38.20093458,856,18,874,0,1089,80.25711662
臺南縣,佳里鎮,六安里,307,503,54.37837838,422,45.62162162,925,12,937,0,1162,80.63683305
臺南縣,佳里鎮,佳化里,308,537,65.48780488,283,34.51219512,820,15,835,0,996,83.83534137
臺南縣,佳里鎮,佳化里,309,566,78.28492393,157,21.71507607,723,23,746,0,921,80.99891422
臺南縣,佳里鎮,禮化里,310,487,71.61764706,193,28.38235294,680,29,709,0,849,83.51001178
臺南縣,佳里鎮,興化里,311,787,73.4141791,285,26.5858209,1072,37,1109,0,1335,83.07116105
臺南縣,佳里鎮,營頂里,312,355,63.62007168,203,36.37992832,558,15,573,0,701,81.7403709
臺南縣,佳里鎮,溪洲里,313,190,65.51724138,100,34.48275862,290,18,308,0,398,77.38693467
臺南縣,佳里鎮,海澄里,314,764,71.80451128,300,28.19548872,1064,28,1092,0,1361,80.23512123
臺南縣,佳里鎮,漳洲里,315,395,70.03546099,169,29.96453901,564,7,571,0,687,83.11499272
臺南縣,佳里鎮,頂部里,316,426,63.67713004,243,36.32286996,669,17,686,0,850,80.70588235
臺南縣,佳里鎮,嘉福里,317,563,74.27440633,195,25.72559367,758,32,790,0,973,81.19218911
臺南縣,佳里鎮,通興里,318,628,74.58432304,214,25.41567696,842,37,879,1,1096,80.20072993
臺南縣,佳里鎮,蚶寮里,319,535,80.08982036,133,19.91017964,668,22,690,1,828,83.33333333
臺南縣,佳里鎮,龍安里,320,597,72.10144928,231,27.89855072,828,29,857,0,981,87.3598369
臺南縣,佳里鎮,民安里,321,771,76.79282869,233,23.20717131,1004,48,1052,0,1292,81.42414861
臺南縣,佳里鎮,子龍里,322,468,79.45670628,121,20.54329372,589,28,617,0,765,80.65359477
臺南縣,佳里鎮,子龍里,323,477,76.32,148,23.68,625,16,641,0,773,82.923674
臺南縣,佳里鎮,三協里,324,547,76.5034965,168,23.4965035,715,15,730,0,879,83.04891923
臺南縣,學甲鎮,一秀里,325,409,69.55782313,179,30.44217687,588,13,601,0,744,80.77956989
臺南縣,學甲鎮,一秀里,326,295,70.74340528,122,29.25659472,417,10,427,1,524,81.48854962
臺南縣,學甲鎮,西明里,327,806,77.27708533,237,22.72291467,1043,6,1049,0,1306,80.32159265
臺南縣,學甲鎮,宜民里,328,273,66.26213592,139,33.73786408,412,4,416,0,513,81.09161793
臺南縣,學甲鎮,煥昌里,329,500,69.63788301,218,30.36211699,718,14,732,0,927,78.96440129
臺南縣,學甲鎮,慈生里,330,286,59.95807128,191,40.04192872,477,13,490,0,602,81.39534884
臺南縣,學甲鎮,仁得里,331,648,67.71159875,309,32.28840125,957,20,977,0,1215,80.41152263
臺南縣,學甲鎮,仁得里,332,554,68.14268143,259,31.85731857,813,10,823,0,1009,81.56590684
臺南縣,學甲鎮,仁得里,333,789,71.27371274,318,28.72628726,1107,20,1127,0,1370,82.26277372
臺南縣,學甲鎮,新生里,334,734,63.49480969,422,36.50519031,1156,11,1167,0,1482,78.74493927
臺南縣,學甲鎮,百福里,335,442,68.42105263,204,31.57894737,646,21,667,0,820,81.34146341
臺南縣,學甲鎮,百福里,336,295,69.08665105,132,30.91334895,427,14,441,0,562,78.46975089
臺南縣,學甲鎮,新榮里,337,354,67.17267552,173,32.82732448,527,11,538,0,690,77.97101449
臺南縣,學甲鎮,新榮里,338,470,72.19662058,181,27.80337942,651,14,665,0,807,82.4039653
臺南縣,學甲鎮,文化里,339,324,74.82678984,109,25.17321016,433,16,449,0,560,80.17857143
臺南縣,學甲鎮,大安里,340,298,71.29186603,120,28.70813397,418,12,430,0,536,80.2238806
臺南縣,學甲鎮,美豐里,341,517,75.6954612,166,24.3045388,683,35,718,0,881,81.49829739
臺南縣,學甲鎮,美和里,342,230,80.98591549,54,19.01408451,284,3,287,0,339,84.66076696
臺南縣,學甲鎮,達明里,343,420,81.55339806,95,18.44660194,515,15,530,0,651,81.41321045
臺南縣,學甲鎮,光明里,344,194,71.85185185,76,28.14814815,270,6,276,0,333,82.88288288
臺南縣,學甲鎮,民吉里,345,239,69.47674419,105,30.52325581,344,8,352,0,431,81.67053364
臺南縣,學甲鎮,西進里,346,278,79.65616046,71,20.34383954,349,23,372,0,482,77.17842324
臺南縣,學甲鎮,白渚里,347,188,71.21212121,76,28.78787879,264,4,268,0,337,79.52522255
臺南縣,學甲鎮,光華里,348,368,81.05726872,86,18.94273128,454,11,465,0,585,79.48717949
臺南縣,學甲鎮,光華里,349,191,76.4,59,23.6,250,6,256,0,317,80.75709779
臺南縣,學甲鎮,頭港里,350,258,77.01492537,77,22.98507463,335,8,343,0,440,77.95454545
臺南縣,學甲鎮,宅港里,351,669,79.3594306,174,20.6405694,843,28,871,0,1093,79.68892955
臺南縣,學甲鎮,平東里,352,324,85.94164456,53,14.05835544,377,16,393,0,479,82.04592902
臺南縣,學甲鎮,平西里,353,451,84.61538462,82,15.38461538,533,19,552,0,686,80.4664723
臺南縣,學甲鎮,頂洲里,354,367,68.85553471,166,31.14446529,533,10,543,0,675,80.44444444
臺南縣,學甲鎮,紅茄里,355,222,66.26865672,113,33.73134328,335,20,355,0,490,72.44897959
臺南縣,學甲鎮,新芳里,356,274,77.40112994,80,22.59887006,354,18,372,0,452,82.30088496
臺南縣,西港鄉,西港村,357,453,63.62359551,259,36.37640449,712,11,723,0,864,83.68055556
臺南縣,西港鄉,西港村,358,479,71.2797619,193,28.7202381,672,17,689,0,810,85.0617284
臺南縣,西港鄉,西港村,359,661,75.11363636,219,24.88636364,880,21,901,0,1120,80.44642857
臺南縣,西港鄉,南海村,363,762,73.05848514,281,26.94151486,1043,26,1069,1,1305,81.91570881
臺南縣,西港鄉,南海村,364,470,84.99095841,83,15.00904159,553,4,557,0,647,86.08964451
臺南縣,西港鄉,南海村,376,321,55.72916667,255,44.27083333,576,20,596,0,751,79.3608522
臺南縣,西港鄉,港東村,365,536,67.33668342,260,32.66331658,796,23,819,0,998,82.06412826
臺南縣,西港鄉,港東村,366,246,77.60252366,71,22.39747634,317,9,326,1,391,83.37595908
臺南縣,西港鄉,檨林村,367,456,74.38825449,157,25.61174551,613,16,629,0,748,84.09090909
臺南縣,西港鄉,檨林村,368,497,77.05426357,148,22.94573643,645,27,672,0,807,83.27137546
臺南縣,西港鄉,後營村,369,807,75,269,25,1076,38,1114,0,1354,82.27474151
臺南縣,西港鄉,營西村,370,735,71.2900097,296,28.7099903,1031,39,1070,0,1324,80.81570997
臺南縣,西港鄉,金砂村,371,493,72.5,187,27.5,680,26,706,0,823,85.7837181
臺南縣,西港鄉,劉厝村,372,721,74.8701973,242,25.1298027,963,31,994,0,1184,83.9527027
臺南縣,西港鄉,竹林村,373,747,77.57009346,216,22.42990654,963,37,1000,0,1187,84.24599832
臺南縣,西港鄉,永樂村,374,520,74.49856734,178,25.50143266,698,32,730,0,881,82.86038593
臺南縣,西港鄉,永樂村,376,321,55.72916667,255,44.27083333,576,20,596,0,751,79.3608522
臺南縣,西港鄉,新復村,375,265,81.53846154,60,18.46153846,325,6,331,0,397,83.37531486
臺南縣,西港鄉,新復村,376,321,55.72916667,255,44.27083333,576,20,596,0,751,79.3608522
臺南縣,西港鄉,慶安村,360,666,64.66019417,364,35.33980583,1030,27,1057,0,1307,80.87222647
臺南縣,西港鄉,慶安村,361,502,66.13965744,257,33.86034256,759,17,776,0,941,82.46546227
臺南縣,西港鄉,慶安村,362,745,67.35985533,361,32.64014467,1106,17,1123,0,1387,80.96611391
臺南縣,七股鄉,後港村,377,331,73.2300885,121,26.7699115,452,5,457,0,559,81.75313059
臺南縣,七股鄉,大潭村,378,368,68.78504673,167,31.21495327,535,22,557,0,725,76.82758621
臺南縣,七股鄉,城內村,379,324,79.41176471,84,20.58823529,408,11,419,0,508,82.48031496
臺南縣,七股鄉,篤加村,380,502,74.92537313,168,25.07462687,670,23,693,0,854,81.14754098
臺南縣,七股鄉,頂山村,381,561,73.91304348,198,26.08695652,759,20,779,0,944,82.52118644
臺南縣,七股鄉,西寮村,382,293,61.68421053,182,38.31578947,475,14,489,0,616,79.38311688
臺南縣,七股鄉,鹽埕村,383,211,60.80691643,136,39.19308357,347,10,357,0,443,80.58690745
臺南縣,七股鄉,龍山村,385,485,76.74050633,147,23.25949367,632,26,658,1,806,81.63771712
臺南縣,七股鄉,龍山村,386,563,77.76243094,161,22.23756906,724,27,751,0,915,82.07650273
臺南縣,七股鄉,溪南村,387,173,61.13074205,110,38.86925795,283,3,286,0,348,82.18390805
臺南縣,七股鄉,七股村,388,545,79.91202346,137,20.08797654,682,22,704,0,883,79.72819932
臺南縣,七股鄉,玉成村,389,472,70.23809524,200,29.76190476,672,24,696,0,854,81.49882904
臺南縣,七股鄉,大埕村,390,747,68.78453039,339,31.21546961,1086,32,1118,0,1408,79.40340909
臺南縣,七股鄉,大寮村,391,558,74.59893048,190,25.40106952,748,30,778,0,959,81.1261731
臺南縣,七股鄉,看坪村,392,393,79.55465587,101,20.44534413,494,16,510,0,620,82.25806452
臺南縣,七股鄉,樹林村,393,609,73.37349398,221,26.62650602,830,26,856,0,1036,82.62548263
臺南縣,七股鄉,竹港村,394,345,73.40425532,125,26.59574468,470,19,489,0,576,84.89583333
臺南縣,七股鄉,中寮村,384,376,63.94557823,212,36.05442177,588,25,613,0,789,77.69328264
臺南縣,七股鄉,竹橋村,395,432,72.36180905,165,27.63819095,597,18,615,0,735,83.67346939
臺南縣,七股鄉,義合村,396,605,72.80385078,226,27.19614922,831,37,868,0,1051,82.58801142
臺南縣,七股鄉,康榔村,397,402,73.62637363,144,26.37362637,546,15,561,0,682,82.25806452
臺南縣,七股鄉,永吉村,398,432,63.71681416,246,36.28318584,678,41,719,0,923,77.89815818
臺南縣,七股鄉,三股村,399,676,57.43415463,501,42.56584537,1177,86,1263,0,1651,76.49909146
臺南縣,七股鄉,十份村,400,713,70.45454545,299,29.54545455,1012,38,1050,0,1332,78.82882883
臺南縣,將軍鄉,長榮村,401,514,67.63157895,246,32.36842105,760,31,791,0,962,82.22453222
臺南縣,將軍鄉,西華村,402,710,68.79844961,322,31.20155039,1032,31,1063,0,1349,78.79911045
臺南縣,將軍鄉,西和村,403,608,75.43424318,198,24.56575682,806,7,813,0,1035,78.55072464
臺南縣,將軍鄉,忠興村,404,252,63.15789474,147,36.84210526,399,13,412,0,506,81.4229249
臺南縣,將軍鄉,忠興村,405,520,67.62028609,249,32.37971391,769,25,794,0,990,80.2020202
臺南縣,將軍鄉,嘉昌村,406,369,79.18454936,97,20.81545064,466,18,484,0,578,83.73702422
臺南縣,將軍鄉,嘉昌村,407,190,72.24334601,73,27.75665399,263,10,273,0,330,82.72727273
臺南縣,將軍鄉,保源村,408,326,70.56277056,136,29.43722944,462,11,473,0,590,80.16949153
臺南縣,將軍鄉,保源村,409,275,77.46478873,80,22.53521127,355,23,378,0,453,83.44370861
臺南縣,將軍鄉,苓和村,410,346,68.51485149,159,31.48514851,505,21,526,0,668,78.74251497
臺南縣,將軍鄉,苓和村,411,232,73.88535032,82,26.11464968,314,8,322,0,406,79.31034483
臺南縣,將軍鄉,仁和村,412,452,79.29824561,118,20.70175439,570,23,593,0,764,77.61780105
臺南縣,將軍鄉,北埔村,413,409,78.65384615,111,21.34615385,520,22,542,0,631,85.89540412
臺南縣,將軍鄉,將富村,414,402,75.70621469,129,24.29378531,531,19,550,0,713,77.13884993
臺南縣,將軍鄉,將貴村,415,234,75,78,25,312,3,315,0,395,79.74683544
臺南縣,將軍鄉,將貴村,416,118,68.20809249,55,31.79190751,173,5,178,0,214,83.17757009
臺南縣,將軍鄉,三吉村,417,212,67.3015873,103,32.6984127,315,12,327,0,435,75.17241379
臺南縣,將軍鄉,玉山村,418,567,84,108,16,675,36,711,0,897,79.26421405
臺南縣,將軍鄉,廣山村,419,388,74.1873805,135,25.8126195,523,35,558,1,696,80.17241379
臺南縣,將軍鄉,長沙村,420,480,78.43137255,132,21.56862745,612,2,614,0,821,74.78684531
臺南縣,將軍鄉,長沙村,421,351,72.07392197,136,27.92607803,487,19,506,0,642,78.81619938
臺南縣,將軍鄉,平沙村,422,750,79.53340403,193,20.46659597,943,27,970,0,1286,75.42768274
臺南縣,將軍鄉,鯤鯓村,423,494,77.42946708,144,22.57053292,638,25,663,0,880,75.34090909
臺南縣,將軍鄉,鯤鯓村,424,641,71.14317425,260,28.85682575,901,28,929,0,1176,78.99659864
臺南縣,將軍鄉,鯤溟村,425,590,77.42782152,172,22.57217848,762,23,785,0,1018,77.11198428
臺南縣,北門鄉,保吉村,432,388,62.78317152,230,37.21682848,618,20,638,1,803,79.45205479
臺南縣,北門鄉,保吉村,433,249,60.14492754,165,39.85507246,414,9,423,0,531,79.66101695
臺南縣,北門鄉,雙春村,437,282,64.67889908,154,35.32110092,436,15,451,0,603,74.79270315
臺南縣,北門鄉,東壁村,434,370,63.46483705,213,36.53516295,583,19,602,0,774,77.77777778
臺南縣,北門鄉,鯤江村,435,198,67.11864407,97,32.88135593,295,6,301,0,401,75.06234414
臺南縣,北門鄉,鯤江村,436,228,77.81569966,65,22.18430034,293,3,296,0,373,79.35656836
臺南縣,北門鄉,北門村,426,290,67.44186047,140,32.55813953,430,5,435,0,532,81.76691729
臺南縣,北門鄉,北門村,427,152,51.00671141,146,48.99328859,298,12,310,0,387,80.10335917
臺南縣,北門鄉,錦湖村,438,543,71.07329843,221,28.92670157,764,36,800,0,1069,74.8362956
臺南縣,北門鄉,三光村,440,305,64.21052632,170,35.78947368,475,17,492,0,651,75.57603687
臺南縣,北門鄉,三光村,441,332,81.57248157,75,18.42751843,407,3,410,0,517,79.30367505
臺南縣,北門鄉,仁里村,443,390,72.08872458,151,27.91127542,541,26,567,0,709,79.97179126
臺南縣,北門鄉,玉港村,430,266,75.35410765,87,24.64589235,353,17,370,0,471,78.55626327
臺南縣,北門鄉,玉港村,431,180,76.27118644,56,23.72881356,236,13,249,0,323,77.08978328
臺南縣,北門鄉,中樞村,442,406,78.37837838,112,21.62162162,518,30,548,0,718,76.32311978
臺南縣,北門鄉,慈安村,439,295,60.45081967,193,39.54918033,488,15,503,0,680,73.97058824
臺南縣,北門鄉,永華村,429,207,65.29968454,110,34.70031546,317,8,325,0,395,82.27848101
臺南縣,北門鄉,永隆村,428,162,40.80604534,235,59.19395466,397,13,410,0,528,77.65151515
臺南縣,新化鎮,武安里,444,282,51.45985401,266,48.54014599,548,17,565,0,709,79.68970381
臺南縣,新化鎮,武安里,445,410,54.16116248,347,45.83883752,757,25,782,0,936,83.54700855
臺南縣,新化鎮,東榮里,446,620,57.8898226,451,42.1101774,1071,6,1077,0,1368,78.72807018
臺南縣,新化鎮,東榮里,447,597,55.63839702,476,44.36160298,1073,28,1101,0,1349,81.61601186
臺南縣,新化鎮,東榮里,448,465,52.90102389,414,47.09897611,879,11,890,0,1114,79.89228007
臺南縣,新化鎮,護國里,449,315,49.29577465,324,50.70422535,639,14,653,0,801,81.52309613
臺南縣,新化鎮,護國里,450,230,44.74708171,284,55.25291829,514,12,526,0,852,61.7370892
臺南縣,新化鎮,太平里,451,522,61.1957796,331,38.8042204,853,15,868,0,1076,80.66914498
臺南縣,新化鎮,太平里,452,356,53.61445783,308,46.38554217,664,19,683,0,862,79.23433875
臺南縣,新化鎮,太平里,453,554,65.71767497,289,34.28232503,843,13,856,0,1055,81.13744076
臺南縣,新化鎮,太平里,454,400,62.4024961,241,37.5975039,641,25,666,0,808,82.42574257
臺南縣,新化鎮,中央里,455,197,55.96590909,155,44.03409091,352,7,359,0,436,82.33944954
臺南縣,新化鎮,觀音里,456,262,55.39112051,211,44.60887949,473,13,486,0,607,80.06589786
臺南縣,新化鎮,竹林里,457,214,59.44444444,146,40.55555556,360,11,371,0,443,83.74717833
臺南縣,新化鎮,清水里,458,488,60.92384519,313,39.07615481,801,20,821,0,983,83.51983723
臺南縣,新化鎮,協興里,459,417,64.55108359,229,35.44891641,646,27,673,0,845,79.64497041
臺南縣,新化鎮,協興里,460,490,54.6875,406,45.3125,896,20,916,0,1115,82.15246637
臺南縣,新化鎮,協興里,461,459,54.64285714,381,45.35714286,840,16,856,0,1057,80.98391675
臺南縣,新化鎮,唪口里,462,407,58.64553314,287,41.35446686,694,7,701,0,832,84.25480769
臺南縣,新化鎮,唪口里,463,480,68.57142857,220,31.42857143,700,21,721,0,864,83.44907407
臺南縣,新化鎮,北勢里,464,577,61.12288136,367,38.87711864,944,10,954,0,1175,81.19148936
臺南縣,新化鎮,豐榮里,465,402,54.32432432,338,45.67567568,740,23,763,0,924,82.57575758
臺南縣,新化鎮,豐榮里,466,256,55.41125541,206,44.58874459,462,19,481,0,612,78.59477124
臺南縣,新化鎮,豐榮里,467,420,57.06521739,316,42.93478261,736,15,751,0,930,80.75268817
臺南縣,新化鎮,全興里,468,247,60.0973236,164,39.9026764,411,18,429,0,543,79.00552486
臺南縣,新化鎮,全興里,469,290,64.15929204,162,35.84070796,452,12,464,0,547,84.82632541
臺南縣,新化鎮,全興里,470,391,49.18238994,404,50.81761006,795,11,806,0,950,84.84210526
臺南縣,新化鎮,崙頂里,471,507,65.67357513,265,34.32642487,772,36,808,0,935,86.4171123
臺南縣,新化鎮,崙頂里,472,427,67.45655608,206,32.54344392,633,25,658,0,818,80.4400978
臺南縣,新化鎮,知義里,473,571,64.96018203,308,35.03981797,879,32,911,0,1082,84.19593346
臺南縣,新化鎮,知義里,474,398,50.89514066,384,49.10485934,782,37,819,0,1053,77.77777778
臺南縣,新化鎮,山腳里,475,640,60.8365019,412,39.1634981,1052,28,1080,0,1325,81.50943396
臺南縣,新化鎮,大坑里,476,233,66.00566572,120,33.99433428,353,29,382,0,481,79.41787942
臺南縣,新化鎮,那拔里,477,485,60.625,315,39.375,800,24,824,0,1027,80.23369036
臺南縣,新化鎮,那拔里,478,440,54.18719212,372,45.81280788,812,32,844,0,1034,81.62475822
臺南縣,新化鎮,羊林里,479,393,62.88,232,37.12,625,22,647,1,845,76.56804734
臺南縣,新化鎮,礁坑里,480,618,78.03030303,174,21.96969697,792,43,835,0,1041,80.21133525
臺南縣,善化鎮,東關里,481,504,65.36964981,267,34.63035019,771,8,779,0,938,83.04904051
臺南縣,善化鎮,坐駕里,482,584,57.59368836,430,42.40631164,1014,25,1039,0,1251,83.05355715
臺南縣,善化鎮,坐駕里,483,754,62.52072968,452,37.47927032,1206,37,1243,0,1508,82.4270557
臺南縣,善化鎮,光文里,484,558,62.90868095,329,37.09131905,887,23,910,1,1132,80.38869258
臺南縣,善化鎮,光文里,485,708,58.95087427,493,41.04912573,1201,22,1223,0,1506,81.20849934
臺南縣,善化鎮,光文里,486,749,59.02285264,520,40.97714736,1269,19,1288,0,1563,82.4056302
臺南縣,善化鎮,文昌里,487,495,63.62467866,283,36.37532134,778,16,794,0,984,80.69105691
臺南縣,善化鎮,文昌里,488,577,63.75690608,328,36.24309392,905,18,923,0,1171,78.82152007
臺南縣,善化鎮,南關里,489,753,75.90725806,239,24.09274194,992,33,1025,0,1263,81.15597783
臺南縣,善化鎮,西關里,490,324,61.36363636,204,38.63636364,528,23,551,0,682,80.79178886
臺南縣,善化鎮,北關里,491,228,63.86554622,129,36.13445378,357,4,361,0,439,82.23234624
臺南縣,善化鎮,文正里,492,636,70.58823529,265,29.41176471,901,34,935,0,1215,76.95473251
臺南縣,善化鎮,胡家里,493,814,84.09090909,154,15.90909091,968,46,1014,0,1247,81.31515638
臺南縣,善化鎮,胡厝里,494,823,79.67086157,210,20.32913843,1033,12,1045,0,1269,82.34830575
臺南縣,善化鎮,胡厝里,495,65,13.51351351,416,86.48648649,481,27,508,0,624,81.41025641
臺南縣,善化鎮,什乃里,496,524,72.77777778,196,27.22222222,720,37,757,0,895,84.58100559
臺南縣,善化鎮,溪美里,497,503,68.80984952,228,31.19015048,731,5,736,0,883,83.35220838
臺南縣,善化鎮,溪美里,498,379,65.68457539,198,34.31542461,577,21,598,0,712,83.98876404
臺南縣,善化鎮,六分里,499,387,72.7443609,145,27.2556391,532,22,554,0,679,81.59057437
臺南縣,善化鎮,六德里,500,618,74.54764777,211,25.45235223,829,16,845,0,1057,79.94323557
臺南縣,善化鎮,田寮里,501,444,76.816609,134,23.183391,578,18,596,0,729,81.7558299
臺南縣,善化鎮,田寮里,502,591,70.6937799,245,29.3062201,836,30,866,0,1033,83.83349468
臺南縣,善化鎮,東隆里,503,501,70.56338028,209,29.43661972,710,25,735,0,866,84.87297921
臺南縣,善化鎮,東昌里,504,593,74.59119497,202,25.40880503,795,32,827,0,984,84.04471545
臺南縣,善化鎮,牛庄里,505,735,67.30769231,357,32.69230769,1092,52,1144,0,1379,82.9586657
臺南縣,善化鎮,嘉北里,506,870,76.44991213,268,23.55008787,1138,49,1187,0,1388,85.51873199
臺南縣,善化鎮,嘉南里,507,607,75.3101737,199,24.6898263,806,23,829,0,1028,80.64202335
臺南縣,善化鎮,小新里,508,735,70.80924855,303,29.19075145,1038,33,1071,0,1295,82.7027027
臺南縣,善化鎮,小新里,509,726,61.31756757,458,38.68243243,1184,37,1221,0,1515,80.59405941
臺南縣,新市鄉,新市村,510,493,68.95104895,222,31.04895105,715,21,736,0,909,80.96809681
臺南縣,新市鄉,新市村,511,374,62.54180602,224,37.45819398,598,6,604,0,718,84.12256267
臺南縣,新市鄉,新市村,512,440,62.94706724,259,37.05293276,699,14,713,0,863,82.61877173
臺南縣,新市鄉,新和村,513,536,64.89104116,290,35.10895884,826,22,848,0,1043,81.30393097
臺南縣,新市鄉,新和村,514,582,63.39869281,336,36.60130719,918,18,936,0,1119,83.6461126
臺南縣,新市鄉,新和村,515,386,58.22021116,277,41.77978884,663,12,675,0,807,83.64312268
臺南縣,新市鄉,新和村,516,581,63.35877863,336,36.64122137,917,18,935,0,1121,83.40767172
臺南縣,新市鄉,新和村,517,651,65.23046092,347,34.76953908,998,22,1020,0,1254,81.33971292
臺南縣,新市鄉,社內村,518,484,71.17647059,196,28.82352941,680,19,699,0,852,82.04225352
臺南縣,新市鄉,社內村,519,709,78.25607064,197,21.74392936,906,39,945,0,1107,85.36585366
臺南縣,新市鄉,大洲村,520,389,73.39622642,141,26.60377358,530,17,547,0,648,84.41358025
臺南縣,新市鄉,豊華村,521,461,65.39007092,244,34.60992908,705,16,721,0,889,81.1023622
臺南縣,新市鄉,三舍村,522,665,69.77964323,288,30.22035677,953,38,991,0,1162,85.28399312
臺南縣,新市鄉,大營村,523,508,59.13853318,351,40.86146682,859,28,887,0,1069,82.97474275
臺南縣,新市鄉,大營村,524,351,65.24163569,187,34.75836431,538,18,556,0,666,83.48348348
臺南縣,新市鄉,大營村,525,333,59.35828877,228,40.64171123,561,18,579,0,683,84.77306003
臺南縣,新市鄉,大社村,526,635,73.92316647,224,26.07683353,859,26,885,0,1059,83.5694051
臺南縣,新市鄉,大社村,527,657,72.51655629,249,27.48344371,906,7,913,0,1111,82.17821782
臺南縣,新市鄉,大社村,528,716,73.28556807,261,26.71443193,977,39,1016,0,1225,82.93877551
臺南縣,新市鄉,潭頂村,529,414,67.98029557,195,32.01970443,609,13,622,0,738,84.28184282
臺南縣,新市鄉,潭頂村,530,414,65.61014263,217,34.38985737,631,31,662,0,788,84.01015228
臺南縣,新市鄉,港墘村,531,381,62.15334421,232,37.84665579,613,13,626,0,769,81.40442133
臺南縣,新市鄉,港墘村,532,621,69.54087346,272,30.45912654,893,39,932,0,1117,83.43777977
臺南縣,新市鄉,港墘村,533,569,68.30732293,264,31.69267707,833,32,865,0,1043,82.93384468
臺南縣,新市鄉,永就村,534,262,68.94736842,118,31.05263158,380,16,396,0,458,86.4628821
臺南縣,新市鄉,永就村,535,479,64.29530201,266,35.70469799,745,7,752,0,948,79.32489451
臺南縣,新市鄉,永就村,536,436,62.19686163,265,37.80313837,701,23,724,0,855,84.67836257
臺南縣,安定鄉,蘇林村,537,661,69.79936642,286,30.20063358,947,34,981,0,1204,81.47840532
臺南縣,安定鄉,蘇林村,538,468,69.95515695,201,30.04484305,669,23,692,0,858,80.65268065
臺南縣,安定鄉,蘇厝村,539,555,71.79818887,218,28.20181113,773,38,811,0,982,82.58655804
臺南縣,安定鄉,蘇厝村,540,451,69.38461538,199,30.61538462,650,30,680,0,817,83.23133415
臺南縣,安定鄉,安定村,541,760,68.96551724,342,31.03448276,1102,35,1137,0,1355,83.91143911
臺南縣,安定鄉,安加村,542,682,74.21109902,237,25.78890098,919,51,970,0,1138,85.23725835
臺南縣,安定鄉,保西村,543,386,60.6918239,250,39.3081761,636,18,654,0,765,85.49019608
臺南縣,安定鄉,港尾村,544,424,69.05537459,190,30.94462541,614,23,637,0,763,83.48623853
臺南縣,安定鄉,港尾村,545,350,61.83745583,216,38.16254417,566,26,592,0,723,81.88105118
臺南縣,安定鄉,中榮村,546,593,74.125,207,25.875,800,42,842,0,1020,82.54901961
臺南縣,安定鄉,港口村,547,470,59.56907478,319,40.43092522,789,33,822,0,1025,80.19512195
臺南縣,安定鄉,港口村,548,671,69.10401648,300,30.89598352,971,18,989,0,1183,83.60101437
臺南縣,安定鄉,港南村,549,649,67.114788,318,32.885212,967,31,998,0,1228,81.27035831
臺南縣,安定鄉,港南村,550,510,64.47534766,281,35.52465234,791,28,819,0,978,83.74233129
臺南縣,安定鄉,大同村,551,309,60.46966732,202,39.53033268,511,15,526,0,634,82.96529968
臺南縣,安定鄉,六嘉村,552,836,72.88578901,311,27.11421099,1147,41,1188,0,1388,85.5907781
臺南縣,安定鄉,中沙村,553,379,65.68457539,198,34.31542461,577,23,600,0,695,86.33093525
臺南縣,安定鄉,新吉村,554,549,70.11494253,234,29.88505747,783,25,808,0,987,81.86423506
臺南縣,安定鄉,新吉村,555,488,72.8358209,182,27.1641791,670,33,703,0,861,81.64924506
臺南縣,安定鄉,海寮村,556,550,62.21719457,334,37.78280543,884,35,919,0,1112,82.64388489
臺南縣,安定鄉,海寮村,557,555,63.50114416,319,36.49885584,874,41,915,0,1117,81.91584602
臺南縣,安定鄉,管寮村,558,581,76.04712042,183,23.95287958,764,21,785,0,915,85.79234973
臺南縣,安定鄉,南安村,559,283,65.81395349,147,34.18604651,430,19,449,0,506,88.73517787
臺南縣,山上鄉,明和村,560,520,70.65217391,216,29.34782609,736,8,744,0,870,85.51724138
臺南縣,山上鄉,明和村,561,437,63.24167873,254,36.75832127,691,36,727,0,903,80.50941307
臺南縣,山上鄉,南洲村,562,361,58.5089141,256,41.4910859,617,26,643,0,751,85.61917443
臺南縣,山上鄉,南洲村,563,480,73.17073171,176,26.82926829,656,33,689,0,800,86.125
臺南縣,山上鄉,山上村,564,425,65.99378882,219,34.00621118,644,28,672,0,866,77.59815242
臺南縣,山上鄉,新莊村,565,407,70.17241379,173,29.82758621,580,23,603,0,757,79.65653897
臺南縣,山上鄉,玉峰村,566,273,63.93442623,154,36.06557377,427,28,455,0,572,79.54545455
臺南縣,山上鄉,平陽村,567,148,53.42960289,129,46.57039711,277,13,290,0,359,80.77994429
臺南縣,山上鄉,豐德村,568,209,68.75,95,31.25,304,8,312,0,379,82.32189974
臺南縣,玉井鄉,玉井村,569,303,42.2005571,415,57.7994429,718,20,738,0,912,80.92105263
臺南縣,玉井鄉,玉田村,570,508,46.39269406,587,53.60730594,1095,26,1121,0,1404,79.84330484
臺南縣,玉井鄉,玉田村,571,542,54.25425425,457,45.74574575,999,29,1028,0,1275,80.62745098
臺南縣,玉井鄉,玉田村,572,558,51.52354571,525,48.47645429,1083,60,1143,0,1424,80.26685393
臺南縣,玉井鄉,中正村,573,577,58.34175935,412,41.65824065,989,41,1030,0,1275,80.78431373
臺南縣,玉井鄉,竹圍村,574,580,55.18553758,471,44.81446242,1051,42,1093,0,1405,77.79359431
臺南縣,玉井鄉,沙田村,575,189,49.09090909,196,50.90909091,385,26,411,0,505,81.38613861
臺南縣,玉井鄉,三埔村,576,203,55.3133515,164,44.6866485,367,12,379,0,511,74.16829746
臺南縣,玉井鄉,三和村,577,335,54.82815057,276,45.17184943,611,30,641,0,771,83.1387808
臺南縣,玉井鄉,望明村,578,270,51.13636364,258,48.86363636,528,20,548,0,681,80.46989721
臺南縣,玉井鄉,望明村,579,420,60.60606061,273,39.39393939,693,24,717,0,893,80.29115342
臺南縣,玉井鄉,層林村,580,282,50.44722719,277,49.55277281,559,17,576,0,694,82.99711816
臺南縣,玉井鄉,豐里村,581,423,54.51030928,353,45.48969072,776,38,814,0,1002,81.23752495
臺南縣,楠西鄉,楠西村,582,328,46.00280505,385,53.99719495,713,25,738,0,965,76.47668394
臺南縣,楠西鄉,楠西村,583,291,41.15983027,416,58.84016973,707,30,737,0,938,78.57142857
臺南縣,楠西鄉,灣丘村,584,447,47.75641026,489,52.24358974,936,50,986,0,1272,77.51572327
臺南縣,楠西鄉,密枝村,585,260,41.86795491,361,58.13204509,621,20,641,0,837,76.58303465
臺南縣,楠西鄉,照興村,586,360,46.99738903,406,53.00261097,766,46,812,0,1058,76.74858223
臺南縣,楠西鄉,鹿田村,587,363,46.24203822,422,53.75796178,785,24,809,0,1008,80.25793651
臺南縣,楠西鄉,龜丹村,588,293,51.49384886,276,48.50615114,569,18,587,0,719,81.64116829
臺南縣,楠西鄉,東勢村,589,346,40.70588235,504,59.29411765,850,23,873,0,1069,81.66510758
臺南縣,楠西鄉,東勢村,590,425,47.80652418,464,52.19347582,889,25,914,0,1186,77.06576728
臺南縣,南化鄉,南化村,591,309,54.78723404,255,45.21276596,564,10,574,0,700,82
臺南縣,南化鄉,南化村,592,295,55.87121212,233,44.12878788,528,20,548,0,676,81.06508876
臺南縣,南化鄉,小崙村,593,311,50.48701299,305,49.51298701,616,17,633,0,795,79.62264151
臺南縣,南化鄉,中坑村,595,216,54.27135678,182,45.72864322,398,15,413,0,502,82.27091633
臺南縣,南化鄉,北平村,596,292,60.20618557,193,39.79381443,485,14,499,0,595,83.86554622
臺南縣,南化鄉,東和村,594,247,50.6147541,241,49.3852459,488,21,509,0,656,77.59146341
臺南縣,南化鄉,西埔村,597,332,54.42622951,278,45.57377049,610,18,628,1,796,78.89447236
臺南縣,南化鄉,北寮村,598,400,43.71584699,515,56.28415301,915,36,951,0,1199,79.31609675
臺南縣,南化鄉,玉山村,599,362,54.27286357,305,45.72713643,667,31,698,0,893,78.16349384
臺南縣,南化鄉,關山村,600,201,53.17460317,177,46.82539683,378,3,381,0,549,69.3989071
臺南縣,左鎮鄉,光和村,601,186,57.58513932,137,42.41486068,323,10,333,0,422,78.90995261
臺南縣,左鎮鄉,榮和村,602,368,68.65671642,168,31.34328358,536,23,559,0,693,80.66378066
臺南縣,左鎮鄉,左鎮村,603,266,63.63636364,152,36.36363636,418,13,431,0,523,82.40917782
臺南縣,左鎮鄉,中正村,604,372,56.02409639,292,43.97590361,664,19,683,0,864,79.05092593
臺南縣,左鎮鄉,睦光村,605,189,62.17105263,115,37.82894737,304,5,309,0,379,81.53034301
臺南縣,左鎮鄉,內庄村,606,189,54.46685879,158,45.53314121,347,32,379,0,469,80.81023454
臺南縣,左鎮鄉,澄山村,610,307,73.79807692,109,26.20192308,416,17,433,0,554,78.15884477
臺南縣,左鎮鄉,岡林村,607,219,68.86792453,99,31.13207547,318,22,340,0,443,76.74943567
臺南縣,左鎮鄉,草山村,608,148,61.15702479,94,38.84297521,242,6,248,0,320,77.5
臺南縣,左鎮鄉,二寮村,609,119,63.29787234,69,36.70212766,188,9,197,0,234,84.18803419
臺南縣,仁德鄉,太子村,611,918,74.8776509,308,25.1223491,1226,30,1256,0,1498,83.84512684
臺南縣,仁德鄉,太子村,612,744,67.51361162,358,32.48638838,1102,24,1126,0,1313,85.75780655
臺南縣,仁德鄉,太子村,613,755,72.24880383,290,27.75119617,1045,29,1074,0,1291,83.19132455
臺南縣,仁德鄉,土庫村,614,656,74.2081448,228,25.7918552,884,14,898,0,1051,85.44243578
臺南縣,仁德鄉,土庫村,615,797,78.29076621,221,21.70923379,1018,21,1039,0,1204,86.29568106
臺南縣,仁德鄉,一甲村,616,487,69.87087518,210,30.12912482,697,16,713,0,854,83.48946136
臺南縣,仁德鄉,一甲村,617,595,69.42823804,262,30.57176196,857,24,881,0,1075,81.95348837
臺南縣,仁德鄉,仁德村,618,852,64.98855835,459,35.01144165,1311,25,1336,0,1650,80.96969697
臺南縣,仁德鄉,仁德村,619,523,56.35775862,405,43.64224138,928,19,947,0,1190,79.57983193
臺南縣,仁德鄉,仁德村,620,828,61.28793486,523,38.71206514,1351,25,1376,0,1707,80.609256
臺南縣,仁德鄉,仁義村,621,715,58.55855856,506,41.44144144,1221,25,1246,0,1488,83.73655914
臺南縣,仁德鄉,仁義村,622,648,61.07445806,413,38.92554194,1061,22,1083,0,1279,84.67552776
臺南縣,仁德鄉,仁義村,623,450,63.73937677,256,36.26062323,706,15,721,0,895,80.55865922
臺南縣,仁德鄉,仁義村,624,493,58.97129187,343,41.02870813,836,19,855,0,1072,79.75746269
臺南縣,仁德鄉,仁義村,625,449,65.07246377,241,34.92753623,690,21,711,0,854,83.25526932
臺南縣,仁德鄉,仁義村,626,749,67.78280543,356,32.21719457,1105,27,1132,0,1342,84.35171386
臺南縣,仁德鄉,新田村,627,443,65.62962963,232,34.37037037,675,13,688,0,859,80.09313155
臺南縣,仁德鄉,新田村,628,357,62.85211268,211,37.14788732,568,8,576,0,672,85.71428571
臺南縣,仁德鄉,新田村,629,525,57.94701987,381,42.05298013,906,25,931,0,1114,83.57271095
臺南縣,仁德鄉,後壁村,630,548,64.85207101,297,35.14792899,845,20,865,0,1036,83.49420849
臺南縣,仁德鄉,後壁村,631,670,70.23060797,284,29.76939203,954,29,983,0,1152,85.32986111
臺南縣,仁德鄉,後壁村,632,583,64.922049,315,35.077951,898,27,925,0,1117,82.81110116
臺南縣,仁德鄉,後壁村,633,575,65.86483391,298,34.13516609,873,12,885,0,1068,82.86516854
臺南縣,仁德鄉,後壁村,634,511,59.97652582,341,40.02347418,852,21,873,0,1119,78.01608579
臺南縣,仁德鄉,後壁村,635,489,57.80141844,357,42.19858156,846,24,870,0,1072,81.15671642
臺南縣,仁德鄉,上崙村,636,578,66.58986175,290,33.41013825,868,40,908,0,1129,80.425155
臺南縣,仁德鄉,上崙村,637,570,62.91390728,336,37.08609272,906,21,927,0,1087,85.28058878
臺南縣,仁德鄉,上崙村,638,672,73.52297593,242,26.47702407,914,37,951,0,1134,83.86243386
臺南縣,仁德鄉,上崙村,639,393,67.06484642,193,32.93515358,586,26,612,0,763,80.20969856
臺南縣,仁德鄉,田厝村,640,690,62.10621062,421,37.89378938,1111,13,1124,0,1320,85.15151515
臺南縣,仁德鄉,三甲村,641,390,67.35751295,189,32.64248705,579,15,594,0,706,84.13597734
臺南縣,仁德鄉,保安村,642,491,66.26180837,250,33.73819163,741,21,762,0,923,82.55687974
臺南縣,仁德鄉,保安村,643,687,65.86768936,356,34.13231064,1043,36,1079,0,1305,82.68199234
臺南縣,仁德鄉,成功村,644,451,43.95711501,575,56.04288499,1026,34,1060,0,1313,80.73115004
臺南縣,仁德鄉,成功村,645,475,54.41008018,398,45.58991982,873,10,883,0,1062,83.14500942
臺南縣,仁德鄉,成功村,646,279,34.91864831,520,65.08135169,799,23,822,0,987,83.28267477
臺南縣,仁德鄉,成功村,647,164,61.42322097,103,38.57677903,267,16,283,0,332,85.24096386
臺南縣,仁德鄉,仁和村,648,53,5.961754781,836,94.03824522,889,40,929,0,1134,81.92239859
臺南縣,仁德鄉,仁愛村,649,71,9.305373526,692,90.69462647,763,27,790,0,957,82.54963427
臺南縣,仁德鄉,仁愛村,650,307,34.41704036,585,65.58295964,892,23,915,0,1109,82.50676285
臺南縣,仁德鄉,二行村,651,527,54.95307612,432,45.04692388,959,19,978,0,1203,81.2967581
臺南縣,仁德鄉,二行村,652,453,68.01801802,213,31.98198198,666,16,682,0,844,80.8056872
臺南縣,仁德鄉,大甲村,653,453,64.89971347,245,35.10028653,698,29,727,0,874,83.18077803
臺南縣,仁德鄉,大甲村,654,567,65.93023256,293,34.06976744,860,31,891,0,1107,80.48780488
臺南縣,仁德鄉,中洲村,655,753,72.12643678,291,27.87356322,1044,46,1090,0,1260,86.50793651
臺南縣,仁德鄉,中生村,656,711,63.82405745,403,36.17594255,1114,41,1155,0,1403,82.3235923
臺南縣,歸仁鄉,南保村,657,723,62.06008584,442,37.93991416,1165,27,1192,0,1407,84.71926084
臺南縣,歸仁鄉,南保村,658,794,65.08196721,426,34.91803279,1220,35,1255,0,1499,83.72248165
臺南縣,歸仁鄉,南保村,659,476,69.69253294,207,30.30746706,683,12,695,0,859,80.9080326
臺南縣,歸仁鄉,南保村,660,504,59.3639576,345,40.6360424,849,16,865,0,1045,82.77511962
臺南縣,歸仁鄉,六甲村,663,539,67.71356784,257,32.28643216,796,26,822,0,1055,77.91469194
臺南縣,歸仁鄉,六甲村,664,551,69.39546599,243,30.60453401,794,33,827,1,1041,79.44284342
臺南縣,歸仁鄉,六甲村,665,555,67.84841076,263,32.15158924,818,29,847,0,1014,83.53057199
臺南縣,歸仁鄉,歸仁村,689,513,59.30635838,352,40.69364162,865,16,881,0,1040,84.71153846
臺南縣,歸仁鄉,歸仁村,690,442,59.72972973,298,40.27027027,740,16,756,0,944,80.08474576
臺南縣,歸仁鄉,後市村,668,652,64.11012783,365,35.88987217,1017,18,1035,0,1263,81.94774347
臺南縣,歸仁鄉,後市村,669,424,59.05292479,294,40.94707521,718,21,739,1,876,84.36073059
臺南縣,歸仁鄉,後市村,670,429,63.36779911,248,36.63220089,677,17,694,0,865,80.23121387
臺南縣,歸仁鄉,辜厝村,673,402,61.75115207,249,38.24884793,651,14,665,1,846,78.60520095
臺南縣,歸仁鄉,辜厝村,674,416,60.55312955,271,39.44687045,687,14,701,0,857,81.79696616
臺南縣,歸仁鄉,辜厝村,675,567,67.10059172,278,32.89940828,845,23,868,0,1047,82.90353391
臺南縣,歸仁鄉,許厝村,678,521,67.13917526,255,32.86082474,776,17,793,0,940,84.36170213
臺南縣,歸仁鄉,許厝村,679,504,67.28971963,245,32.71028037,749,14,763,0,951,80.23133544
臺南縣,歸仁鄉,許厝村,680,497,68.08219178,233,31.91780822,730,10,740,0,898,82.40534521
臺南縣,歸仁鄉,看西村,681,823,71.87772926,322,28.12227074,1145,29,1174,0,1388,84.58213256
臺南縣,歸仁鄉,看東村,682,684,65.26717557,364,34.73282443,1048,41,1089,0,1324,82.25075529
臺南縣,歸仁鄉,崙頂村,683,644,70.07616975,275,29.92383025,919,26,945,0,1119,84.45040214
臺南縣,歸仁鄉,崙頂村,684,470,65.27777778,250,34.72222222,720,18,738,0,872,84.63302752
臺南縣,歸仁鄉,沙崙村,685,335,69.07216495,150,30.92783505,485,10,495,0,608,81.41447368
臺南縣,歸仁鄉,大潭村,686,437,69.6969697,190,30.3030303,627,23,650,0,774,83.97932817
臺南縣,歸仁鄉,大潭村,687,588,76.96335079,176,23.03664921,764,27,791,0,920,85.97826087
臺南縣,歸仁鄉,武東村,688,581,64.91620112,314,35.08379888,895,34,929,0,1200,77.41666667
臺南縣,歸仁鄉,八甲村,691,611,64.51953537,336,35.48046463,947,30,977,0,1169,83.57570573
臺南縣,歸仁鄉,八甲村,692,524,69.40397351,231,30.59602649,755,18,773,0,929,83.20775027
臺南縣,歸仁鄉,七甲村,693,616,66.30785791,313,33.69214209,929,22,951,0,1103,86.21940163
臺南縣,歸仁鄉,七甲村,694,621,69.07675195,278,30.92324805,899,20,919,0,1090,84.31192661
臺南縣,歸仁鄉,媽廟村,695,595,71.60048135,236,28.39951865,831,22,853,0,1007,84.70705065
臺南縣,歸仁鄉,媽廟村,696,463,65.76704545,241,34.23295455,704,20,724,0,870,83.2183908
臺南縣,歸仁鄉,西埔村,697,440,74.07407407,154,25.92592593,594,16,610,0,744,81.98924731
臺南縣,歸仁鄉,西埔村,698,360,71.14624506,146,28.85375494,506,9,515,0,597,86.26465662
臺南縣,歸仁鄉,大廟村,699,600,67.95016988,283,32.04983012,883,23,906,0,1117,81.11011638
臺南縣,歸仁鄉,大廟村,700,674,76.33069083,209,23.66930917,883,33,916,0,1119,81.8588025
臺南縣,歸仁鄉,南興村,661,796,64.14182111,445,35.85817889,1241,32,1273,0,1510,84.30463576
臺南縣,歸仁鄉,南興村,662,692,64.01480111,389,35.98519889,1081,19,1100,0,1370,80.2919708
臺南縣,歸仁鄉,新厝村,676,544,65.85956416,282,34.14043584,826,20,846,0,1015,83.34975369
臺南縣,歸仁鄉,新厝村,677,637,71.01449275,260,28.98550725,897,22,919,0,1097,83.7739289
臺南縣,歸仁鄉,歸南村,666,542,60.49107143,354,39.50892857,896,10,906,0,1088,83.27205882
臺南縣,歸仁鄉,歸南村,667,486,62.1483376,296,37.8516624,782,11,793,0,981,80.83588175
臺南縣,歸仁鄉,文化村,671,712,63.6282395,407,36.3717605,1119,13,1132,1,1369,82.6880935
臺南縣,歸仁鄉,文化村,672,481,59.2364532,331,40.7635468,812,14,826,0,1009,81.86323092
臺南縣,關廟鄉,關廟村,701,461,65.11299435,247,34.88700565,708,8,716,0,875,81.82857143
臺南縣,關廟鄉,關廟村,702,531,60.47835991,347,39.52164009,878,26,904,0,1080,83.7037037
臺南縣,關廟鄉,山西村,703,439,65.62032885,230,34.37967115,669,9,678,0,831,81.58844765
臺南縣,關廟鄉,山西村,704,572,66.66666667,286,33.33333333,858,28,886,0,1046,84.70363289
臺南縣,關廟鄉,香洋村,705,503,62.25247525,305,37.74752475,808,24,832,0,1022,81.40900196
臺南縣,關廟鄉,香洋村,706,500,58.61664713,353,41.38335287,853,33,886,0,1062,83.42749529
臺南縣,關廟鄉,香洋村,707,709,66.69802446,354,33.30197554,1063,48,1111,0,1314,84.55098935
臺南縣,關廟鄉,北勢村,708,683,69.12955466,305,30.87044534,988,35,1023,0,1210,84.54545455
臺南縣,關廟鄉,北勢村,709,663,66.56626506,333,33.43373494,996,30,1026,0,1267,80.97868982
臺南縣,關廟鄉,新埔村,710,461,65.76319544,240,34.23680456,701,26,727,0,877,82.89623717
臺南縣,關廟鄉,新光村,711,432,73.0964467,159,26.9035533,591,26,617,0,752,82.04787234
臺南縣,關廟鄉,五甲村,712,690,61.88340807,425,38.11659193,1115,20,1135,0,1399,81.12937813
臺南縣,關廟鄉,五甲村,713,693,63.40347667,400,36.59652333,1093,22,1115,0,1335,83.52059925
臺南縣,關廟鄉,東勢村,714,799,68.46615253,368,31.53384747,1167,37,1204,0,1459,82.52227553
臺南縣,關廟鄉,東勢村,715,766,63.30578512,444,36.69421488,1210,33,1243,0,1536,80.92447917
臺南縣,關廟鄉,松腳村,716,459,66.04316547,236,33.95683453,695,19,714,0,848,84.19811321
臺南縣,關廟鄉,松腳村,717,594,67.42338252,287,32.57661748,881,24,905,0,1067,84.81724461
臺南縣,關廟鄉,南花村,718,786,67.00767263,387,32.99232737,1173,39,1212,0,1472,82.33695652
臺南縣,關廟鄉,北花村,719,543,68.38790932,251,31.61209068,794,38,832,1,1010,82.37623762
臺南縣,關廟鄉,北花村,720,611,67.66334441,292,32.33665559,903,30,933,0,1117,83.52730528
臺南縣,關廟鄉,深坑村,721,412,67.54098361,198,32.45901639,610,16,626,0,756,82.8042328
臺南縣,關廟鄉,深坑村,722,430,68.58054226,197,31.41945774,627,24,651,0,789,82.5095057
臺南縣,關廟鄉,布袋村,723,709,71.83383992,278,28.16616008,987,43,1030,0,1217,84.63434675
臺南縣,關廟鄉,田中村,724,450,71.42857143,180,28.57142857,630,25,655,0,753,86.98539177
臺南縣,關廟鄉,龜洞村,725,429,68.31210191,199,31.68789809,628,25,653,0,775,84.25806452
臺南縣,關廟鄉,埤頭村,726,437,68.49529781,201,31.50470219,638,23,661,0,803,82.31631382
臺南縣,關廟鄉,埤頭村,727,407,70.90592334,167,29.09407666,574,24,598,0,733,81.58253752
臺南縣,關廟鄉,下湖村,728,211,66.5615142,106,33.4384858,317,17,334,0,397,84.13098237
臺南縣,龍崎鄉,崎頂村,729,596,64.5021645,328,35.4978355,924,51,975,0,1153,84.56201214
臺南縣,龍崎鄉,土崎村,730,347,64.49814126,191,35.50185874,538,28,566,0,702,80.62678063
臺南縣,龍崎鄉,中坑村,731,88,66.66666667,44,33.33333333,132,9,141,0,199,70.85427136
臺南縣,龍崎鄉,楠坑村,732,141,57.55102041,104,42.44897959,245,14,259,0,308,84.09090909
臺南縣,龍崎鄉,牛埔村,733,134,60.36036036,88,39.63963964,222,14,236,0,270,87.40740741
臺南縣,龍崎鄉,大坪村,734,140,60.60606061,91,39.39393939,231,18,249,0,305,81.63934426
臺南縣,龍崎鄉,龍船村,735,172,49.42528736,176,50.57471264,348,16,364,0,429,84.84848485
臺南縣,龍崎鄉,石曹村,736,166,56.08108108,130,43.91891892,296,23,319,0,381,83.72703412
高雄縣,鳳山市,縣口里,46,195,49.49238579,199,50.50761421,394,5,399,0,483,82.60869565
高雄縣,鳳山市,成功里,45,387,61.04100946,247,38.95899054,634,14,648,0,791,81.9216182
高雄縣,鳳山市,光明里,47,247,60.53921569,161,39.46078431,408,6,414,0,524,79.00763359
高雄縣,鳳山市,光明里,48,369,57.38724728,274,42.61275272,643,13,656,0,785,83.56687898
高雄縣,鳳山市,興中里,62,374,55.98802395,294,44.01197605,668,13,681,0,802,84.9127182
高雄縣,鳳山市,南興里,55,490,57.51173709,362,42.48826291,852,24,876,0,1068,82.02247191
高雄縣,鳳山市,和德里,49,365,50.41436464,359,49.58563536,724,10,734,0,849,86.45465253
高雄縣,鳳山市,和德里,50,366,55.6231003,292,44.3768997,658,16,674,0,832,81.00961538
高雄縣,鳳山市,鳳崗里,1,257,51.09343936,246,48.90656064,503,18,521,0,621,83.89694042
高雄縣,鳳山市,鳳崗里,2,232,43.69114878,299,56.30885122,531,8,539,0,657,82.03957382
高雄縣,鳳山市,中和里,75,499,53.59828142,432,46.40171858,931,11,942,1,1147,82.12728858
高雄縣,鳳山市,中和里,76,283,36.32862644,496,63.67137356,779,30,809,0,995,81.30653266
高雄縣,鳳山市,中和里,77,381,41.10032362,546,58.89967638,927,20,947,0,1132,83.65724382
高雄縣,鳳山市,鎮北里,14,530,61.62790698,330,38.37209302,860,16,876,0,1078,81.26159555
高雄縣,鳳山市,鎮北里,15,692,67.71037182,330,32.28962818,1022,17,1039,0,1313,79.13175933
高雄縣,鳳山市,鎮北里,16,338,51.52439024,318,48.47560976,656,7,663,0,826,80.26634383
高雄縣,鳳山市,鎮北里,17,531,54.79876161,438,45.20123839,969,16,985,0,1172,84.0443686
高雄縣,鳳山市,縣衙里,3,313,47.49620637,346,52.50379363,659,10,669,0,855,78.24561404
高雄縣,鳳山市,文英里,22,621,58.97435897,432,41.02564103,1053,15,1068,0,1257,84.96420048
高雄縣,鳳山市,文英里,23,479,56.48584906,369,43.51415094,848,25,873,2,1071,81.51260504
高雄縣,鳳山市,文英里,24,235,41.51943463,331,58.48056537,566,8,574,0,685,83.79562044
高雄縣,鳳山市,鎮西里,6,603,52.29835212,550,47.70164788,1153,13,1166,0,1438,81.08484006
高雄縣,鳳山市,鎮西里,7,575,58.31643002,411,41.68356998,986,17,1003,0,1262,79.4770206
高雄縣,鳳山市,鎮西里,8,506,56.03543743,397,43.96456257,903,13,916,0,1141,80.28045574
高雄縣,鳳山市,鎮西里,9,534,55.74112735,424,44.25887265,958,23,981,0,1204,81.47840532
高雄縣,鳳山市,鎮東里,82,477,54.45205479,399,45.54794521,876,26,902,0,1136,79.40140845
高雄縣,鳳山市,鎮東里,83,406,54.35073628,341,45.64926372,747,18,765,0,958,79.85386221
高雄縣,鳳山市,埤頂里,104,469,58.11648079,338,41.88351921,807,16,823,0,1006,81.80914513
高雄縣,鳳山市,埤頂里,105,520,51.18110236,496,48.81889764,1016,23,1039,0,1248,83.25320513
高雄縣,鳳山市,埤頂里,106,320,37.03703704,544,62.96296296,864,11,875,0,1061,82.46936852
高雄縣,鳳山市,埤頂里,107,434,41.33333333,616,58.66666667,1050,13,1063,0,1295,82.08494208
高雄縣,鳳山市,中正里,109,280,30.97345133,624,69.02654867,904,19,923,0,1169,78.95637297
高雄縣,鳳山市,鎮南里,187,497,59.9517491,332,40.0482509,829,19,848,0,1005,84.37810945
高雄縣,鳳山市,鎮南里,188,363,62.15753425,221,37.84246575,584,23,607,0,775,78.32258065
高雄縣,鳳山市,鎮南里,189,588,64.82910695,319,35.17089305,907,20,927,0,1157,80.12100259
高雄縣,鳳山市,鎮南里,190,520,64.11837238,291,35.88162762,811,21,832,0,1020,81.56862745
高雄縣,鳳山市,老爺里,155,693,67.08615682,340,32.91384318,1033,30,1063,0,1316,80.77507599
高雄縣,鳳山市,老爺里,156,724,65.99817685,373,34.00182315,1097,28,1125,0,1346,83.58098068
高雄縣,鳳山市,老爺里,157,727,65.31895777,386,34.68104223,1113,26,1139,0,1369,83.19941563
高雄縣,鳳山市,老爺里,158,592,65.70477248,309,34.29522752,901,20,921,0,1145,80.43668122
高雄縣,鳳山市,老爺里,159,532,66.83417085,264,33.16582915,796,14,810,0,990,81.81818182
高雄縣,鳳山市,瑞竹里,84,464,53.02857143,411,46.97142857,875,23,898,0,1039,86.4292589
高雄縣,鳳山市,瑞竹里,85,310,37.94369645,507,62.05630355,817,19,836,0,987,84.70111449
高雄縣,鳳山市,瑞竹里,86,435,52.03349282,401,47.96650718,836,22,858,0,1031,83.22017459
高雄縣,鳳山市,瑞竹里,87,333,44.45927904,416,55.54072096,749,23,772,0,909,84.92849285
高雄縣,鳳山市,瑞竹里,88,358,48.37837838,382,51.62162162,740,10,750,0,919,81.61044614
高雄縣,鳳山市,忠義里,66,354,46.94960212,400,53.05039788,754,20,774,0,946,81.81818182
高雄縣,鳳山市,忠義里,67,344,46.48648649,396,53.51351351,740,11,751,0,918,81.80827887
高雄縣,鳳山市,忠義里,68,339,43.85510996,434,56.14489004,773,4,777,0,969,80.18575851
高雄縣,鳳山市,忠義里,69,602,55.68917669,479,44.31082331,1081,24,1105,0,1337,82.64771877
高雄縣,鳳山市,誠義里,80,239,25.50693703,698,74.49306297,937,14,951,0,1141,83.3479404
高雄縣,鳳山市,美齡里,108,42,7.636363636,508,92.36363636,550,14,564,0,692,81.50289017
高雄縣,鳳山市,新興里,57,575,58.19838057,413,41.80161943,988,25,1013,0,1407,71.99715707
高雄縣,鳳山市,海光里,110,33,4.903417533,640,95.09658247,673,15,688,0,820,83.90243902
高雄縣,鳳山市,海光里,111,31,6.404958678,453,93.59504132,484,7,491,0,618,79.44983819
高雄縣,鳳山市,海光里,112,302,36.03818616,536,63.96181384,838,2,840,0,1005,83.58208955
高雄縣,鳳山市,海光里,113,380,35.38175047,694,64.61824953,1074,13,1087,0,1326,81.97586727
高雄縣,鳳山市,海風里,114,26,4.87804878,507,95.12195122,533,10,543,0,660,82.27272727
高雄縣,鳳山市,海風里,115,36,5.834683955,581,94.16531605,617,11,628,0,751,83.62183755
高雄縣,鳳山市,海風里,116,30,4.076086957,706,95.92391304,736,19,755,0,912,82.78508772
高雄縣,鳳山市,忠誠里,20,494,45.61403509,589,54.38596491,1083,36,1119,3,1386,80.73593074
高雄縣,鳳山市,忠誠里,21,829,63.08980213,485,36.91019787,1314,27,1341,0,1659,80.8318264
高雄縣,鳳山市,新甲里,135,492,63.15789474,287,36.84210526,779,7,786,0,908,86.56387665
高雄縣,鳳山市,新甲里,136,377,64.00679117,212,35.99320883,589,5,594,1,775,76.64516129
高雄縣,鳳山市,新甲里,137,347,60.45296167,227,39.54703833,574,9,583,0,705,82.69503546
高雄縣,鳳山市,武漢里,131,432,62.33766234,261,37.66233766,693,17,710,0,866,81.98614319
高雄縣,鳳山市,武漢里,132,516,61.42857143,324,38.57142857,840,17,857,0,1060,80.8490566
高雄縣,鳳山市,武漢里,133,416,54.16666667,352,45.83333333,768,16,784,0,954,82.1802935
高雄縣,鳳山市,武漢里,134,460,55.48854041,369,44.51145959,829,11,840,1,1025,81.95121951
高雄縣,鳳山市,正義里,173,686,62.42038217,413,37.57961783,1099,26,1125,0,1404,80.12820513
高雄縣,鳳山市,正義里,174,851,65.16079632,455,34.83920368,1306,28,1334,0,1627,81.99139521
高雄縣,鳳山市,正義里,175,792,67.75021386,377,32.24978614,1169,35,1204,0,1481,81.29642134
高雄縣,鳳山市,正義里,176,655,63.71595331,373,36.28404669,1028,18,1046,0,1285,81.40077821
高雄縣,鳳山市,正義里,177,707,62.78863233,419,37.21136767,1126,20,1146,0,1399,81.91565404
高雄縣,鳳山市,正義里,178,560,61.00217865,358,38.99782135,918,5,923,0,1143,80.75240595
高雄縣,鳳山市,一甲里,179,667,64.56921588,366,35.43078412,1033,30,1063,0,1308,81.26911315
高雄縣,鳳山市,一甲里,180,541,67.625,259,32.375,800,27,827,0,989,83.619818
高雄縣,鳳山市,一甲里,181,488,68.34733894,226,31.65266106,714,16,730,0,921,79.2616721
高雄縣,鳳山市,福興里,217,550,62.57110353,329,37.42889647,879,19,898,0,1072,83.76865672
高雄縣,鳳山市,福興里,218,524,61.50234742,328,38.49765258,852,18,870,0,1013,85.88351431
高雄縣,鳳山市,福興里,219,577,64.54138702,317,35.45861298,894,22,916,0,1120,81.78571429
高雄縣,鳳山市,福興里,220,467,62.43315508,281,37.56684492,748,15,763,0,960,79.47916667
高雄縣,鳳山市,福興里,221,591,64.44929117,326,35.55070883,917,15,932,0,1150,81.04347826
高雄縣,鳳山市,東門里,92,532,50.95785441,512,49.04214559,1044,19,1063,0,1313,80.95963442
高雄縣,鳳山市,東門里,93,382,24.86979167,1154,75.13020833,1536,36,1572,0,1854,84.78964401
高雄縣,鳳山市,東門里,94,639,49.11606457,662,50.88393543,1301,20,1321,0,1620,81.54320988
高雄縣,鳳山市,瑞興里,89,494,48.00777454,535,51.99222546,1029,24,1053,0,1254,83.97129187
高雄縣,鳳山市,瑞興里,90,403,36.70309654,695,63.29690346,1098,11,1109,0,1330,83.38345865
高雄縣,鳳山市,瑞興里,91,509,46.99907664,574,53.00092336,1083,20,1103,0,1302,84.71582181
高雄縣,鳳山市,天興里,207,399,62.83464567,236,37.16535433,635,18,653,0,795,82.13836478
高雄縣,鳳山市,天興里,208,467,65.13249651,250,34.86750349,717,10,727,0,924,78.67965368
高雄縣,鳳山市,天興里,209,444,60.82191781,286,39.17808219,730,15,745,0,928,80.28017241
高雄縣,鳳山市,天興里,210,399,60.18099548,264,39.81900452,663,21,684,0,813,84.13284133
高雄縣,鳳山市,新強里,146,656,64,369,36,1025,17,1042,0,1247,83.56054531
高雄縣,鳳山市,新強里,147,629,59.50804163,428,40.49195837,1057,11,1068,0,1264,84.49367089
高雄縣,鳳山市,新強里,148,618,55.27728086,500,44.72271914,1118,9,1127,0,1355,83.17343173
高雄縣,鳳山市,國泰里,117,424,54.2893726,357,45.7106274,781,11,792,0,969,81.73374613
高雄縣,鳳山市,國泰里,118,328,47.95321637,356,52.04678363,684,12,696,0,850,81.88235294
高雄縣,鳳山市,國泰里,119,487,63.7434555,277,36.2565445,764,18,782,0,929,84.17653391
高雄縣,鳳山市,國泰里,120,533,52.56410256,481,47.43589744,1014,15,1029,0,1236,83.25242718
高雄縣,鳳山市,鳳東里,101,617,54.99108734,505,45.00891266,1122,27,1149,0,1376,83.50290698
高雄縣,鳳山市,鳳東里,102,584,55.93869732,460,44.06130268,1044,21,1065,0,1256,84.79299363
高雄縣,鳳山市,鳳東里,103,605,53.58724535,524,46.41275465,1129,16,1145,0,1402,81.66904422
高雄縣,鳳山市,新富里,152,629,63.40725806,363,36.59274194,992,15,1007,0,1217,82.74445357
高雄縣,鳳山市,新富里,153,567,60.25504782,374,39.74495218,941,20,961,0,1179,81.50975403
高雄縣,鳳山市,新富里,154,596,60.38500507,391,39.61499493,987,9,996,0,1260,79.04761905
高雄縣,鳳山市,國光里,121,579,59.14198161,400,40.85801839,979,12,991,0,1235,80.24291498
高雄縣,鳳山市,國光里,122,586,57.39471107,435,42.60528893,1021,13,1034,0,1279,80.8444097
高雄縣,鳳山市,國光里,123,482,51.05932203,462,48.94067797,944,11,955,0,1152,82.89930556
高雄縣,鳳山市,國隆里,124,587,68.49474912,270,31.50525088,857,12,869,0,1063,81.74976482
高雄縣,鳳山市,國隆里,125,444,59.67741935,300,40.32258065,744,15,759,0,924,82.14285714
高雄縣,鳳山市,國隆里,126,394,68.16608997,184,31.83391003,578,13,591,0,718,82.31197772
高雄縣,鳳山市,文德里,34,516,45.42253521,620,54.57746479,1136,19,1155,0,1378,83.81712627
高雄縣,鳳山市,文德里,35,484,48.93832154,505,51.06167846,989,12,1001,0,1278,78.32550861
高雄縣,鳳山市,文德里,36,491,49.5959596,499,50.4040404,990,13,1003,0,1224,81.94444444
高雄縣,鳳山市,文德里,37,667,49.7761194,673,50.2238806,1340,17,1357,0,1655,81.9939577
高雄縣,鳳山市,過埤里,170,473,49.3736952,485,50.6263048,958,30,988,0,1203,82.1280133
高雄縣,鳳山市,過埤里,171,496,65.26315789,264,34.73684211,760,16,776,0,967,80.24819028
高雄縣,鳳山市,過埤里,172,548,58.54700855,388,41.45299145,936,23,959,0,1162,82.53012048
高雄縣,鳳山市,曹公里,4,592,56.54250239,455,43.45749761,1047,26,1073,0,1363,78.72340426
高雄縣,鳳山市,曹公里,5,378,48.9003881,395,51.0996119,773,15,788,0,956,82.42677824
高雄縣,鳳山市,興仁里,58,439,47.25511302,490,52.74488698,929,14,943,0,1133,83.23036187
高雄縣,鳳山市,興仁里,59,352,53.2526475,309,46.7473525,661,10,671,0,829,80.94089264
高雄縣,鳳山市,興仁里,60,366,50.7628294,355,49.2371706,721,17,738,0,876,84.24657534
高雄縣,鳳山市,興仁里,61,403,52.54237288,364,47.45762712,767,10,777,0,921,84.36482085
高雄縣,鳳山市,五福里,214,466,61.07470511,297,38.92529489,763,25,788,0,921,85.55917481
高雄縣,鳳山市,五福里,215,506,61.2590799,320,38.7409201,826,19,845,0,1038,81.40655106
高雄縣,鳳山市,五福里,216,523,59.56719818,355,40.43280182,878,12,890,0,1092,81.5018315
高雄縣,鳳山市,忠孝里,70,506,56.59955257,388,43.40044743,894,18,912,0,1140,80
高雄縣,鳳山市,忠孝里,71,390,44.16761042,493,55.83238958,883,10,893,1,1073,83.22460391
高雄縣,鳳山市,忠孝里,72,396,47.4251497,439,52.5748503,835,23,858,0,1075,79.81395349
高雄縣,鳳山市,忠孝里,73,511,52.51798561,462,47.48201439,973,19,992,0,1181,83.99661304
高雄縣,鳳山市,忠孝里,74,351,45.05776637,428,54.94223363,779,14,793,0,959,82.6903024
高雄縣,鳳山市,生明里,81,443,37.86324786,727,62.13675214,1170,20,1190,0,1446,82.29598893
高雄縣,鳳山市,和興里,51,550,51.30597015,522,48.69402985,1072,15,1087,0,1256,86.54458599
高雄縣,鳳山市,和興里,52,579,56.15906887,452,43.84093113,1031,16,1047,0,1264,82.83227848
高雄縣,鳳山市,和興里,53,480,48.68154158,506,51.31845842,986,22,1008,0,1177,85.64146134
高雄縣,鳳山市,和興里,54,545,56.88935282,413,43.11064718,958,20,978,0,1186,82.46205734
高雄縣,鳳山市,協和里,63,577,56.79133858,439,43.20866142,1016,19,1035,0,1234,83.87358185
高雄縣,鳳山市,協和里,64,515,46.31294964,597,53.68705036,1112,19,1131,0,1371,82.49452954
高雄縣,鳳山市,協和里,65,388,41.58628081,545,58.41371919,933,16,949,0,1126,84.28063943
高雄縣,鳳山市,文山里,29,540,65.13872135,289,34.86127865,829,7,836,0,995,84.0201005
高雄縣,鳳山市,文山里,30,711,59.34891486,487,40.65108514,1198,21,1219,0,1478,82.47631935
高雄縣,鳳山市,文山里,31,532,64.09638554,298,35.90361446,830,26,856,0,1056,81.06060606
高雄縣,鳳山市,文山里,32,553,68.52540273,254,31.47459727,807,9,816,0,985,82.84263959
高雄縣,鳳山市,文山里,33,288,44.44444444,360,55.55555556,648,14,662,0,807,82.03221809
高雄縣,鳳山市,福誠里,224,447,60,298,40,745,16,761,0,925,82.27027027
高雄縣,鳳山市,福誠里,225,511,70.28885832,216,29.71114168,727,16,743,0,915,81.20218579
高雄縣,鳳山市,福誠里,226,493,60.56511057,321,39.43488943,814,8,822,0,1008,81.54761905
高雄縣,鳳山市,誠德里,95,267,33.45864662,531,66.54135338,798,19,817,0,975,83.79487179
高雄縣,鳳山市,誠德里,96,350,40.13761468,522,59.86238532,872,18,890,0,1076,82.71375465
高雄縣,鳳山市,三民里,56,499,54.53551913,416,45.46448087,915,7,922,0,1097,84.04740201
高雄縣,鳳山市,誠正里,78,24,6.575342466,341,93.42465753,365,7,372,0,461,80.69414317
高雄縣,鳳山市,誠正里,79,10,2.673796791,364,97.32620321,374,12,386,0,486,79.42386831
高雄縣,鳳山市,北門里,10,491,55.79545455,389,44.20454545,880,20,900,0,1082,83.1792976
高雄縣,鳳山市,北門里,11,472,56.66266507,361,43.33733493,833,30,863,0,1080,79.90740741
高雄縣,鳳山市,北門里,12,299,56.41509434,231,43.58490566,530,10,540,0,657,82.19178082
高雄縣,鳳山市,北門里,13,548,60.48565121,358,39.51434879,906,24,930,0,1138,81.72231986
高雄縣,鳳山市,富甲里,191,333,61.32596685,210,38.67403315,543,5,548,0,876,62.55707763
高雄縣,鳳山市,富甲里,192,313,62.4750499,188,37.5249501,501,18,519,0,615,84.3902439
高雄縣,鳳山市,富甲里,193,288,62.47288503,173,37.52711497,461,22,483,0,582,82.98969072
高雄縣,鳳山市,南成里,201,439,67.33128834,213,32.66871166,652,10,662,0,805,82.23602484
高雄縣,鳳山市,南成里,202,501,64.31322208,278,35.68677792,779,14,793,0,970,81.75257732
高雄縣,鳳山市,南成里,203,490,62.42038217,295,37.57961783,785,10,795,0,962,82.64033264
高雄縣,鳳山市,南成里,204,353,63.94927536,199,36.05072464,552,7,559,0,693,80.66378066
高雄縣,鳳山市,南成里,205,590,67.04545455,290,32.95454545,880,28,908,0,1095,82.92237443
高雄縣,鳳山市,南成里,206,570,64.26155581,317,35.73844419,887,16,903,0,1095,82.46575342
高雄縣,鳳山市,文華里,25,454,32.49821045,943,67.50178955,1397,34,1431,0,1701,84.12698413
高雄縣,鳳山市,文華里,26,403,50.88383838,389,49.11616162,792,14,806,0,994,81.08651911
高雄縣,鳳山市,文華里,27,545,57.61099366,401,42.38900634,946,15,961,0,1173,81.92668372
高雄縣,鳳山市,文華里,28,499,50.4040404,491,49.5959596,990,21,1011,0,1194,84.67336683
高雄縣,鳳山市,大德里,211,639,64.02805611,359,35.97194389,998,20,1018,0,1279,79.59343237
高雄縣,鳳山市,大德里,212,680,67.93206793,321,32.06793207,1001,24,1025,0,1249,82.06565252
高雄縣,鳳山市,大德里,213,582,63.74589266,331,36.25410734,913,17,930,0,1125,82.66666667
高雄縣,鳳山市,武松里,18,650,61.43667297,408,38.56332703,1058,19,1077,0,1336,80.61377246
高雄縣,鳳山市,武松里,19,529,57.94085433,384,42.05914567,913,15,928,0,1093,84.90393413
高雄縣,鳳山市,文衡里,38,580,59.85552116,389,40.14447884,969,9,978,0,1172,83.44709898
高雄縣,鳳山市,文衡里,39,473,50.05291005,472,49.94708995,945,8,953,0,1153,82.65394623
高雄縣,鳳山市,文福里,40,443,43.99205561,564,56.00794439,1007,20,1027,0,1256,81.76751592
高雄縣,鳳山市,文福里,41,500,51.86721992,464,48.13278008,964,12,976,0,1205,80.99585062
高雄縣,鳳山市,文福里,42,411,49.10394265,426,50.89605735,837,19,856,0,1044,81.99233716
高雄縣,鳳山市,文福里,43,505,49.85192498,508,50.14807502,1013,16,1029,0,1300,79.15384615
高雄縣,鳳山市,文福里,44,429,49.71031286,434,50.28968714,863,14,877,0,1060,82.73584906
高雄縣,鳳山市,誠信里,97,216,32,459,68,675,10,685,0,830,82.53012048
高雄縣,鳳山市,誠信里,98,187,27.74480712,487,72.25519288,674,7,681,0,837,81.36200717
高雄縣,鳳山市,誠智里,99,389,40.22750776,578,59.77249224,967,18,985,0,1225,80.40816327
高雄縣,鳳山市,誠智里,100,356,44.27860697,448,55.72139303,804,25,829,0,1007,82.32373386
高雄縣,鳳山市,國富里,127,498,53.20512821,438,46.79487179,936,11,947,0,1156,81.92041522
高雄縣,鳳山市,國富里,128,427,49.94152047,428,50.05847953,855,11,866,0,1054,82.16318786
高雄縣,鳳山市,武慶里,129,559,67.1875,273,32.8125,832,10,842,0,1030,81.74757282
高雄縣,鳳山市,武慶里,130,473,53.32581736,414,46.67418264,887,20,907,0,1113,81.49146451
高雄縣,鳳山市,海洋里,149,514,70.89655172,211,29.10344828,725,8,733,0,851,86.13396005
高雄縣,鳳山市,海洋里,150,431,55.90142672,340,44.09857328,771,9,780,0,969,80.49535604
高雄縣,鳳山市,海洋里,151,520,49.05660377,540,50.94339623,1060,9,1069,0,1279,83.5809226
高雄縣,鳳山市,新武里,138,485,59.87654321,325,40.12345679,810,21,831,0,1020,81.47058824
高雄縣,鳳山市,新武里,139,493,66.17449664,252,33.82550336,745,13,758,0,932,81.3304721
高雄縣,鳳山市,新樂里,143,480,62.41872562,289,37.58127438,769,14,783,0,946,82.76955603
高雄縣,鳳山市,新樂里,144,538,59.71143174,363,40.28856826,901,21,922,0,1105,83.43891403
高雄縣,鳳山市,新樂里,145,545,50.32317636,538,49.67682364,1083,17,1100,1,1307,84.16220352
高雄縣,鳳山市,新泰里,140,427,62.79411765,253,37.20588235,680,21,701,0,836,83.85167464
高雄縣,鳳山市,新泰里,141,381,55.94713656,300,44.05286344,681,6,687,0,846,81.20567376
高雄縣,鳳山市,新泰里,142,381,45.24940618,461,54.75059382,842,10,852,0,1046,81.45315488
高雄縣,鳳山市,中崙里,164,366,50,366,50,732,12,744,0,917,81.13413304
高雄縣,鳳山市,中崙里,165,485,56.00461894,381,43.99538106,866,21,887,0,1085,81.75115207
高雄縣,鳳山市,中榮里,166,498,59.35637664,341,40.64362336,839,16,855,0,1060,80.66037736
高雄縣,鳳山市,中榮里,167,361,47.75132275,395,52.24867725,756,21,777,0,943,82.39660657
高雄縣,鳳山市,中榮里,168,496,60.93366093,318,39.06633907,814,9,823,0,1006,81.80914513
高雄縣,鳳山市,中榮里,169,452,59.16230366,312,40.83769634,764,9,773,0,979,78.95812053
高雄縣,鳳山市,中民里,160,469,62.45006658,282,37.54993342,751,12,763,0,937,81.43009605
高雄縣,鳳山市,中民里,161,409,64.61295419,224,35.38704581,633,11,644,0,841,76.57550535
高雄縣,鳳山市,中民里,162,393,61.11975117,250,38.88024883,643,15,658,0,831,79.18170878
高雄縣,鳳山市,中民里,163,406,63.83647799,230,36.16352201,636,12,648,0,825,78.54545455
高雄縣,鳳山市,二甲里,182,673,66.37080868,341,33.62919132,1014,13,1027,0,1260,81.50793651
高雄縣,鳳山市,二甲里,183,488,59.43970767,333,40.56029233,821,11,832,0,1030,80.77669903
高雄縣,鳳山市,二甲里,184,700,61.94690265,430,38.05309735,1130,22,1152,0,1361,84.64364438
高雄縣,鳳山市,龍成里,185,754,62.41721854,454,37.58278146,1208,21,1229,0,1505,81.66112957
高雄縣,鳳山市,龍成里,186,620,65.46990496,327,34.53009504,947,29,976,0,1214,80.39538715
高雄縣,鳳山市,富榮里,198,488,63.95806029,275,36.04193971,763,22,785,0,969,81.01135191
高雄縣,鳳山市,富榮里,199,415,52.3989899,377,47.6010101,792,13,805,0,1005,80.09950249
高雄縣,鳳山市,善美里,194,533,60.70615034,345,39.29384966,878,15,893,0,1059,84.32483475
高雄縣,鳳山市,善美里,195,507,60.14234875,336,39.85765125,843,19,862,0,1036,83.2046332
高雄縣,鳳山市,善美里,196,531,57.96943231,385,42.03056769,916,20,936,0,1156,80.96885813
高雄縣,鳳山市,善美里,197,572,55.26570048,463,44.73429952,1035,20,1055,0,1324,79.68277946
高雄縣,鳳山市,南和里,200,382,63.66666667,218,36.33333333,600,11,611,0,753,81.14209827
高雄縣,鳳山市,福祥里,222,634,69.3654267,280,30.6345733,914,20,934,0,1133,82.43601059
高雄縣,鳳山市,福祥里,223,730,63.5335074,419,36.4664926,1149,13,1162,0,1436,80.91922006
高雄縣,林園鄉,東林村,234,535,56.25657203,416,43.74342797,951,31,982,0,1198,81.96994992
高雄縣,林園鄉,東林村,235,572,57.71947528,419,42.28052472,991,36,1027,0,1313,78.21782178
高雄縣,林園鄉,林園村,229,489,58.56287425,346,41.43712575,835,23,858,0,1043,82.26270374
高雄縣,林園鄉,林園村,230,492,61.7314931,305,38.2685069,797,19,816,0,978,83.43558282
高雄縣,林園鄉,林園村,231,436,56.47668394,336,43.52331606,772,5,777,0,974,79.77412731
高雄縣,林園鄉,溪州村,236,650,68.8559322,294,31.1440678,944,35,979,0,1176,83.24829932
高雄縣,林園鄉,溪州村,237,569,67.57719715,273,32.42280285,842,35,877,0,1100,79.72727273
高雄縣,林園鄉,溪州村,238,531,62.6918536,316,37.3081464,847,30,877,0,1093,80.2378774
高雄縣,林園鄉,潭頭村,241,640,62.13592233,390,37.86407767,1030,30,1060,0,1294,81.91653787
高雄縣,林園鄉,潭頭村,242,487,56.43105446,376,43.56894554,863,45,908,0,1132,80.21201413
高雄縣,林園鄉,中厝村,243,809,71.4664311,323,28.5335689,1132,43,1175,0,1440,81.59722222
高雄縣,林園鄉,中厝村,244,397,44.20935412,501,55.79064588,898,52,950,0,1159,81.96721311
高雄縣,林園鄉,中門村,256,411,63.91912908,232,36.08087092,643,27,670,0,816,82.10784314
高雄縣,林園鄉,中門村,257,587,65.73348264,306,34.26651736,893,12,905,0,1147,78.90148213
高雄縣,林園鄉,頂厝村,258,513,68.8590604,232,31.1409396,745,13,758,0,967,78.38676319
高雄縣,林園鄉,頂厝村,259,544,65.1497006,291,34.8502994,835,19,854,1,1050,81.33333333
高雄縣,林園鄉,頂厝村,260,798,64.82534525,433,35.17465475,1231,23,1254,0,1555,80.64308682
高雄縣,林園鄉,港埔村,261,497,71.71717172,196,28.28282828,693,22,715,0,876,81.62100457
高雄縣,林園鄉,港埔村,262,398,65.35303777,211,34.64696223,609,18,627,0,777,80.69498069
高雄縣,林園鄉,西溪村,264,458,64.05594406,257,35.94405594,715,25,740,0,909,81.40814081
高雄縣,林園鄉,西溪村,265,503,69.86111111,217,30.13888889,720,16,736,0,912,80.70175439
高雄縣,林園鄉,西溪村,266,573,72.34848485,219,27.65151515,792,28,820,0,996,82.32931727
高雄縣,林園鄉,港嘴村,263,772,69.86425339,333,30.13574661,1105,25,1130,0,1362,82.96622614
高雄縣,林園鄉,北汕村,275,146,33.95348837,284,66.04651163,430,21,451,0,616,73.21428571
高雄縣,林園鄉,北汕村,276,407,66.28664495,207,33.71335505,614,21,635,0,854,74.3559719
高雄縣,林園鄉,林內村,245,449,62.44784423,270,37.55215577,719,26,745,0,912,81.68859649
高雄縣,林園鄉,林內村,246,185,28.72670807,459,71.27329193,644,33,677,0,843,80.3084223
高雄縣,林園鄉,王公村,247,461,55.6763285,367,44.3236715,828,17,845,0,1030,82.03883495
高雄縣,林園鄉,王公村,248,499,60.85365854,321,39.14634146,820,17,837,0,1008,83.03571429
高雄縣,林園鄉,王公村,249,552,66.66666667,276,33.33333333,828,28,856,0,1030,83.10679612
高雄縣,林園鄉,林家村,253,608,66.37554585,308,33.62445415,916,42,958,0,1202,79.70049917
高雄縣,林園鄉,龔厝村,254,405,61.9266055,249,38.0733945,654,22,676,0,846,79.90543735
高雄縣,林園鄉,龔厝村,255,421,64.27480916,234,35.72519084,655,37,692,0,816,84.80392157
高雄縣,林園鄉,鳳芸村,269,466,77.28026534,137,22.71973466,603,8,611,1,745,82.01342282
高雄縣,林園鄉,鳳芸村,270,478,66.20498615,244,33.79501385,722,29,751,0,930,80.75268817
高雄縣,林園鄉,中芸村,267,557,77.1468144,165,22.8531856,722,26,748,0,946,79.06976744
高雄縣,林園鄉,中芸村,268,432,72.60504202,163,27.39495798,595,22,617,0,754,81.83023873
高雄縣,林園鄉,東汕村,271,484,69.24177396,215,30.75822604,699,27,726,0,908,79.95594714
高雄縣,林園鄉,西汕村,272,430,75.70422535,138,24.29577465,568,20,588,0,757,77.67503303
高雄縣,林園鄉,仁愛村,227,738,65.30973451,392,34.69026549,1130,30,1160,0,1369,84.73338203
高雄縣,林園鄉,仁愛村,228,614,61.77062374,380,38.22937626,994,36,1030,0,1250,82.4
高雄縣,林園鄉,文賢村,232,516,57.20620843,386,42.79379157,902,28,930,0,1110,83.78378378
高雄縣,林園鄉,文賢村,233,469,63.72282609,267,36.27717391,736,21,757,0,946,80.02114165
高雄縣,林園鄉,廣應村,250,500,65.78947368,260,34.21052632,760,22,782,0,959,81.54327424
高雄縣,林園鄉,廣應村,251,521,62.99879081,306,37.00120919,827,21,848,0,1048,80.91603053
高雄縣,林園鄉,廣應村,252,415,60.58394161,270,39.41605839,685,29,714,0,874,81.69336384
高雄縣,林園鄉,五福村,239,537,68.84615385,243,31.15384615,780,26,806,0,1008,79.96031746
高雄縣,林園鄉,五福村,240,433,69.61414791,189,30.38585209,622,3,625,0,843,74.13997628
高雄縣,林園鄉,中汕村,273,663,77.27272727,195,22.72727273,858,34,892,0,1119,79.71403038
高雄縣,林園鄉,中汕村,274,561,75.10040161,186,24.89959839,747,38,785,0,1029,76.28765792
高雄縣,大寮鄉,拷潭村,339,433,74.39862543,149,25.60137457,582,34,616,0,755,81.58940397
高雄縣,大寮鄉,拷潭村,340,326,70.56277056,136,29.43722944,462,16,478,0,600,79.66666667
高雄縣,大寮鄉,內坑村,341,676,68.76907426,307,31.23092574,983,24,1007,0,1318,76.40364188
高雄縣,大寮鄉,內坑村,342,518,63.32518337,300,36.67481663,818,24,842,2,1034,81.43133462
高雄縣,大寮鄉,內坑村,343,436,54.77386935,360,45.22613065,796,11,807,0,1068,75.56179775
高雄縣,大寮鄉,內坑村,344,218,62.46418338,131,37.53581662,349,14,363,0,442,82.12669683
高雄縣,大寮鄉,大寮村,334,595,68.31228473,276,31.68771527,871,27,898,1,1131,79.39876216
高雄縣,大寮鄉,大寮村,335,547,58.25346113,392,41.74653887,939,23,962,0,1176,81.80272109
高雄縣,大寮鄉,大寮村,336,555,65.2173913,296,34.7826087,851,19,870,0,1087,80.03679853
高雄縣,大寮鄉,大寮村,337,635,69.24754635,282,30.75245365,917,11,928,0,1205,77.01244813
高雄縣,大寮鄉,大寮村,338,518,67.80104712,246,32.19895288,764,20,784,0,954,82.1802935
高雄縣,大寮鄉,上寮村,332,644,73.09875142,237,26.90124858,881,29,910,0,1103,82.50226655
高雄縣,大寮鄉,上寮村,333,614,74.96947497,205,25.03052503,819,22,841,0,995,84.52261307
高雄縣,大寮鄉,三隆村,329,764,70.15610652,325,29.84389348,1089,5,1094,0,1308,83.63914373
高雄縣,大寮鄉,三隆村,330,733,66.5154265,369,33.4845735,1102,25,1127,0,1381,81.60753077
高雄縣,大寮鄉,三隆村,331,654,66.66666667,327,33.33333333,981,32,1013,0,1265,80.07905138
高雄縣,大寮鄉,琉球村,311,518,77.42899851,151,22.57100149,669,37,706,0,833,84.75390156
高雄縣,大寮鄉,琉球村,312,583,71.7097171,230,28.2902829,813,4,817,0,986,82.86004057
高雄縣,大寮鄉,琉球村,313,684,67.4556213,330,32.5443787,1014,49,1063,0,1248,85.17628205
高雄縣,大寮鄉,翁園村,309,958,76.03174603,302,23.96825397,1260,29,1289,1,1516,85.02638522
高雄縣,大寮鄉,翁園村,310,847,77.07006369,252,22.92993631,1099,32,1131,0,1333,84.84621155
高雄縣,大寮鄉,前庄村,294,533,69.40104167,235,30.59895833,768,25,793,0,920,86.19565217
高雄縣,大寮鄉,前庄村,295,452,53.42789598,394,46.57210402,846,11,857,2,1070,80.09345794
高雄縣,大寮鄉,中庄村,282,547,61.18568233,347,38.81431767,894,14,908,0,1109,81.87556357
高雄縣,大寮鄉,中庄村,283,541,67.4563591,261,32.5436409,802,20,822,0,1008,81.54761905
高雄縣,大寮鄉,中庄村,284,428,61.49425287,268,38.50574713,696,16,712,0,869,81.93325662
高雄縣,大寮鄉,中庄村,285,543,60.19955654,359,39.80044346,902,19,921,0,1127,81.72138421
高雄縣,大寮鄉,中庄村,286,513,68.4,237,31.6,750,12,762,0,963,79.12772586
高雄縣,大寮鄉,中庄村,287,566,60.34115139,372,39.65884861,938,9,947,0,1132,83.65724382
高雄縣,大寮鄉,中庄村,288,451,55.67901235,359,44.32098765,810,22,832,0,1039,80.07699711
高雄縣,大寮鄉,中庄村,289,606,67.18403548,296,32.81596452,902,17,919,0,1143,80.40244969
高雄縣,大寮鄉,後庄村,290,509,61.17788462,323,38.82211538,832,32,864,0,1113,77.62803235
高雄縣,大寮鄉,後庄村,291,583,58.06772908,421,41.93227092,1004,24,1028,0,1259,81.65210485
高雄縣,大寮鄉,後庄村,292,615,66.12903226,315,33.87096774,930,21,951,1,1192,79.78187919
高雄縣,大寮鄉,後庄村,293,737,58.67834395,519,41.32165605,1256,18,1274,2,1608,79.22885572
高雄縣,大寮鄉,義仁村,354,507,65.50387597,267,34.49612403,774,22,796,0,999,79.67967968
高雄縣,大寮鄉,義仁村,355,450,70.64364207,187,29.35635793,637,26,663,0,804,82.46268657
高雄縣,大寮鄉,新厝村,345,781,71.78308824,307,28.21691176,1088,51,1139,0,1429,79.70608817
高雄縣,大寮鄉,過溪村,346,551,64.44444444,304,35.55555556,855,29,884,0,1087,81.32474701
高雄縣,大寮鄉,過溪村,347,380,68.59205776,174,31.40794224,554,23,577,0,712,81.03932584
高雄縣,大寮鄉,潮寮村,348,691,72.50786988,262,27.49213012,953,42,995,1,1266,78.59399684
高雄縣,大寮鄉,潮寮村,349,779,71.86346863,305,28.13653137,1084,37,1121,0,1307,85.7689365
高雄縣,大寮鄉,會結村,350,616,62.85714286,364,37.14285714,980,37,1017,1,1246,81.6211878
高雄縣,大寮鄉,會社村,325,333,46.76966292,379,53.23033708,712,25,737,0,1040,70.86538462
高雄縣,大寮鄉,會社村,326,451,50.78828829,437,49.21171171,888,19,907,0,1079,84.05931418
高雄縣,大寮鄉,會社村,327,751,62.22038111,456,37.77961889,1207,23,1230,0,1502,81.89081225
高雄縣,大寮鄉,會社村,328,473,57.33333333,352,42.66666667,825,20,845,0,1057,79.94323557
高雄縣,大寮鄉,山頂村,320,635,67.98715203,299,32.01284797,934,28,962,0,1130,85.13274336
高雄縣,大寮鄉,山頂村,321,361,45.35175879,435,54.64824121,796,25,821,0,1014,80.96646943
高雄縣,大寮鄉,山頂村,322,275,40.50073638,404,59.49926362,679,6,685,0,935,73.26203209
高雄縣,大寮鄉,山頂村,323,514,53.65344468,444,46.34655532,958,23,981,0,1178,83.27674024
高雄縣,大寮鄉,山頂村,324,568,46.86468647,644,53.13531353,1212,28,1240,0,1481,83.72721134
高雄縣,大寮鄉,忠義村,301,93,14.19847328,562,85.80152672,655,17,672,1,814,82.55528256
高雄縣,大寮鄉,忠義村,302,142,15.63876652,766,84.36123348,908,22,930,0,1115,83.40807175
高雄縣,大寮鄉,永芳村,314,507,68.51351351,233,31.48648649,740,25,765,0,941,81.29649309
高雄縣,大寮鄉,永芳村,315,517,68.11594203,242,31.88405797,759,18,777,0,945,82.22222222
高雄縣,大寮鄉,永芳村,316,584,70.44632087,245,29.55367913,829,23,852,0,1029,82.79883382
高雄縣,大寮鄉,永芳村,317,415,58.1232493,299,41.8767507,714,23,737,0,907,81.25689085
高雄縣,大寮鄉,永芳村,318,511,53.5639413,443,46.4360587,954,17,971,0,1168,83.13356164
高雄縣,大寮鄉,永芳村,319,463,56.67074663,354,43.32925337,817,24,841,0,1004,83.76494024
高雄縣,大寮鄉,義和村,277,563,72.17948718,217,27.82051282,780,21,801,0,954,83.96226415
高雄縣,大寮鄉,義和村,278,559,67.34939759,271,32.65060241,830,26,856,0,1069,80.0748363
高雄縣,大寮鄉,溪寮村,279,797,69.12402428,356,30.87597572,1153,43,1196,0,1418,84.34414669
高雄縣,大寮鄉,江山村,280,405,68.76061121,184,31.23938879,589,3,592,0,685,86.42335766
高雄縣,大寮鄉,江山村,281,459,64.37587658,254,35.62412342,713,13,726,0,842,86.22327791
高雄縣,大寮鄉,昭明村,351,676,75.95505618,214,24.04494382,890,21,911,0,1094,83.27239488
高雄縣,大寮鄉,昭明村,352,523,71.84065934,205,28.15934066,728,33,761,0,965,78.86010363
高雄縣,大寮鄉,昭明村,353,489,65.81426649,254,34.18573351,743,28,771,0,968,79.64876033
高雄縣,大寮鄉,光武村,303,65,8.259212198,722,91.7407878,787,28,815,0,993,82.07452165
高雄縣,大寮鄉,光武村,304,42,5.323193916,747,94.67680608,789,26,815,0,1002,81.33732535
高雄縣,大寮鄉,復興村,305,19,2.954898911,624,97.04510109,643,22,665,0,796,83.54271357
高雄縣,大寮鄉,復興村,306,40,5.633802817,670,94.36619718,710,25,735,0,887,82.86358512
高雄縣,大寮鄉,復興村,307,39,4.887218045,759,95.11278195,798,18,816,0,976,83.60655738
高雄縣,大寮鄉,復興村,308,53,7.593123209,645,92.40687679,698,23,721,0,860,83.8372093
高雄縣,大寮鄉,中興村,296,485,40.75630252,705,59.24369748,1190,27,1217,0,1444,84.27977839
高雄縣,大寮鄉,中興村,297,413,42.88681205,550,57.11318795,963,24,987,0,1219,80.96800656
高雄縣,大寮鄉,中興村,298,339,38.52272727,541,61.47727273,880,16,896,0,1080,82.96296296
高雄縣,大寮鄉,中興村,299,209,26.32241814,585,73.67758186,794,26,820,0,954,85.95387841
高雄縣,大寮鄉,中興村,300,249,33.69418133,490,66.30581867,739,20,759,0,892,85.0896861
高雄縣,大樹鄉,竹寮村,356,541,64.71291866,295,35.28708134,836,20,856,0,1036,82.62548263
高雄縣,大樹鄉,竹寮村,357,449,50.7918552,435,49.2081448,884,21,905,0,1093,82.79963403
高雄縣,大樹鄉,九曲村,358,813,60.13313609,539,39.86686391,1352,28,1380,0,1770,77.96610169
高雄縣,大樹鄉,九曲村,359,576,55.97667638,453,44.02332362,1029,29,1058,0,1276,82.9153605
高雄縣,大樹鄉,九曲村,360,416,45.61403509,496,54.38596491,912,16,928,0,1136,81.69014085
高雄縣,大樹鄉,久堂村,361,549,51.84135977,510,48.15864023,1059,33,1092,0,1322,82.602118
高雄縣,大樹鄉,久堂村,362,487,55.2154195,395,44.7845805,882,29,911,0,1076,84.66542751
高雄縣,大樹鄉,久堂村,363,683,55.5736371,546,44.4263629,1229,46,1275,1,1534,83.11603651
高雄縣,大樹鄉,水安村,364,660,75.60137457,213,24.39862543,873,39,912,0,1090,83.66972477
高雄縣,大樹鄉,水安村,365,536,61.6091954,334,38.3908046,870,26,896,0,1076,83.27137546
高雄縣,大樹鄉,水寮村,366,595,67.61363636,285,32.38636364,880,35,915,1,1102,83.03085299
高雄縣,大樹鄉,水寮村,367,720,74.76635514,243,25.23364486,963,29,992,0,1177,84.28207307
高雄縣,大樹鄉,檨腳村,375,623,67.20604099,304,32.79395901,927,31,958,0,1158,82.72884283
高雄縣,大樹鄉,檨腳村,376,485,64.06869221,272,35.93130779,757,23,780,0,968,80.5785124
高雄縣,大樹鄉,檨腳村,377,613,70.94907407,251,29.05092593,864,30,894,0,1091,81.9431714
高雄縣,大樹鄉,興山村,378,682,77.58816837,197,22.41183163,879,38,917,0,1087,84.36062557
高雄縣,大樹鄉,和山村,379,573,72.53164557,217,27.46835443,790,24,814,0,955,85.23560209
高雄縣,大樹鄉,姑山村,380,564,73.53324641,203,26.46675359,767,37,804,0,976,82.37704918
高雄縣,大樹鄉,大坑村,382,810,73.7704918,288,26.2295082,1098,30,1128,0,1338,84.30493274
高雄縣,大樹鄉,井腳村,368,492,76.39751553,152,23.60248447,644,16,660,0,774,85.27131783
高雄縣,大樹鄉,井腳村,369,499,78.33594976,138,21.66405024,637,8,645,0,752,85.7712766
高雄縣,大樹鄉,小坪村,370,629,65.31671859,334,34.68328141,963,36,999,0,1222,81.7512275
高雄縣,大樹鄉,龍目村,371,468,79.45670628,121,20.54329372,589,20,609,0,717,84.93723849
高雄縣,大樹鄉,龍目村,372,583,79.64480874,149,20.35519126,732,29,761,0,865,87.97687861
高雄縣,大樹鄉,大樹村,373,618,67.39367503,299,32.60632497,917,28,945,0,1138,83.04042179
高雄縣,大樹鄉,大樹村,374,638,68.89848812,288,31.10151188,926,13,939,0,1120,83.83928571
高雄縣,大樹鄉,三和村,381,436,69.20634921,194,30.79365079,630,32,662,0,822,80.53527981
高雄縣,大樹鄉,溪埔村,383,486,78.51373183,133,21.48626817,619,28,647,0,768,84.24479167
高雄縣,大樹鄉,溪埔村,384,397,54.60797799,330,45.39202201,727,19,746,1,907,82.2491731
高雄縣,大樹鄉,興田村,385,588,74.14880202,205,25.85119798,793,28,821,0,1007,81.52929494
高雄縣,大樹鄉,興田村,386,227,29.32816537,547,70.67183463,774,21,795,0,913,87.07557503
高雄縣,大樹鄉,統嶺村,387,375,76.8442623,113,23.1557377,488,21,509,0,614,82.8990228
高雄縣,大社鄉,嘉誠村,388,459,63.31034483,266,36.68965517,725,46,771,0,944,81.67372881
高雄縣,大社鄉,保社村,389,597,66.48106904,301,33.51893096,898,41,939,1,1095,85.75342466
高雄縣,大社鄉,保社村,390,397,55.83684951,314,44.16315049,711,25,736,0,887,82.97632469
高雄縣,大社鄉,大社村,391,547,66.46415553,276,33.53584447,823,7,830,0,996,83.33333333
高雄縣,大社鄉,大社村,392,537,72.56756757,203,27.43243243,740,32,772,0,960,80.41666667
高雄縣,大社鄉,大社村,393,566,63.02895323,332,36.97104677,898,17,915,0,1069,85.5940131
高雄縣,大社鄉,大社村,394,549,61.47816349,344,38.52183651,893,8,901,0,1064,84.68045113
高雄縣,大社鄉,翠屏村,408,846,71.39240506,339,28.60759494,1185,42,1227,1,1471,83.41264446
高雄縣,大社鄉,三奶村,397,800,67.73920406,381,32.26079594,1181,46,1227,1,1489,82.40429819
高雄縣,大社鄉,三奶村,398,483,58.19277108,347,41.80722892,830,27,857,0,1017,84.26745329
高雄縣,大社鄉,觀音村,399,506,67.28723404,246,32.71276596,752,39,791,0,906,87.30684327
高雄縣,大社鄉,觀音村,400,745,66.04609929,383,33.95390071,1128,38,1166,0,1436,81.19777159
高雄縣,大社鄉,觀音村,401,587,62.64674493,350,37.35325507,937,27,964,1,1150,83.82608696
高雄縣,大社鄉,觀音村,402,541,60.71829405,350,39.28170595,891,15,906,0,1092,82.96703297
高雄縣,大社鄉,神農村,403,634,63.78269618,360,36.21730382,994,7,1001,0,1230,81.38211382
高雄縣,大社鄉,神農村,404,578,63.23851204,336,36.76148796,914,37,951,0,1190,79.91596639
高雄縣,大社鄉,神農村,405,547,60.77777778,353,39.22222222,900,45,945,0,1151,82.10251955
高雄縣,大社鄉,中里村,406,749,68.09090909,351,31.90909091,1100,51,1151,0,1377,83.58750908
高雄縣,大社鄉,中里村,407,632,58.79069767,443,41.20930233,1075,22,1097,0,1303,84.19033001
高雄縣,大社鄉,保安村,395,643,66.63212435,322,33.36787565,965,38,1003,1,1195,83.93305439
高雄縣,大社鄉,保安村,396,706,64.18181818,394,35.81818182,1100,33,1133,0,1335,84.86891386
高雄縣,仁武鄉,大灣村,430,673,68.39430894,311,31.60569106,984,27,1011,0,1195,84.60251046
高雄縣,仁武鄉,大灣村,431,350,61.08202443,223,38.91797557,573,13,586,0,720,81.38888889
高雄縣,仁武鄉,灣內村,436,824,66.29123089,419,33.70876911,1243,32,1275,1,1550,82.25806452
高雄縣,仁武鄉,灣內村,437,844,68.84176183,382,31.15823817,1226,33,1259,0,1605,78.4423676
高雄縣,仁武鄉,考潭村,439,497,54.37636761,417,45.62363239,914,30,944,0,1170,80.68376068
高雄縣,仁武鄉,考潭村,440,554,57.76850886,405,42.23149114,959,30,989,0,1227,80.60309698
高雄縣,仁武鄉,烏林村,441,400,54.42176871,335,45.57823129,735,28,763,0,929,82.131324
高雄縣,仁武鄉,烏林村,442,420,64.31852986,233,35.68147014,653,21,674,0,806,83.62282878
高雄縣,仁武鄉,烏林村,443,546,59.02702703,379,40.97297297,925,26,951,0,1177,80.79864061
高雄縣,仁武鄉,仁福村,444,327,68.84210526,148,31.15789474,475,20,495,0,600,82.5
高雄縣,仁武鄉,仁武村,409,754,65.05608283,405,34.94391717,1159,26,1185,0,1489,79.58361316
高雄縣,仁武鄉,仁武村,410,710,66.10800745,364,33.89199255,1074,27,1101,0,1315,83.72623574
高雄縣,仁武鄉,仁武村,411,816,67.71784232,389,32.28215768,1205,41,1246,0,1440,86.52777778
高雄縣,仁武鄉,文武村,412,679,73.08934338,250,26.91065662,929,36,965,0,1162,83.0464716
高雄縣,仁武鄉,文武村,413,591,62.53968254,354,37.46031746,945,29,974,0,1180,82.54237288
高雄縣,仁武鄉,文武村,414,746,68.06569343,350,31.93430657,1096,42,1138,0,1368,83.1871345
高雄縣,仁武鄉,文武村,415,729,57.8112609,532,42.1887391,1261,21,1282,0,1534,83.57235984
高雄縣,仁武鄉,竹後村,418,718,76.05932203,226,23.94067797,944,15,959,0,1110,86.3963964
高雄縣,仁武鄉,竹後村,419,658,75.54535017,213,24.45464983,871,27,898,0,1080,83.14814815
高雄縣,仁武鄉,八卦村,421,677,69.72193615,294,30.27806385,971,21,992,0,1190,83.36134454
高雄縣,仁武鄉,八卦村,422,587,63.32254585,340,36.67745415,927,11,938,0,1143,82.06474191
高雄縣,仁武鄉,八卦村,423,499,58.02325581,361,41.97674419,860,12,872,0,1071,81.41923436
高雄縣,仁武鄉,八卦村,424,795,62.40188383,479,37.59811617,1274,31,1305,0,1588,82.17884131
高雄縣,仁武鄉,八卦村,425,746,53.9017341,638,46.0982659,1384,24,1408,0,1707,82.48388987
高雄縣,仁武鄉,高楠村,428,500,68.58710562,229,31.41289438,729,20,749,0,897,83.50055741
高雄縣,仁武鄉,高楠村,429,466,67.34104046,226,32.65895954,692,31,723,0,830,87.10843373
高雄縣,仁武鄉,後安村,416,616,74.75728155,208,25.24271845,824,26,850,0,1029,82.60447036
高雄縣,仁武鄉,後安村,417,634,68.61471861,290,31.38528139,924,19,943,0,1138,82.86467487
高雄縣,仁武鄉,中華村,420,655,63.04138595,384,36.95861405,1039,35,1074,0,1362,78.85462555
高雄縣,仁武鄉,五和村,426,652,68.34381551,302,31.65618449,954,25,979,0,1212,80.77557756
高雄縣,仁武鄉,五和村,427,551,63.04347826,323,36.95652174,874,25,899,0,1093,82.25068618
高雄縣,仁武鄉,仁和村,434,621,68.16684962,290,31.83315038,911,18,929,0,1086,85.54327808
高雄縣,仁武鄉,仁和村,435,419,57.08446866,315,42.91553134,734,9,743,0,918,80.93681917
高雄縣,仁武鄉,赤山村,432,606,64.26299046,337,35.73700954,943,21,964,0,1158,83.24697755
高雄縣,仁武鄉,赤山村,433,694,63.4369287,400,36.5630713,1094,21,1115,0,1299,85.83525789
高雄縣,仁武鄉,仁慈村,438,643,59.04499541,446,40.95500459,1089,17,1106,1,1307,84.62127008
高雄縣,鳥松鄉,鳥松村,445,761,59.73312402,513,40.26687598,1274,26,1300,0,1594,81.55583438
高雄縣,鳥松鄉,鳥松村,446,650,54.53020134,542,45.46979866,1192,23,1215,0,1482,81.98380567
高雄縣,鳥松鄉,鳥松村,447,704,58.2781457,504,41.7218543,1208,19,1227,0,1554,78.95752896
高雄縣,鳥松鄉,鳥松村,448,686,51.96969697,634,48.03030303,1320,10,1330,1,1643,80.94948265
高雄縣,鳥松鄉,鳥松村,449,716,61.61790017,446,38.38209983,1162,35,1197,0,1451,82.49483115
高雄縣,鳥松鄉,夢裡村,450,619,61.96196196,380,38.03803804,999,29,1028,0,1225,83.91836735
高雄縣,鳥松鄉,夢裡村,451,740,56.92307692,560,43.07692308,1300,32,1332,0,1607,82.88736777
高雄縣,鳥松鄉,大華村,452,791,63.07814992,463,36.92185008,1254,8,1262,0,1501,84.07728181
高雄縣,鳥松鄉,大華村,453,654,51.65876777,612,48.34123223,1266,26,1292,0,1579,81.8239392
高雄縣,鳥松鄉,大華村,454,657,54.25268373,554,45.74731627,1211,16,1227,0,1495,82.0735786
高雄縣,鳥松鄉,大華村,455,756,55.18248175,614,44.81751825,1370,14,1384,0,1656,83.57487923
高雄縣,鳥松鄉,大華村,456,612,53.59019264,530,46.40980736,1142,20,1162,0,1406,82.6458037
高雄縣,鳥松鄉,濫埔村,457,825,70.57313944,344,29.42686056,1169,27,1196,0,1434,83.40306834
高雄縣,鳥松鄉,濫埔村,458,807,64.87138264,437,35.12861736,1244,29,1273,0,1510,84.30463576
高雄縣,鳥松鄉,仁美村,459,710,68.99902818,319,31.00097182,1029,33,1062,0,1270,83.62204724
高雄縣,鳥松鄉,仁美村,460,657,63.11239193,384,36.88760807,1041,34,1075,2,1256,85.58917197
高雄縣,鳥松鄉,仁美村,461,892,66.51752424,449,33.48247576,1341,27,1368,0,1653,82.75862069
高雄縣,鳥松鄉,仁美村,462,709,59.73041281,478,40.26958719,1187,26,1213,0,1523,79.64543664
高雄縣,鳥松鄉,大竹村,465,364,64.76868327,198,35.23131673,562,21,583,0,697,83.64418938
高雄縣,鳥松鄉,華美村,463,709,57.31608731,528,42.68391269,1237,41,1278,0,1574,81.19440915
高雄縣,鳥松鄉,華美村,464,810,59.9112426,542,40.0887574,1352,23,1375,2,1661,82.78145695
高雄縣,岡山鎮,平安里,469,584,60.02055498,389,39.97944502,973,25,998,0,1235,80.8097166
高雄縣,岡山鎮,岡山里,466,580,51.19152692,553,48.80847308,1133,24,1157,0,1376,84.08430233
高雄縣,岡山鎮,岡山里,467,533,57.49730313,394,42.50269687,927,20,947,0,1188,79.71380471
高雄縣,岡山鎮,岡山里,468,583,61.69312169,362,38.30687831,945,25,970,0,1220,79.50819672
高雄縣,岡山鎮,壽天里,470,513,48.48771267,545,51.51228733,1058,25,1083,0,1301,83.24365872
高雄縣,岡山鎮,壽天里,471,439,46.55355249,504,53.44644751,943,15,958,1,1168,82.02054795
高雄縣,岡山鎮,壽天里,472,342,65.76923077,178,34.23076923,520,9,529,0,655,80.76335878
高雄縣,岡山鎮,維仁里,473,283,60.72961373,183,39.27038627,466,15,481,0,590,81.52542373
高雄縣,岡山鎮,維仁里,474,296,62.57928118,177,37.42071882,473,21,494,0,608,81.25
高雄縣,岡山鎮,後紅里,477,634,64.43089431,350,35.56910569,984,27,1011,0,1241,81.46655923
高雄縣,岡山鎮,後紅里,478,627,43.12242091,827,56.87757909,1454,18,1472,0,1806,81.50609081
高雄縣,岡山鎮,大遼里,476,790,76.84824903,238,23.15175097,1028,40,1068,0,1250,85.44
高雄縣,岡山鎮,忠孝里,519,129,38.97280967,202,61.02719033,331,5,336,0,427,78.68852459
高雄縣,岡山鎮,和平里,520,117,15.74697174,626,84.25302826,743,16,759,0,924,82.14285714
高雄縣,岡山鎮,前峰里,489,539,58.77862595,378,41.22137405,917,36,953,0,1121,85.01338091
高雄縣,岡山鎮,前峰里,490,551,52.47619048,499,47.52380952,1050,38,1088,0,1322,82.29954614
高雄縣,岡山鎮,劉厝里,506,784,72.45841035,298,27.54158965,1082,43,1125,0,1326,84.84162896
高雄縣,岡山鎮,協和里,496,551,52.72727273,494,47.27272727,1045,37,1082,0,1306,82.84839204
高雄縣,岡山鎮,協和里,497,619,54.6337158,514,45.3662842,1133,8,1141,1,1401,81.44182727
高雄縣,岡山鎮,協和里,498,35,8.293838863,387,91.70616114,422,11,433,0,509,85.06876228
高雄縣,岡山鎮,後協里,500,434,48.81889764,455,51.18110236,889,27,916,0,1136,80.63380282
高雄縣,岡山鎮,後協里,501,460,52.99539171,408,47.00460829,868,19,887,0,1072,82.74253731
高雄縣,岡山鎮,後協里,502,395,44.18344519,499,55.81655481,894,18,912,0,1116,81.72043011
高雄縣,岡山鎮,後協里,503,459,40.76376554,667,59.23623446,1126,23,1149,0,1411,81.43160879
高雄縣,岡山鎮,信義里,521,108,13.81074169,674,86.18925831,782,4,786,0,937,83.88473853
高雄縣,岡山鎮,信義里,522,379,39.23395445,587,60.76604555,966,22,988,0,1192,82.88590604
高雄縣,岡山鎮,仁愛里,523,18,3.719008264,466,96.28099174,484,11,495,0,584,84.76027397
高雄縣,岡山鎮,仁愛里,524,17,2.782324059,594,97.21767594,611,21,632,0,762,82.93963255
高雄縣,岡山鎮,復興里,527,9,2.521008403,348,97.4789916,357,8,365,0,445,82.02247191
高雄縣,岡山鎮,潭底里,515,439,70.57877814,183,29.42122186,622,31,653,0,747,87.41633199
高雄縣,岡山鎮,三和里,517,496,78.48101266,136,21.51898734,632,4,636,0,772,82.38341969
高雄縣,岡山鎮,仁壽里,493,521,60.0922722,346,39.9077278,867,17,884,0,1049,84.27073403
高雄縣,岡山鎮,仁壽里,494,415,53.34190231,363,46.65809769,778,20,798,0,960,83.125
高雄縣,岡山鎮,仁壽里,495,475,45.98257502,558,54.01742498,1033,25,1058,0,1264,83.70253165
高雄縣,岡山鎮,四維里,525,14,3.153153153,430,96.84684685,444,7,451,0,533,84.61538462
高雄縣,岡山鎮,四維里,526,28,5.2141527,509,94.7858473,537,14,551,0,639,86.228482
高雄縣,岡山鎮,碧紅里,479,729,56.03382014,572,43.96617986,1301,27,1328,0,1585,83.78548896
高雄縣,岡山鎮,碧紅里,480,633,55.57506585,506,44.42493415,1139,17,1156,0,1395,82.86738351
高雄縣,岡山鎮,程香里,481,719,54.46969697,601,45.53030303,1320,29,1349,0,1593,84.68298807
高雄縣,岡山鎮,程香里,482,532,45.58697515,635,54.41302485,1167,32,1199,0,1452,82.57575758
高雄縣,岡山鎮,竹圍里,483,622,51.06732348,596,48.93267652,1218,19,1237,0,1525,81.1147541
高雄縣,岡山鎮,竹圍里,484,695,55.42264753,559,44.57735247,1254,10,1264,0,1537,82.23812622
高雄縣,岡山鎮,竹圍里,485,693,61.6,432,38.4,1125,34,1159,0,1370,84.59854015
高雄縣,岡山鎮,臺上里,486,916,61.35298058,577,38.64701942,1493,45,1538,0,1886,81.54825027
高雄縣,岡山鎮,臺上里,487,884,58.54304636,626,41.45695364,1510,42,1552,0,1842,84.25624321
高雄縣,岡山鎮,灣裡里,475,649,59.05368517,450,40.94631483,1099,43,1142,0,1339,85.28752801
高雄縣,岡山鎮,白米里,507,570,55.07246377,465,44.92753623,1035,27,1062,0,1229,86.41171684
高雄縣,岡山鎮,石潭里,508,754,74.43237907,259,25.56762093,1013,39,1052,0,1246,84.43017657
高雄縣,岡山鎮,福興里,509,478,57.86924939,348,42.13075061,826,33,859,0,1003,85.64307079
高雄縣,岡山鎮,本洲里,499,768,65.86620926,398,34.13379074,1166,47,1213,0,1449,83.71290545
高雄縣,岡山鎮,嘉興里,510,627,71.57534247,249,28.42465753,876,40,916,0,1086,84.34622468
高雄縣,岡山鎮,嘉興里,511,577,71.49938042,230,28.50061958,807,38,845,0,1012,83.49802372
高雄縣,岡山鎮,嘉興里,512,600,69.93006993,258,30.06993007,858,32,890,0,1093,81.42726441
高雄縣,岡山鎮,嘉峰里,513,667,62.16216216,406,37.83783784,1073,44,1117,0,1329,84.04815651
高雄縣,岡山鎮,嘉峰里,514,199,77.13178295,59,22.86821705,258,8,266,0,304,87.5
高雄縣,岡山鎮,華崗里,516,906,81.99095023,199,18.00904977,1105,63,1168,0,1352,86.39053254
高雄縣,岡山鎮,大莊里,518,383,53.64145658,331,46.35854342,714,35,749,0,892,83.96860987
高雄縣,岡山鎮,協榮里,504,392,42.15053763,538,57.84946237,930,36,966,0,1164,82.98969072
高雄縣,岡山鎮,協榮里,505,239,36.76923077,411,63.23076923,650,12,662,0,795,83.27044025
高雄縣,岡山鎮,為隨里,488,354,73.4439834,128,26.5560166,482,37,519,0,596,87.08053691
高雄縣,岡山鎮,壽峰里,491,435,52.03349282,401,47.96650718,836,21,857,1,1045,82.00956938
高雄縣,岡山鎮,壽峰里,492,381,50.86782377,368,49.13217623,749,9,758,0,889,85.26434196
高雄縣,橋頭鄉,橋頭村,528,540,63.23185012,314,36.76814988,854,26,880,1,1036,84.94208494
高雄縣,橋頭鄉,橋頭村,529,379,63.8047138,215,36.1952862,594,15,609,0,721,84.46601942
高雄縣,橋頭鄉,橋南村,530,596,64.57204767,327,35.42795233,923,21,944,0,1121,84.21052632
高雄縣,橋頭鄉,仕隆村,531,497,69.31659693,220,30.68340307,717,30,747,0,907,82.35942668
高雄縣,橋頭鄉,仕隆村,532,668,67.33870968,324,32.66129032,992,36,1028,0,1225,83.91836735
高雄縣,橋頭鄉,仕豐村,533,519,61.27508855,328,38.72491145,847,27,874,0,1064,82.14285714
高雄縣,橋頭鄉,仕豐村,534,593,65.23652365,316,34.76347635,909,24,933,0,1130,82.56637168
高雄縣,橋頭鄉,芋寮村,549,692,75.6284153,223,24.3715847,915,44,959,0,1118,85.77817531
高雄縣,橋頭鄉,東林村,553,605,71.85273159,237,28.14726841,842,38,880,0,1059,83.09726157
高雄縣,橋頭鄉,東林村,554,676,74.04162103,237,25.95837897,913,33,946,0,1104,85.6884058
高雄縣,橋頭鄉,西林村,551,471,77.59472817,136,22.40527183,607,10,617,0,730,84.52054795
高雄縣,橋頭鄉,西林村,552,424,68.71961102,193,31.28038898,617,23,640,0,759,84.32147563
高雄縣,橋頭鄉,白樹村,546,830,64.79313037,451,35.20686963,1281,37,1318,0,1608,81.96517413
高雄縣,橋頭鄉,白樹村,547,476,66.01941748,245,33.98058252,721,13,734,0,873,84.07789233
高雄縣,橋頭鄉,白樹村,548,4,1.851851852,212,98.14814815,216,10,226,0,269,84.01486989
高雄縣,橋頭鄉,筆秀村,556,324,65.72008114,169,34.27991886,493,17,510,0,586,87.03071672
高雄縣,橋頭鄉,筆秀村,557,541,74.62068966,184,25.37931034,725,31,756,0,902,83.81374723
高雄縣,橋頭鄉,新莊村,538,490,75.15337423,162,24.84662577,652,40,692,0,794,87.15365239
高雄縣,橋頭鄉,新莊村,539,176,66.41509434,89,33.58490566,265,7,272,0,311,87.45980707
高雄縣,橋頭鄉,新莊村,540,27,17.30769231,129,82.69230769,156,5,161,0,185,87.02702703
高雄縣,橋頭鄉,甲北村,541,652,70.56277056,272,29.43722944,924,44,968,0,1114,86.8940754
高雄縣,橋頭鄉,甲北村,542,411,60.88888889,264,39.11111111,675,23,698,1,848,82.31132075
高雄縣,橋頭鄉,甲南村,543,542,62.08476518,331,37.91523482,873,33,906,0,1093,82.89112534
高雄縣,橋頭鄉,甲南村,544,560,65.04065041,301,34.95934959,861,38,899,0,1045,86.02870813
高雄縣,橋頭鄉,頂鹽村,545,587,67.08571429,288,32.91428571,875,31,906,0,1053,86.03988604
高雄縣,橋頭鄉,中崎村,558,385,75.34246575,126,24.65753425,511,32,543,0,655,82.90076336
高雄縣,橋頭鄉,仕和村,535,664,69.89473684,286,30.10526316,950,33,983,0,1148,85.6271777
高雄縣,橋頭鄉,仕和村,536,625,65.78947368,325,34.21052632,950,25,975,0,1142,85.3765324
高雄縣,橋頭鄉,仕和村,537,534,64.41495778,295,35.58504222,829,18,847,0,987,85.81560284
高雄縣,橋頭鄉,德松村,555,636,69.43231441,280,30.56768559,916,15,931,0,1096,84.94525547
高雄縣,橋頭鄉,三德村,550,478,77.22132472,141,22.77867528,619,20,639,0,740,86.35135135
高雄縣,燕巢鄉,尖山村,560,621,72.20930233,239,27.79069767,860,47,907,0,1119,81.05451296
高雄縣,燕巢鄉,瓊林村,568,403,64.48,222,35.52,625,29,654,0,799,81.85231539
高雄縣,燕巢鄉,瓊林村,569,545,67.87048568,258,32.12951432,803,38,841,0,994,84.60764588
高雄縣,燕巢鄉,安招村,570,766,67.78761062,364,32.21238938,1130,40,1170,0,1414,82.74398868
高雄縣,燕巢鄉,安招村,571,677,61.15627823,430,38.84372177,1107,65,1172,0,1409,83.17955997
高雄縣,燕巢鄉,安招村,572,10,3.436426117,281,96.56357388,291,43,334,0,542,61.62361624
高雄縣,燕巢鄉,安招村,573,11,4.104477612,257,95.89552239,268,64,332,0,573,57.94066318
高雄縣,燕巢鄉,角宿村,574,420,59.65909091,284,40.34090909,704,27,731,1,868,84.21658986
高雄縣,燕巢鄉,角宿村,575,347,78.86363636,93,21.13636364,440,24,464,0,560,82.85714286
高雄縣,燕巢鄉,角宿村,576,376,58.56697819,266,41.43302181,642,18,660,0,808,81.68316832
高雄縣,燕巢鄉,鳳雄村,577,537,62.29698376,325,37.70301624,862,32,894,0,1058,84.49905482
高雄縣,燕巢鄉,鳳雄村,578,526,50.82125604,509,49.17874396,1035,30,1065,0,1238,86.02584814
高雄縣,燕巢鄉,金山村,559,224,62.92134831,132,37.07865169,356,9,365,0,440,82.95454545
高雄縣,燕巢鄉,東燕村,561,750,68.99724011,337,31.00275989,1087,60,1147,0,1354,84.71196455
高雄縣,燕巢鄉,東燕村,562,418,58.70786517,294,41.29213483,712,33,745,0,882,84.46712018
高雄縣,燕巢鄉,南燕村,566,558,52.10084034,513,47.89915966,1071,50,1121,0,1372,81.70553936
高雄縣,燕巢鄉,南燕村,567,600,55.60704356,479,44.39295644,1079,39,1118,0,1341,83.37061894
高雄縣,燕巢鄉,西燕村,563,496,57.6744186,364,42.3255814,860,49,909,0,1076,84.4795539
高雄縣,燕巢鄉,西燕村,564,441,61.59217877,275,38.40782123,716,26,742,0,920,80.65217391
高雄縣,燕巢鄉,西燕村,565,507,60.5734767,330,39.4265233,837,31,868,0,1057,82.1192053
高雄縣,燕巢鄉,橫山村,579,466,62.38286479,281,37.61713521,747,28,775,1,939,82.53461129
高雄縣,燕巢鄉,橫山村,580,416,63.31811263,241,36.68188737,657,29,686,0,857,80.04667445
高雄縣,燕巢鄉,深水村,581,607,62.25641026,368,37.74358974,975,49,1024,0,1237,82.78092158
高雄縣,燕巢鄉,深水村,582,494,57.04387991,372,42.95612009,866,44,910,0,1175,77.44680851
高雄縣,田寮鄉,鹿埔村,583,165,57.69230769,121,42.30769231,286,16,302,0,368,82.06521739
高雄縣,田寮鄉,南安村,588,392,64.90066225,212,35.09933775,604,32,636,0,790,80.50632911
高雄縣,田寮鄉,南安村,589,327,77.48815166,95,22.51184834,422,27,449,0,545,82.3853211
高雄縣,田寮鄉,大同村,590,269,80.05952381,67,19.94047619,336,2,338,0,421,80.28503563
高雄縣,田寮鄉,田寮村,591,202,66.66666667,101,33.33333333,303,23,326,0,430,75.81395349
高雄縣,田寮鄉,七星村,592,507,74.23133236,176,25.76866764,683,49,732,0,886,82.61851016
高雄縣,田寮鄉,崇德村,585,447,59.20529801,308,40.79470199,755,32,787,0,965,81.55440415
高雄縣,田寮鄉,西德村,587,493,68.47222222,227,31.52777778,720,7,727,0,888,81.86936937
高雄縣,田寮鄉,三和村,586,164,56.16438356,128,43.83561644,292,28,320,0,416,76.92307692
高雄縣,田寮鄉,古亭村,584,313,65.89473684,162,34.10526316,475,44,519,0,672,77.23214286
高雄縣,田寮鄉,新興村,593,725,70.593963,302,29.406037,1027,73,1100,0,1315,83.65019011
高雄縣,阿蓮鄉,石安村,605,774,75.5859375,250,24.4140625,1024,60,1084,0,1295,83.70656371
高雄縣,阿蓮鄉,中路村,606,601,75.69269521,193,24.30730479,794,37,831,0,1007,82.52234359
高雄縣,阿蓮鄉,中路村,607,559,75.84803256,178,24.15196744,737,37,774,0,934,82.86937901
高雄縣,阿蓮鄉,峰山村,608,578,65.23702032,308,34.76297968,886,46,932,0,1119,83.28865058
高雄縣,阿蓮鄉,港後村,609,593,56.96445725,448,43.03554275,1041,61,1102,0,1337,82.42333583
高雄縣,阿蓮鄉,港後村,610,254,61.20481928,161,38.79518072,415,13,428,0,512,83.59375
高雄縣,阿蓮鄉,崗山村,611,359,63.53982301,206,36.46017699,565,37,602,0,733,82.12824011
高雄縣,阿蓮鄉,阿蓮村,594,531,64.13043478,297,35.86956522,828,8,836,0,1013,82.52714709
高雄縣,阿蓮鄉,阿蓮村,595,544,62.31386025,329,37.68613975,873,41,914,0,1125,81.24444444
高雄縣,阿蓮鄉,阿蓮村,596,557,64.17050691,311,35.82949309,868,23,891,0,1086,82.0441989
高雄縣,阿蓮鄉,阿蓮村,597,472,61.37841352,297,38.62158648,769,17,786,0,973,80.78108941
高雄縣,阿蓮鄉,清蓮村,600,782,66.27118644,398,33.72881356,1180,47,1227,0,1473,83.299389
高雄縣,阿蓮鄉,清蓮村,601,535,60.93394077,343,39.06605923,878,40,918,0,1096,83.75912409
高雄縣,阿蓮鄉,和蓮村,602,546,71.18644068,221,28.81355932,767,37,804,0,949,84.72075869
高雄縣,阿蓮鄉,和蓮村,603,604,70.23255814,256,29.76744186,860,52,912,0,1108,82.31046931
高雄縣,阿蓮鄉,青旗村,604,627,60.17274472,415,39.82725528,1042,51,1093,0,1346,81.20356612
高雄縣,阿蓮鄉,復安村,612,441,67.32824427,214,32.67175573,655,37,692,0,819,84.49328449
高雄縣,阿蓮鄉,復安村,613,312,51.74129353,291,48.25870647,603,24,627,0,769,81.53446034
高雄縣,阿蓮鄉,玉庫村,614,572,72.95918367,212,27.04081633,784,42,826,0,987,83.68794326
高雄縣,阿蓮鄉,南蓮村,598,661,58.08435852,477,41.91564148,1138,40,1178,0,1452,81.12947658
高雄縣,阿蓮鄉,南蓮村,599,577,55.6412729,460,44.3587271,1037,31,1068,0,1254,85.16746411
高雄縣,路竹鄉,竹滬村,642,598,62.61780105,357,37.38219895,955,34,989,0,1264,78.24367089
高雄縣,路竹鄉,竹滬村,643,634,62.15686275,386,37.84313725,1020,52,1072,1,1339,80.05974608
高雄縣,路竹鄉,頂寮村,644,593,65.30837004,315,34.69162996,908,48,956,0,1171,81.63962425
高雄縣,路竹鄉,新達村,645,527,56.3034188,409,43.6965812,936,58,994,0,1196,83.11036789
高雄縣,路竹鄉,後鄉村,646,474,62.45059289,285,37.54940711,759,31,790,0,933,84.67309753
高雄縣,路竹鄉,北嶺村,647,552,60.52631579,360,39.47368421,912,35,947,0,1118,84.70483005
高雄縣,路竹鄉,社西村,627,463,54.79289941,382,45.20710059,845,46,891,0,1064,83.7406015
高雄縣,路竹鄉,社西村,628,566,61.12311015,360,38.87688985,926,43,969,0,1153,84.04163053
高雄縣,路竹鄉,甲北村,622,492,64.48230668,271,35.51769332,763,30,793,0,947,83.73812038
高雄縣,路竹鄉,甲北村,623,476,58.83807169,333,41.16192831,809,33,842,0,1017,82.79252704
高雄縣,路竹鄉,甲南村,619,451,58.26873385,323,41.73126615,774,35,809,0,952,84.9789916
高雄縣,路竹鄉,甲南村,620,359,46.9895288,405,53.0104712,764,28,792,0,914,86.65207877
高雄縣,路竹鄉,甲南村,621,374,44.73684211,462,55.26315789,836,51,887,0,1077,82.35840297
高雄縣,路竹鄉,下坑村,617,556,56.56154629,427,43.43845371,983,46,1029,0,1223,84.13736713
高雄縣,路竹鄉,下坑村,618,607,59.68534907,410,40.31465093,1017,51,1068,0,1292,82.6625387
高雄縣,路竹鄉,竹園村,615,343,52.20700152,314,47.79299848,657,6,663,0,795,83.39622642
高雄縣,路竹鄉,竹園村,616,498,69.74789916,216,30.25210084,714,56,770,0,915,84.15300546
高雄縣,路竹鄉,竹東村,632,660,54.81727575,544,45.18272425,1204,28,1232,0,1490,82.68456376
高雄縣,路竹鄉,竹東村,633,638,56.81211042,485,43.18788958,1123,27,1150,0,1369,84.00292184
高雄縣,路竹鄉,竹西村,636,489,57.52941176,361,42.47058824,850,39,889,0,1037,85.72806172
高雄縣,路竹鄉,竹西村,637,473,52.26519337,432,47.73480663,905,26,931,0,1107,84.10117435
高雄縣,路竹鄉,文北村,640,578,58.91946993,403,41.08053007,981,53,1034,0,1253,82.52194733
高雄縣,路竹鄉,文北村,641,681,59.68448729,460,40.31551271,1141,46,1187,0,1474,80.52917232
高雄縣,路竹鄉,文南村,638,529,57.25108225,395,42.74891775,924,34,958,1,1133,84.55428067
高雄縣,路竹鄉,文南村,639,463,53.7746806,398,46.2253194,861,31,892,1,1043,85.52253116
高雄縣,路竹鄉,三爺村,648,460,65.80829757,239,34.19170243,699,50,749,0,882,84.92063492
高雄縣,路竹鄉,鴨寮村,649,731,58.52682146,518,41.47317854,1249,44,1293,0,1550,83.41935484
高雄縣,路竹鄉,社東村,624,383,62.88998358,226,37.11001642,609,28,637,0,781,81.56209987
高雄縣,路竹鄉,社東村,625,404,64.02535658,227,35.97464342,631,36,667,0,799,83.47934919
高雄縣,路竹鄉,社中村,626,404,58.2972583,289,41.7027417,693,41,734,0,890,82.47191011
高雄縣,路竹鄉,竹南村,634,691,59.1609589,477,40.8390411,1168,32,1200,0,1453,82.58774948
高雄縣,路竹鄉,竹南村,635,501,51.22699387,477,48.77300613,978,22,1000,0,1224,81.69934641
高雄縣,路竹鄉,社南村,629,535,60.52036199,349,39.47963801,884,41,925,0,1123,82.36865539
高雄縣,路竹鄉,社南村,630,523,56.41855448,404,43.58144552,927,18,945,0,1161,81.39534884
高雄縣,路竹鄉,社南村,631,570,57.69230769,418,42.30769231,988,42,1030,0,1253,82.20271349
高雄縣,湖內鄉,海山村,661,624,65.68421053,326,34.31578947,950,50,1000,0,1171,85.3970965
高雄縣,湖內鄉,劉家村,662,633,73.43387471,229,26.56612529,862,39,901,0,1080,83.42592593
高雄縣,湖內鄉,太爺村,663,435,66.41221374,220,33.58778626,655,26,681,0,835,81.55688623
高雄縣,湖內鄉,公館村,664,373,66.72629696,186,33.27370304,559,18,577,0,686,84.11078717
高雄縣,湖內鄉,公館村,665,479,59.57711443,325,40.42288557,804,14,818,0,993,82.37663646
高雄縣,湖內鄉,葉厝村,666,498,68.78453039,226,31.21546961,724,28,752,0,904,83.18584071
高雄縣,湖內鄉,葉厝村,667,526,67.6092545,252,32.3907455,778,25,803,0,975,82.35897436
高雄縣,湖內鄉,葉厝村,670,572,66.05080831,294,33.94919169,866,34,900,0,1115,80.71748879
高雄縣,湖內鄉,大湖村,650,301,55.0274223,246,44.9725777,547,23,570,0,670,85.07462687
高雄縣,湖內鄉,大湖村,651,405,63.47962382,233,36.52037618,638,23,661,0,781,84.63508323
高雄縣,湖內鄉,大湖村,652,487,52.64864865,438,47.35135135,925,28,953,0,1113,85.62443845
高雄縣,湖內鄉,田尾村,653,498,59.71223022,336,40.28776978,834,34,868,0,1063,81.65569144
高雄縣,湖內鄉,湖內村,654,356,61.16838488,226,38.83161512,582,21,603,0,727,82.94360385
高雄縣,湖內鄉,湖內村,655,464,72.04968944,180,27.95031056,644,19,663,0,786,84.35114504
高雄縣,湖內鄉,湖內村,656,490,49.5951417,498,50.4048583,988,10,998,0,1247,80.03207698
高雄縣,湖內鄉,海埔村,659,477,74.76489028,161,25.23510972,638,24,662,0,802,82.5436409
高雄縣,湖內鄉,海埔村,660,509,67.06192358,250,32.93807642,759,30,789,0,952,82.87815126
高雄縣,湖內鄉,文賢村,668,702,72.52066116,266,27.47933884,968,39,1007,0,1196,84.19732441
高雄縣,湖內鄉,中賢村,669,455,63.7254902,259,36.2745098,714,12,726,0,917,79.17121047
高雄縣,湖內鄉,逸賢村,671,555,70.07575758,237,29.92424242,792,4,796,0,991,80.32290616
高雄縣,湖內鄉,忠興村,672,403,65.8496732,209,34.1503268,612,23,635,0,751,84.5539281
高雄縣,湖內鄉,湖東村,657,374,46.63341646,428,53.36658354,802,26,828,0,1026,80.70175439
高雄縣,湖內鄉,湖東村,658,365,49.79536153,368,50.20463847,733,20,753,0,942,79.93630573
高雄縣,茄萣鄉,福德村,673,652,74.17519909,227,25.82480091,879,8,887,0,1042,85.12476008
高雄縣,茄萣鄉,萬福村,674,431,60.19553073,285,39.80446927,716,19,735,0,900,81.66666667
高雄縣,茄萣鄉,白雲村,675,745,60.1291364,494,39.8708636,1239,50,1289,0,1604,80.36159601
高雄縣,茄萣鄉,嘉賜村,676,669,64.38883542,370,35.61116458,1039,43,1082,0,1378,78.51959361
高雄縣,茄萣鄉,嘉賜村,677,746,62.21851543,453,37.78148457,1199,20,1219,0,1466,83.15143247
高雄縣,茄萣鄉,嘉安村,678,680,59.54465849,462,40.45534151,1142,38,1180,0,1452,81.26721763
高雄縣,茄萣鄉,嘉定村,683,616,62.7930683,365,37.2069317,981,36,1017,0,1298,78.35130971
高雄縣,茄萣鄉,保定村,684,650,66.12410987,333,33.87589013,983,35,1018,0,1275,79.84313725
高雄縣,茄萣鄉,保定村,685,864,63.85809313,489,36.14190687,1353,8,1361,0,1700,80.05882353
高雄縣,茄萣鄉,光定村,687,507,62.20858896,308,37.79141104,815,39,854,0,1064,80.26315789
高雄縣,茄萣鄉,大定村,686,545,57.61099366,401,42.38900634,946,33,979,0,1197,81.78780284
高雄縣,茄萣鄉,吉定村,688,693,69.23076923,308,30.76923077,1001,36,1037,1,1261,82.23632038
高雄縣,茄萣鄉,嘉樂村,679,994,66.98113208,490,33.01886792,1484,53,1537,0,1878,81.84238552
高雄縣,茄萣鄉,嘉泰村,680,601,65.11375948,322,34.88624052,923,43,966,0,1190,81.17647059
高雄縣,茄萣鄉,嘉福村,681,488,64.37994723,270,35.62005277,758,23,781,0,987,79.12867275
高雄縣,茄萣鄉,和協村,682,641,66.77083333,319,33.22916667,960,32,992,0,1215,81.64609053
高雄縣,茄萣鄉,崎漏村,689,765,59.765625,515,40.234375,1280,58,1338,0,1720,77.79069767
高雄縣,茄萣鄉,崎漏村,690,829,58.09390329,598,41.90609671,1427,17,1444,0,1908,75.68134172
高雄縣,永安鄉,永安村,691,258,47.86641929,281,52.13358071,539,30,569,0,708,80.36723164
高雄縣,永安鄉,永安村,692,315,51.47058824,297,48.52941176,612,31,643,0,789,81.49556401
高雄縣,永安鄉,永華村,693,338,51.68195719,316,48.31804281,654,25,679,0,840,80.83333333
高雄縣,永安鄉,永華村,694,394,56.12535613,308,43.87464387,702,9,711,0,881,80.70374574
高雄縣,永安鄉,新港村,695,428,54.87179487,352,45.12820513,780,25,805,0,960,83.85416667
高雄縣,永安鄉,新港村,696,373,69.45996276,164,30.54003724,537,18,555,0,718,77.29805014
高雄縣,永安鄉,新港村,697,302,55.51470588,242,44.48529412,544,16,560,0,706,79.32011331
高雄縣,永安鄉,鹽田村,698,197,69.36619718,87,30.63380282,284,9,293,0,385,76.1038961
高雄縣,永安鄉,保寧村,699,416,49.88009592,418,50.11990408,834,46,880,0,1042,84.45297505
高雄縣,永安鄉,保寧村,700,426,54.40613027,357,45.59386973,783,14,797,0,998,79.85971944
高雄縣,永安鄉,維新村,701,664,63.11787072,388,36.88212928,1052,49,1101,0,1281,85.94847775
高雄縣,永安鄉,維新村,702,646,60.657277,419,39.342723,1065,45,1110,1,1353,82.03991131
高雄縣,彌陀鄉,光和村,707,509,57.44920993,377,42.55079007,886,32,918,0,1083,84.76454294
高雄縣,彌陀鄉,彌靖村,708,835,56.53351388,642,43.46648612,1477,40,1517,0,1842,82.35613464
高雄縣,彌陀鄉,彌仁村,709,262,53.57873211,227,46.42126789,489,21,510,0,597,85.42713568
高雄縣,彌陀鄉,彌壽村,710,293,49.57698816,298,50.42301184,591,22,613,0,728,84.2032967
高雄縣,彌陀鄉,彌陀村,711,653,51.41732283,617,48.58267717,1270,47,1317,0,1552,84.85824742
高雄縣,彌陀鄉,舊港村,703,683,57.49158249,505,42.50841751,1188,60,1248,0,1516,82.32189974
高雄縣,彌陀鄉,文安村,704,854,60.35335689,561,39.64664311,1415,66,1481,1,1813,81.68781026
高雄縣,彌陀鄉,鹽埕村,705,915,59.22330097,630,40.77669903,1545,75,1620,0,1917,84.50704225
高雄縣,彌陀鄉,過港村,706,455,57.74111675,333,42.25888325,788,50,838,0,998,83.96793587
高雄縣,彌陀鄉,海尾村,712,319,50.31545741,315,49.68454259,634,35,669,0,846,79.07801418
高雄縣,彌陀鄉,漯底村,713,472,56.73076923,360,43.26923077,832,49,881,0,1010,87.22772277
高雄縣,彌陀鄉,南寮村,714,914,56.73494724,697,43.26505276,1611,54,1665,0,2014,82.67130089
高雄縣,梓官鄉,梓信村,715,592,72.72727273,222,27.27272727,814,33,847,0,1028,82.39299611
高雄縣,梓官鄉,梓信村,716,532,67.25663717,259,32.74336283,791,17,808,0,974,82.95687885
高雄縣,梓官鄉,梓義村,717,523,68.09895833,245,31.90104167,768,23,791,0,950,83.26315789
高雄縣,梓官鄉,梓義村,718,535,63.91875747,302,36.08124253,837,29,866,0,1076,80.48327138
高雄縣,梓官鄉,梓和村,719,417,63.85911179,236,36.14088821,653,24,677,0,824,82.16019417
高雄縣,梓官鄉,梓和村,720,374,70.56603774,156,29.43396226,530,19,549,0,653,84.07350689
高雄縣,梓官鄉,梓和村,721,437,66.31259484,222,33.68740516,659,18,677,0,796,85.05025126
高雄縣,梓官鄉,梓平村,722,656,69.7130712,285,30.2869288,941,42,983,0,1124,87.45551601
高雄縣,梓官鄉,中崙村,723,572,65.37142857,303,34.62857143,875,23,898,0,1055,85.11848341
高雄縣,梓官鄉,赤崁村,728,585,65.29017857,311,34.70982143,896,41,937,0,1131,82.84703802
高雄縣,梓官鄉,赤崁村,729,389,64.51077944,214,35.48922056,603,26,629,0,750,83.86666667
高雄縣,梓官鄉,禮蚵村,733,605,68.05399325,284,31.94600675,889,21,910,0,1113,81.76100629
高雄縣,梓官鄉,禮蚵村,734,619,66.13247863,317,33.86752137,936,31,967,0,1222,79.13256956
高雄縣,梓官鄉,智蚵村,735,525,64.02439024,295,35.97560976,820,33,853,0,1111,76.77767777
高雄縣,梓官鄉,智蚵村,736,638,59.40409683,436,40.59590317,1074,19,1093,0,1322,82.67776097
高雄縣,梓官鄉,信蚵村,737,735,56.23565417,572,43.76434583,1307,51,1358,0,1707,79.55477446
高雄縣,梓官鄉,同安村,724,526,69.21052632,234,30.78947368,760,42,802,0,935,85.77540107
高雄縣,梓官鄉,大舍村,725,650,71.19386637,263,28.80613363,913,37,950,0,1156,82.1799308
高雄縣,梓官鄉,大舍村,726,604,63.78035903,343,36.21964097,947,28,975,1,1189,82.00168209
高雄縣,梓官鄉,大舍村,727,541,62.90697674,319,37.09302326,860,32,892,0,1105,80.7239819
高雄縣,梓官鄉,赤東村,730,756,68.60254083,346,31.39745917,1102,34,1136,0,1379,82.37853517
高雄縣,梓官鄉,赤東村,731,490,65.5957162,257,34.4042838,747,32,779,1,968,80.47520661
高雄縣,梓官鄉,赤西村,732,287,54.25330813,242,45.74669187,529,19,548,0,687,79.76710335
高雄縣,梓官鄉,茄苳村,738,588,59.93883792,393,40.06116208,981,27,1008,0,1174,85.86030664
高雄縣,梓官鄉,茄苳村,739,458,61.47651007,287,38.52348993,745,39,784,0,1016,77.16535433
高雄縣,梓官鄉,典寶村,740,604,65.36796537,320,34.63203463,924,36,960,0,1121,85.63782337
高雄縣,梓官鄉,典寶村,741,587,53.80384968,504,46.19615032,1091,29,1120,0,1354,82.71787297
高雄縣,旗山鎮,太平里,742,512,56.32563256,397,43.67436744,909,28,937,0,1172,79.94880546
高雄縣,旗山鎮,太平里,743,465,55.16014235,378,44.83985765,843,39,882,0,1150,76.69565217
高雄縣,旗山鎮,大德里,744,558,54.33300876,469,45.66699124,1027,26,1053,0,1316,80.01519757
高雄縣,旗山鎮,大德里,745,419,48.77764843,440,51.22235157,859,18,877,0,1133,77.40511915
高雄縣,旗山鎮,湄洲里,746,379,55.0872093,309,44.9127907,688,19,707,0,884,79.97737557
高雄縣,旗山鎮,鼓山里,747,232,51.21412804,221,48.78587196,453,12,465,0,573,81.15183246
高雄縣,旗山鎮,和平里,749,353,62.69982238,210,37.30017762,563,16,579,0,760,76.18421053
高雄縣,旗山鎮,圓富里,758,429,57.04787234,323,42.95212766,752,28,780,0,1014,76.92307692
高雄縣,旗山鎮,圓富里,759,303,50.33222591,299,49.66777409,602,27,629,0,850,74
高雄縣,旗山鎮,中正里,760,449,56.54911839,345,43.45088161,794,35,829,0,1092,75.91575092
高雄縣,旗山鎮,中正里,761,100,30.39513678,229,69.60486322,329,13,342,0,441,77.55102041
高雄縣,旗山鎮,大林里,762,438,65.17857143,234,34.82142857,672,9,681,0,944,72.13983051
高雄縣,旗山鎮,大林里,763,171,43.95886889,218,56.04113111,389,20,409,0,533,76.73545966
高雄縣,旗山鎮,上洲里,764,576,70.32967033,243,29.67032967,819,35,854,0,1003,85.1445663
高雄縣,旗山鎮,新山里,748,365,59.93431856,244,40.06568144,609,12,621,0,774,80.23255814
高雄縣,旗山鎮,新光里,769,469,67.28837877,228,32.71162123,697,17,714,0,870,82.06896552
高雄縣,旗山鎮,南勝里,770,638,68.38156484,295,31.61843516,933,48,981,0,1243,78.92196299
高雄縣,旗山鎮,南勝里,771,517,59.83796296,347,40.16203704,864,28,892,0,1118,79.78533095
高雄縣,旗山鎮,中寮里,777,106,67.94871795,50,32.05128205,156,14,170,0,205,82.92682927
高雄縣,旗山鎮,東平里,772,441,61.93820225,271,38.06179775,712,19,731,0,920,79.45652174
高雄縣,旗山鎮,東平里,773,459,62.36413043,277,37.63586957,736,31,767,1,995,77.08542714
高雄縣,旗山鎮,東昌里,774,297,60.6122449,193,39.3877551,490,27,517,0,659,78.4522003
高雄縣,旗山鎮,竹峰里,750,246,57.07656613,185,42.92343387,431,3,434,0,561,77.36185383
高雄縣,旗山鎮,瑞吉里,751,411,60.0877193,273,39.9122807,684,26,710,0,904,78.53982301
高雄縣,旗山鎮,瑞吉里,752,466,59.43877551,318,40.56122449,784,28,812,0,1049,77.40705434
高雄縣,旗山鎮,永和里,753,719,57.56605284,530,42.43394716,1249,13,1262,0,1615,78.14241486
高雄縣,旗山鎮,永和里,754,670,61.18721461,425,38.81278539,1095,35,1130,0,1440,78.47222222
高雄縣,旗山鎮,三協里,755,493,62.6429479,294,37.3570521,787,35,822,0,1057,77.76726585
高雄縣,旗山鎮,三協里,756,231,56.20437956,180,43.79562044,411,17,428,0,561,76.29233512
高雄縣,旗山鎮,三協里,757,122,57.27699531,91,42.72300469,213,19,232,0,292,79.45205479
高雄縣,旗山鎮,鯤洲里,765,533,75.60283688,172,24.39716312,705,22,727,0,897,81.04793757
高雄縣,旗山鎮,大山里,766,755,73.22987391,276,26.77012609,1031,56,1087,0,1338,81.2406577
高雄縣,旗山鎮,中洲里,767,561,75,187,25,748,42,790,0,930,84.94623656
高雄縣,旗山鎮,南洲里,768,703,64.73296501,383,35.26703499,1086,41,1127,0,1372,82.14285714
高雄縣,旗山鎮,糖廠里,775,120,40.54054054,176,59.45945946,296,7,303,0,378,80.15873016
高雄縣,旗山鎮,廣福里,776,251,49.21568627,259,50.78431373,510,20,530,0,644,82.29813665
高雄縣,美濃鎮,福安里,786,537,59.79955457,361,40.20044543,898,34,932,0,1173,79.45439045
高雄縣,美濃鎮,福安里,787,580,56.03864734,455,43.96135266,1035,11,1046,0,1369,76.40613587
高雄縣,美濃鎮,合和里,782,369,51.60839161,346,48.39160839,715,32,747,1,952,78.46638655
高雄縣,美濃鎮,合和里,783,478,47.99196787,518,52.00803213,996,28,1024,0,1309,78.2276547
高雄縣,美濃鎮,祿興里,788,561,60.06423983,373,39.93576017,934,42,976,0,1272,76.72955975
高雄縣,美濃鎮,祿興里,789,487,52.4219591,442,47.5780409,929,39,968,0,1237,78.25383994
高雄縣,美濃鎮,中壇里,790,385,50.39267016,379,49.60732984,764,31,795,0,1018,78.09430255
高雄縣,美濃鎮,中壇里,791,386,51.53538051,363,48.46461949,749,32,781,0,1021,76.49363369
高雄縣,美濃鎮,德興里,792,507,44.04865334,644,55.95134666,1151,37,1188,0,1492,79.62466488
高雄縣,美濃鎮,龍山里,800,492,56.42201835,380,43.57798165,872,14,886,0,1143,77.51531059
高雄縣,美濃鎮,龍山里,801,451,56.44555695,348,43.55444305,799,16,815,0,1048,77.76717557
高雄縣,美濃鎮,獅山里,802,735,68.69158879,335,31.30841121,1070,13,1083,0,1374,78.8209607
高雄縣,美濃鎮,獅山里,803,450,57.6184379,331,42.3815621,781,18,799,0,1023,78.10361681
高雄縣,美濃鎮,龍肚里,804,272,47.71929825,298,52.28070175,570,21,591,0,738,80.08130081
高雄縣,美濃鎮,龍肚里,805,368,57.68025078,270,42.31974922,638,42,680,0,870,78.16091954
高雄縣,美濃鎮,廣德里,806,675,62.557924,404,37.442076,1079,43,1122,0,1416,79.23728814
高雄縣,美濃鎮,興隆里,807,576,63.15789474,336,36.84210526,912,34,946,0,1221,77.47747748
高雄縣,美濃鎮,中圳里,778,425,61.50506512,266,38.49493488,691,33,724,0,926,78.18574514
高雄縣,美濃鎮,中圳里,779,349,51.55096012,328,48.44903988,677,25,702,0,923,76.05633803
高雄縣,美濃鎮,東門里,780,617,61.94779116,379,38.05220884,996,43,1039,0,1364,76.17302053
高雄縣,美濃鎮,泰安里,781,569,49.56445993,579,50.43554007,1148,36,1184,0,1496,79.14438503
高雄縣,美濃鎮,瀰濃里,784,518,56.86059276,393,43.13940724,911,28,939,0,1192,78.77516779
高雄縣,美濃鎮,瀰濃里,785,400,53.05039788,354,46.94960212,754,32,786,0,1017,77.28613569
高雄縣,美濃鎮,清水里,793,407,56.76429568,310,43.23570432,717,24,741,0,979,75.68947906
高雄縣,美濃鎮,清水里,794,309,55.0802139,252,44.9197861,561,24,585,0,741,78.94736842
高雄縣,美濃鎮,吉洋里,796,399,53.99188092,340,46.00811908,739,36,775,0,996,77.81124498
高雄縣,美濃鎮,吉洋里,797,480,62.99212598,282,37.00787402,762,33,795,0,1005,79.10447761
高雄縣,美濃鎮,吉和里,795,552,51.83098592,513,48.16901408,1065,44,1109,0,1410,78.65248227
高雄縣,美濃鎮,吉東里,798,383,59.65732087,259,40.34267913,642,22,664,0,855,77.66081871
高雄縣,美濃鎮,吉東里,799,424,65.73643411,221,34.26356589,645,28,673,0,861,78.16492451
高雄縣,美濃鎮,廣林里,808,403,63.36477987,233,36.63522013,636,34,670,0,873,76.74684994
高雄縣,美濃鎮,廣林里,809,359,60.43771044,235,39.56228956,594,33,627,0,860,72.90697674
高雄縣,六龜鄉,新威村,815,330,55.46218487,265,44.53781513,595,26,621,0,821,75.63946407
高雄縣,六龜鄉,新興村,816,317,63.65461847,181,36.34538153,498,42,540,0,746,72.38605898
高雄縣,六龜鄉,新寮村,817,280,61.53846154,175,38.46153846,455,27,482,0,632,76.26582278
高雄縣,六龜鄉,新發村,819,607,73.66504854,217,26.33495146,824,83,907,0,1377,65.86782861
高雄縣,六龜鄉,荖濃村,820,628,65.41666667,332,34.58333333,960,66,1026,0,1574,65.18424396
高雄縣,六龜鄉,六龜村,810,452,59.0078329,314,40.9921671,766,51,817,0,1140,71.66666667
高雄縣,六龜鄉,義寶村,811,469,55.37190083,378,44.62809917,847,34,881,0,1154,76.34315425
高雄縣,六龜鄉,興龍村,814,387,63.44262295,223,36.55737705,610,36,646,0,914,70.67833698
高雄縣,六龜鄉,中興村,813,481,49.08163265,499,50.91836735,980,49,1029,0,1400,73.5
高雄縣,六龜鄉,寶來村,821,437,56.45994832,337,43.54005168,774,33,807,0,1111,72.63726373
高雄縣,六龜鄉,文武村,812,638,63.35650447,369,36.64349553,1007,63,1070,0,1604,66.70822943
高雄縣,六龜鄉,大津村,818,147,58.56573705,104,41.43426295,251,19,270,0,353,76.48725212
高雄縣,甲仙鄉,東安村,822,234,51.20350109,223,48.79649891,457,14,471,0,617,76.33711507
高雄縣,甲仙鄉,西安村,823,328,38.95486936,514,61.04513064,842,31,873,0,1084,80.53505535
高雄縣,甲仙鄉,和安村,824,280,44.65709729,347,55.34290271,627,36,663,0,836,79.3062201
高雄縣,甲仙鄉,大田村,825,580,47.85478548,632,52.14521452,1212,50,1262,0,1622,77.80517879
高雄縣,甲仙鄉,寶隆村,826,311,56.13718412,243,43.86281588,554,24,578,0,724,79.83425414
高雄縣,甲仙鄉,關山村,827,272,51.61290323,255,48.38709677,527,37,564,0,736,76.63043478
高雄縣,甲仙鄉,小林村,828,442,53.51089588,384,46.48910412,826,37,863,0,1168,73.8869863
高雄縣,杉林鄉,杉林村,829,341,63.14814815,199,36.85185185,540,25,565,0,763,74.04980341
高雄縣,杉林鄉,木梓村,830,325,62.74131274,193,37.25868726,518,31,549,0,783,70.11494253
高雄縣,杉林鄉,集來村,831,501,63.09823678,293,36.90176322,794,33,827,0,1119,73.90527256
高雄縣,杉林鄉,集來村,832,363,68.36158192,168,31.63841808,531,47,578,0,779,74.19768935
高雄縣,杉林鄉,新庄村,833,293,36.90176322,501,63.09823678,794,58,852,0,1149,74.15143603
高雄縣,杉林鄉,新庄村,834,290,63.45733042,167,36.54266958,457,30,487,0,627,77.67145136
高雄縣,杉林鄉,上平村,835,482,46.08030593,564,53.91969407,1046,48,1094,1,1520,71.97368421
高雄縣,杉林鄉,月眉村,836,624,50.81433225,604,49.18566775,1228,58,1286,0,1769,72.69643867
高雄縣,杉林鄉,月美村,837,560,59.3220339,384,40.6779661,944,45,989,1,1323,74.75434618
高雄縣,內門鄉,溝坪村,839,385,53.47222222,335,46.52777778,720,39,759,0,1029,73.76093294
高雄縣,內門鄉,金竹村,838,384,67.6056338,184,32.3943662,568,22,590,1,794,74.30730479
高雄縣,內門鄉,永富村,842,433,58.51351351,307,41.48648649,740,45,785,0,1044,75.19157088
高雄縣,內門鄉,永吉村,841,202,54.89130435,166,45.10869565,368,19,387,0,477,81.13207547
高雄縣,內門鄉,永興村,840,177,52.36686391,161,47.63313609,338,25,363,0,489,74.23312883
高雄縣,內門鄉,石坑村,853,226,59.16230366,156,40.83769634,382,17,399,0,509,78.38899804
高雄縣,內門鄉,內門村,852,347,45.5978975,414,54.4021025,761,28,789,0,997,79.13741224
高雄縣,內門鄉,內豊村,851,438,48.77505568,460,51.22494432,898,34,932,0,1148,81.18466899
高雄縣,內門鄉,觀亭村,843,319,59.40409683,218,40.59590317,537,23,560,0,693,80.80808081
高雄縣,內門鄉,觀亭村,844,476,56.46500593,367,43.53499407,843,35,878,1,1086,80.84714549
高雄縣,內門鄉,中埔村,845,241,52.50544662,218,47.49455338,459,30,489,0,598,81.77257525
高雄縣,內門鄉,內東村,848,335,56.11390285,262,43.88609715,597,47,644,0,787,81.82973316
高雄縣,內門鄉,內南村,847,195,60.9375,125,39.0625,320,11,331,0,406,81.5270936
高雄縣,內門鄉,東埔村,850,232,63.21525886,135,36.78474114,367,21,388,0,502,77.29083665
高雄縣,內門鄉,三平村,854,284,55.46875,228,44.53125,512,24,536,0,688,77.90697674
高雄縣,內門鄉,木柵村,855,339,64.69465649,185,35.30534351,524,20,544,0,697,78.04878049
高雄縣,內門鄉,內興村,856,338,73.47826087,122,26.52173913,460,31,491,0,636,77.20125786
高雄縣,內門鄉,瑞山村,846,162,61.36363636,102,38.63636364,264,18,282,0,366,77.04918033
高雄縣,內門鄉,光興村,849,269,55.92515593,212,44.07484407,481,27,508,0,642,79.12772586
高雄縣,茂林鄉,茂林村,857,48,11.65048544,364,88.34951456,412,11,423,0,536,78.91791045
高雄縣,茂林鄉,萬山村,858,16,7.111111111,209,92.88888889,225,6,231,0,292,79.10958904
高雄縣,茂林鄉,多納村,859,21,6.774193548,289,93.22580645,310,8,318,1,429,74.12587413
高雄縣,桃源鄉,桃源村,864,65,12.57253385,452,87.42746615,517,15,532,0,759,70.09222661
高雄縣,桃源鄉,寶山村,860,22,15.82733813,117,84.17266187,139,10,149,0,197,75.63451777
高雄縣,桃源鄉,寶山村,861,22,10.78431373,182,89.21568627,204,10,214,0,349,61.31805158
高雄縣,桃源鄉,建山村,862,40,11.26760563,315,88.73239437,355,19,374,0,549,68.12386157
高雄縣,桃源鄉,高中村,863,54,15.69767442,290,84.30232558,344,10,354,0,518,68.33976834
高雄縣,桃源鄉,勤和村,865,16,9.248554913,157,90.75144509,173,1,174,0,235,74.04255319
高雄縣,桃源鄉,復興村,866,38,23.89937107,121,76.10062893,159,4,163,0,257,63.42412451
高雄縣,桃源鄉,梅蘭村,867,45,26.31578947,126,73.68421053,171,1,172,0,248,69.35483871
高雄縣,桃源鄉,梅山村,868,20,10.58201058,169,89.41798942,189,2,191,0,242,78.92561983
高雄縣,三民鄉,民生村,871,82,10.56701031,694,89.43298969,776,7,783,0,1105,70.85972851
高雄縣,三民鄉,民權村,870,36,8.97755611,365,91.02244389,401,13,414,0,592,69.93243243
高雄縣,三民鄉,民族村,869,99,28.20512821,252,71.79487179,351,17,368,0,529,69.56521739
屏東縣,屏東市,光榮里,2,668,56.46661031,515,43.53338969,1183,22,1205,0,1517,79.43309163
屏東縣,屏東市,文明里,3,325,38.73659118,514,61.26340882,839,13,852,0,1083,78.67036011
屏東縣,屏東市,武廟里,1,792,63.15789474,462,36.84210526,1254,11,1265,0,1515,83.49834983
屏東縣,屏東市,大同里,1,792,63.15789474,462,36.84210526,1254,11,1265,0,1515,83.49834983
屏東縣,屏東市,泰安里,3,325,38.73659118,514,61.26340882,839,13,852,0,1083,78.67036011
屏東縣,屏東市,端正里,1,792,63.15789474,462,36.84210526,1254,11,1265,0,1515,83.49834983
屏東縣,屏東市,民權里,2,668,56.46661031,515,43.53338969,1183,22,1205,0,1517,79.43309163
屏東縣,屏東市,大埔里,6,805,68.10490694,377,31.89509306,1182,20,1202,0,1462,82.21614227
屏東縣,屏東市,必信里,6,805,68.10490694,377,31.89509306,1182,20,1202,0,1462,82.21614227
屏東縣,屏東市,崇智里,7,467,67.68115942,223,32.31884058,690,20,710,0,860,82.55813953
屏東縣,屏東市,崇禮里,7,467,67.68115942,223,32.31884058,690,20,710,0,860,82.55813953
屏東縣,屏東市,維新里,4,637,58.92691952,444,41.07308048,1081,26,1107,0,1417,78.12279464
屏東縣,屏東市,維新里,5,661,60.1455869,438,39.8544131,1099,30,1129,0,1427,79.11702873
屏東縣,屏東市,安樂里,9,537,60.26936027,354,39.73063973,891,11,902,0,1081,83.44125809
屏東縣,屏東市,平和里,8,439,63.07471264,257,36.92528736,696,19,715,0,874,81.80778032
屏東縣,屏東市,楠樹里,28,452,66.37298091,229,33.62701909,681,14,695,0,816,85.17156863
屏東縣,屏東市,扶風里,9,537,60.26936027,354,39.73063973,891,11,902,0,1081,83.44125809
屏東縣,屏東市,慶春里,28,452,66.37298091,229,33.62701909,681,14,695,0,816,85.17156863
屏東縣,屏東市,金泉里,10,691,67.02230844,340,32.97769156,1031,17,1048,0,1293,81.05181748
屏東縣,屏東市,勝豐里,10,691,67.02230844,340,32.97769156,1031,17,1048,0,1293,81.05181748
屏東縣,屏東市,橋南里,11,657,55.63082134,524,44.36917866,1181,30,1211,0,1570,77.13375796
屏東縣,屏東市,橋北里,12,432,59.09712722,299,40.90287278,731,9,740,0,914,80.96280088
屏東縣,屏東市,長春里,26,456,52.23367698,417,47.76632302,873,16,889,1,1089,81.63452709
屏東縣,屏東市,長春里,27,365,48.86211513,382,51.13788487,747,3,750,0,986,76.06490872
屏東縣,屏東市,豐榮里,21,487,49.44162437,498,50.55837563,985,11,996,0,1201,82.93089092
屏東縣,屏東市,豐榮里,22,549,54.95495495,450,45.04504505,999,13,1012,0,1255,80.6374502
屏東縣,屏東市,豐源里,23,449,44.94494494,550,55.05505506,999,5,1004,0,1238,81.09854604
屏東縣,屏東市,豐源里,24,525,50.38387716,517,49.61612284,1042,15,1057,0,1301,81.245196
屏東縣,屏東市,豐源里,25,497,51.5560166,467,48.4439834,964,10,974,0,1179,82.61238338
屏東縣,屏東市,豐田里,18,434,50.28968714,429,49.71031286,863,9,872,0,1098,79.41712204
屏東縣,屏東市,豐田里,19,526,46.92239072,595,53.07760928,1121,13,1134,0,1399,81.0578985
屏東縣,屏東市,豐田里,20,581,50.34662045,573,49.65337955,1154,27,1181,0,1453,81.28011012
屏東縣,屏東市,大連里,13,630,44.80796586,776,55.19203414,1406,20,1426,0,1713,83.24576766
屏東縣,屏東市,大連里,14,683,45.08250825,832,54.91749175,1515,25,1540,0,1854,83.06364617
屏東縣,屏東市,大連里,15,649,43.52783367,842,56.47216633,1491,19,1510,0,1823,82.83049918
屏東縣,屏東市,大連里,16,641,45.65527066,763,54.34472934,1404,13,1417,1,1717,82.52766453
屏東縣,屏東市,大連里,17,671,49.15750916,694,50.84249084,1365,19,1384,0,1684,82.18527316
屏東縣,屏東市,湖西里,34,854,74.97805092,285,25.02194908,1139,20,1159,0,1392,83.26149425
屏東縣,屏東市,湖南里,33,630,77.49077491,183,22.50922509,813,18,831,0,989,84.02426694
屏東縣,屏東市,歸心里,35,633,72.09567198,245,27.90432802,878,28,906,0,1113,81.40161725
屏東縣,屏東市,瑞光里,29,577,48.16360601,621,51.83639399,1198,23,1221,0,1549,78.82504842
屏東縣,屏東市,瑞光里,30,704,52.8132033,629,47.1867967,1333,49,1382,0,1809,76.39579878
屏東縣,屏東市,瑞光里,31,600,49.75124378,606,50.24875622,1206,12,1218,0,1559,78.12700449
屏東縣,屏東市,瑞光里,32,562,42.93353705,747,57.06646295,1309,25,1334,0,1675,79.64179104
屏東縣,屏東市,新生里,56,693,60.31331593,456,39.68668407,1149,26,1175,0,1426,82.39831697
屏東縣,屏東市,新生里,57,511,41.8852459,709,58.1147541,1220,24,1244,0,1557,79.89723828
屏東縣,屏東市,新生里,58,897,63.21353066,522,36.78646934,1419,32,1451,0,1781,81.47108366
屏東縣,屏東市,頂宅里,59,328,76.99530516,98,23.00469484,426,6,432,0,530,81.50943396
屏東縣,屏東市,厚生里,67,706,65.73556797,368,34.26443203,1074,27,1101,0,1375,80.07272727
屏東縣,屏東市,厚生里,68,907,68.55631141,416,31.44368859,1323,25,1348,0,1649,81.74651304
屏東縣,屏東市,擇仁里,65,829,64.36335404,459,35.63664596,1288,23,1311,0,1684,77.85035629
屏東縣,屏東市,建國里,65,829,64.36335404,459,35.63664596,1288,23,1311,0,1684,77.85035629
屏東縣,屏東市,一心里,69,569,42.43102163,772,57.56897837,1341,29,1370,0,1720,79.65116279
屏東縣,屏東市,萬年里,66,393,63.18327974,229,36.81672026,622,12,634,0,775,81.80645161
屏東縣,屏東市,義勇里,69,569,42.43102163,772,57.56897837,1341,29,1370,0,1720,79.65116279
屏東縣,屏東市,光華里,70,358,61.72413793,222,38.27586207,580,14,594,0,789,75.2851711
屏東縣,屏東市,永安里,71,654,60.33210332,430,39.66789668,1084,13,1097,0,1393,78.75089734
屏東縣,屏東市,永安里,72,751,60.41834272,492,39.58165728,1243,33,1276,0,1592,80.15075377
屏東縣,屏東市,永安里,73,759,52.38095238,690,47.61904762,1449,21,1470,0,1848,79.54545455
屏東縣,屏東市,永安里,74,767,53.11634349,677,46.88365651,1444,14,1458,0,1825,79.89041096
屏東縣,屏東市,新興里,53,294,41.46685472,415,58.53314528,709,10,719,0,909,79.09790979
屏東縣,屏東市,新興里,54,789,67.55136986,379,32.44863014,1168,12,1180,0,1387,85.07570296
屏東縣,屏東市,公館里,55,809,67.41666667,391,32.58333333,1200,21,1221,0,1482,82.38866397
屏東縣,屏東市,龍華里,62,721,64.2030276,402,35.7969724,1123,38,1161,0,1408,82.45738636
屏東縣,屏東市,龍華里,63,404,53.58090186,350,46.41909814,754,16,770,0,981,78.49133537
屏東縣,屏東市,玉成里,64,813,73.37545126,295,26.62454874,1108,41,1149,0,1370,83.86861314
屏東縣,屏東市,頂柳里,60,559,64.47520185,308,35.52479815,867,15,882,0,1027,85.8812074
屏東縣,屏東市,大湖里,61,864,68.51704996,397,31.48295004,1261,25,1286,0,1565,82.17252396
屏東縣,屏東市,凌雲里,42,181,16.14629795,940,83.85370205,1121,26,1147,0,1378,83.23657475
屏東縣,屏東市,鵬程里,44,76,6.631762653,1070,93.36823735,1146,27,1173,0,1419,82.66384778
屏東縣,屏東市,安鎮里,45,528,69.65699208,230,30.34300792,758,15,773,0,921,83.93051031
屏東縣,屏東市,安鎮里,46,558,62.83783784,330,37.16216216,888,22,910,0,1082,84.10351201
屏東縣,屏東市,永光里,47,526,57.61226725,387,42.38773275,913,28,941,0,1166,80.70325901
屏東縣,屏東市,大洲里,52,665,74.88738739,223,25.11261261,888,35,923,0,1088,84.83455882
屏東縣,屏東市,大武里,38,657,44.21265141,829,55.78734859,1486,21,1507,0,1862,80.93447905
屏東縣,屏東市,大武里,39,505,43.79878578,648,56.20121422,1153,14,1167,2,1433,81.43754361
屏東縣,屏東市,大武里,40,735,50.37697053,724,49.62302947,1459,26,1485,0,1789,83.00726663
屏東縣,屏東市,大武里,41,736,51.21781489,701,48.78218511,1437,31,1468,0,1830,80.21857923
屏東縣,屏東市,前進里,50,772,63.33059885,447,36.66940115,1219,29,1248,0,1541,80.98637249
屏東縣,屏東市,前進里,51,664,67.4796748,320,32.5203252,984,20,1004,0,1229,81.69243287
屏東縣,屏東市,清溪里,36,622,53.85281385,533,46.14718615,1155,20,1175,0,1458,80.58984911
屏東縣,屏東市,清溪里,37,579,48.81956155,607,51.18043845,1186,13,1199,0,1486,80.68640646
屏東縣,屏東市,長安里,48,569,70.42079208,239,29.57920792,808,23,831,0,1022,81.3111546
屏東縣,屏東市,長安里,49,468,60.85825748,301,39.14174252,769,26,795,0,977,81.37154555
屏東縣,屏東市,永順里,43,249,24.4357213,770,75.5642787,1019,21,1040,0,1291,80.5577072
屏東縣,屏東市,永昌里,43,249,24.4357213,770,75.5642787,1019,21,1040,0,1291,80.5577072
屏東縣,屏東市,斯文里,93,420,51.66051661,393,48.33948339,813,20,833,0,1010,82.47524752
屏東縣,屏東市,斯文里,94,396,45.72748268,470,54.27251732,866,11,877,0,1089,80.53259871
屏東縣,屏東市,華山里,95,559,47.4533107,619,52.5466893,1178,21,1199,0,1444,83.033241
屏東縣,屏東市,華山里,96,628,50.56360709,614,49.43639291,1242,17,1259,0,1537,81.91281718
屏東縣,屏東市,華山里,97,639,41.68297456,894,58.31702544,1533,29,1562,0,1890,82.64550265
屏東縣,屏東市,興樂里,111,355,47.20744681,397,52.79255319,752,12,764,0,960,79.58333333
屏東縣,屏東市,明正里,112,712,50.10555947,709,49.89444053,1421,26,1447,1,1778,81.38357705
屏東縣,屏東市,太平里,112,712,50.10555947,709,49.89444053,1421,26,1447,1,1778,81.38357705
屏東縣,屏東市,中正里,109,612,47.36842105,680,52.63157895,1292,21,1313,0,1622,80.94944513
屏東縣,屏東市,中正里,110,636,43.08943089,840,56.91056911,1476,19,1495,0,1835,81.47138965
屏東縣,屏東市,勝利里,90,450,40.17857143,670,59.82142857,1120,22,1142,0,1694,67.41440378
屏東縣,屏東市,勝利里,91,492,43.15789474,648,56.84210526,1140,21,1161,0,1472,78.87228261
屏東縣,屏東市,勝利里,92,471,39.81403212,712,60.18596788,1183,15,1198,0,1488,80.51075269
屏東縣,屏東市,永城里,85,371,41.17647059,530,58.82352941,901,12,913,0,1183,77.17666948
屏東縣,屏東市,永城里,86,404,47.19626168,452,52.80373832,856,20,876,0,1136,77.11267606
屏東縣,屏東市,溝美里,98,565,51.5041021,532,48.4958979,1097,18,1115,0,1401,79.58600999
屏東縣,屏東市,溝美里,99,508,45.4789615,609,54.5210385,1117,13,1130,0,1408,80.25568182
屏東縣,屏東市,北勢里,107,553,52.1206409,508,47.8793591,1061,18,1079,0,1282,84.16536661
屏東縣,屏東市,北勢里,108,544,59.45355191,371,40.54644809,915,19,934,0,1130,82.65486726
屏東縣,屏東市,北興里,103,299,26.72028597,820,73.27971403,1119,26,1145,0,1437,79.67988866
屏東縣,屏東市,北興里,104,500,50.35246727,493,49.64753273,993,20,1013,0,1264,80.14240506
屏東縣,屏東市,北興里,105,618,49.1646778,639,50.8353222,1257,20,1277,0,1586,80.51702396
屏東縣,屏東市,北興里,106,520,48.82629108,545,51.17370892,1065,13,1078,0,1355,79.55719557
屏東縣,屏東市,仁愛里,115,484,53.42163355,422,46.57836645,906,12,918,0,1139,80.59701493
屏東縣,屏東市,仁愛里,116,474,52.43362832,430,47.56637168,904,12,916,0,1118,81.93202147
屏東縣,屏東市,廣興里,89,833,55.90604027,657,44.09395973,1490,22,1512,2,1858,81.37782562
屏東縣,屏東市,大鵬里,88,26,4.618117229,537,95.38188277,563,23,586,0,715,81.95804196
屏東縣,屏東市,崇蘭里,75,641,54.04721754,545,45.95278246,1186,19,1205,0,1462,82.42134063
屏東縣,屏東市,崇蘭里,76,796,49.07521578,826,50.92478422,1622,25,1647,0,2061,79.91266376
屏東縣,屏東市,崇蘭里,77,394,37.24007561,664,62.75992439,1058,15,1073,0,1344,79.83630952
屏東縣,屏東市,崇蘭里,78,479,38.13694268,777,61.86305732,1256,18,1274,0,1532,83.15926893
屏東縣,屏東市,崇蘭里,79,268,30.31674208,616,69.68325792,884,10,894,0,1052,84.98098859
屏東縣,屏東市,空翔里,87,380,29.80392157,895,70.19607843,1275,25,1300,0,1593,81.60703076
屏東縣,屏東市,潭墘里,80,379,34.54876937,718,65.45123063,1097,22,1119,0,1450,77.17241379
屏東縣,屏東市,潭墘里,81,532,40.39483675,785,59.60516325,1317,22,1339,0,1674,79.98805257
屏東縣,屏東市,潭墘里,82,483,41.49484536,681,58.50515464,1164,24,1188,1,1508,78.77984085
屏東縣,屏東市,潭墘里,83,437,37.90112749,716,62.09887251,1153,14,1167,0,1408,82.88352273
屏東縣,屏東市,潭墘里,84,543,37.06484642,922,62.93515358,1465,20,1485,0,1874,79.24226254
屏東縣,屏東市,三山里,100,642,63.18897638,374,36.81102362,1016,22,1038,0,1256,82.6433121
屏東縣,屏東市,海豐里,101,491,70.24320458,208,29.75679542,699,14,713,0,856,83.29439252
屏東縣,屏東市,仁義里,102,508,63.34164589,294,36.65835411,802,23,825,0,1009,81.76412289
屏東縣,屏東市,和興里,114,513,70.66115702,213,29.33884298,726,18,744,0,954,77.98742138
屏東縣,屏東市,信和里,113,842,72.5862069,318,27.4137931,1160,38,1198,0,1472,81.38586957
屏東縣,潮州鎮,潮州里,117,252,51.42857143,238,48.57142857,490,7,497,0,607,81.87808896
屏東縣,潮州鎮,同榮里,120,397,67.5170068,191,32.4829932,588,11,599,0,712,84.12921348
屏東縣,潮州鎮,新榮里,122,674,60.07130125,448,39.92869875,1122,22,1144,0,1456,78.57142857
屏東縣,潮州鎮,新生里,121,563,61.80021954,348,38.19978046,911,7,918,0,1155,79.48051948
屏東縣,潮州鎮,光華里,118,983,56.33237822,762,43.66762178,1745,36,1781,0,2279,78.14831066
屏東縣,潮州鎮,光華里,119,674,51.25475285,641,48.74524715,1315,25,1340,0,1769,75.74901074
屏東縣,潮州鎮,彭城里,123,477,73.72488408,170,26.27511592,647,23,670,0,808,82.92079208
屏東縣,潮州鎮,三星里,124,553,54.1625857,468,45.8374143,1021,14,1035,0,1293,80.04640371
屏東縣,潮州鎮,三星里,125,619,51.36929461,586,48.63070539,1205,17,1222,0,1532,79.76501305
屏東縣,潮州鎮,三星里,126,711,54.35779817,597,45.64220183,1308,16,1324,0,1672,79.18660287
屏東縣,潮州鎮,三共里,127,741,56.05143722,581,43.94856278,1322,25,1347,0,1724,78.13225058
屏東縣,潮州鎮,三共里,128,845,56.1461794,660,43.8538206,1505,26,1531,0,1946,78.67420349
屏東縣,潮州鎮,三共里,129,844,56.98852127,637,43.01147873,1481,19,1500,0,1928,77.80082988
屏東縣,潮州鎮,三和里,130,853,58.99031812,593,41.00968188,1446,15,1461,0,1868,78.21199143
屏東縣,潮州鎮,五魁里,131,642,67.79303062,305,32.20696938,947,21,968,2,1197,80.86883876
屏東縣,潮州鎮,蓬萊里,132,941,66.69029057,470,33.30970943,1411,12,1423,0,1797,79.18753478
屏東縣,潮州鎮,八爺里,133,925,60.41802743,606,39.58197257,1531,37,1568,0,2042,76.78746327
屏東縣,潮州鎮,永春里,134,910,57.77777778,665,42.22222222,1575,36,1611,1,2047,78.70053737
屏東縣,潮州鎮,永春里,135,666,53.83993533,571,46.16006467,1237,30,1267,0,1618,78.3065513
屏東縣,潮州鎮,永春里,136,699,55.69721116,556,44.30278884,1255,26,1281,0,1622,78.97657213
屏東縣,潮州鎮,富春里,137,553,50.92081031,533,49.07918969,1086,11,1097,0,1428,76.82072829
屏東縣,潮州鎮,光春里,138,669,64.76282672,364,35.23717328,1033,10,1043,0,1325,78.71698113
屏東縣,潮州鎮,興美里,139,428,65.64417178,224,34.35582822,652,15,667,0,866,77.02078522
屏東縣,潮州鎮,檨子里,140,228,53.52112676,198,46.47887324,426,19,445,0,593,75.04215852
屏東縣,潮州鎮,九塊里,141,827,71.66377816,327,28.33622184,1154,38,1192,0,1576,75.63451777
屏東縣,潮州鎮,泗林里,142,784,63.17485898,457,36.82514102,1241,40,1281,0,1563,81.95777351
屏東縣,潮州鎮,四春里,143,1019,69.08474576,456,30.91525424,1475,46,1521,1,1921,79.17751171
屏東縣,潮州鎮,崙東里,144,784,66.27218935,399,33.72781065,1183,50,1233,0,1596,77.2556391
屏東縣,東港鎮,新勝里,145,549,61.75478065,340,38.24521935,889,17,906,0,1109,81.69522092
屏東縣,東港鎮,新勝里,146,641,65.54192229,337,34.45807771,978,18,996,0,1224,81.37254902
屏東縣,東港鎮,頂新里,147,318,68.38709677,147,31.61290323,465,12,477,0,579,82.38341969
屏東縣,東港鎮,頂中里,148,228,65.32951289,121,34.67048711,349,6,355,0,447,79.41834452
屏東縣,東港鎮,東和里,149,382,64.20168067,213,35.79831933,595,12,607,0,777,78.12097812
屏東縣,東港鎮,興台里,150,275,63.0733945,161,36.9266055,436,12,448,0,575,77.91304348
屏東縣,東港鎮,中興里,156,360,56.96202532,272,43.03797468,632,11,643,0,790,81.39240506
屏東縣,東港鎮,朝安里,157,616,63.24435318,358,36.75564682,974,30,1004,0,1273,78.86881383
屏東縣,東港鎮,朝安里,158,326,65.59356137,171,34.40643863,497,5,502,0,607,82.70181219
屏東縣,東港鎮,八德里,159,439,64.08759124,246,35.91240876,685,20,705,0,882,79.93197279
屏東縣,東港鎮,東隆里,160,684,64.83412322,371,35.16587678,1055,25,1080,0,1368,78.94736842
屏東縣,東港鎮,豐漁里,161,387,66.83937824,192,33.16062176,579,12,591,0,743,79.54239569
屏東縣,東港鎮,盛漁里,162,732,73.4939759,264,26.5060241,996,40,1036,0,1342,77.19821162
屏東縣,東港鎮,興漁里,163,454,70.82683307,187,29.17316693,641,17,658,0,819,80.34188034
屏東縣,東港鎮,興漁里,164,590,67.04545455,290,32.95454545,880,17,897,0,1130,79.38053097
屏東縣,東港鎮,鎮海里,165,635,66.6316894,318,33.3683106,953,17,970,0,1223,79.31316435
屏東縣,東港鎮,鎮海里,166,798,74.37092265,275,25.62907735,1073,18,1091,0,1390,78.48920863
屏東縣,東港鎮,嘉蓮里,167,837,67.99350122,394,32.00649878,1231,36,1267,0,1630,77.73006135
屏東縣,東港鎮,南平里,168,244,64.72148541,133,35.27851459,377,10,387,1,505,76.63366337
屏東縣,東港鎮,南平里,169,607,63.03219107,356,36.96780893,963,20,983,0,1290,76.20155039
屏東縣,東港鎮,船頭里,170,508,62.79357231,301,37.20642769,809,29,838,0,1069,78.39101964
屏東縣,東港鎮,船頭里,171,665,63.27307326,386,36.72692674,1051,27,1078,0,1337,80.62827225
屏東縣,東港鎮,船頭里,172,727,65.20179372,388,34.79820628,1115,30,1145,0,1504,76.13031915
屏東縣,東港鎮,下部里,173,695,80.9080326,164,19.0919674,859,24,883,0,1092,80.86080586
屏東縣,東港鎮,下部里,174,395,68.10344828,185,31.89655172,580,15,595,0,734,81.0626703
屏東縣,東港鎮,大潭里,175,795,63.44772546,458,36.55227454,1253,36,1289,0,1618,79.66625464
屏東縣,東港鎮,興東里,151,609,62.52566735,365,37.47433265,974,30,1004,0,1278,78.56025039
屏東縣,東港鎮,興東里,152,429,59.17241379,296,40.82758621,725,9,734,0,904,81.19469027
屏東縣,東港鎮,興東里,153,943,62.90860574,556,37.09139426,1499,34,1533,0,1977,77.54172989
屏東縣,東港鎮,興東里,154,888,64.06926407,498,35.93073593,1386,17,1403,1,1765,79.49008499
屏東縣,東港鎮,興農里,155,413,69.29530201,183,30.70469799,596,13,609,0,733,83.08321965
屏東縣,東港鎮,興和里,176,525,75.32281205,172,24.67718795,697,33,730,0,910,80.21978022
屏東縣,東港鎮,共和里,177,148,25.34246575,436,74.65753425,584,11,595,0,763,77.98165138
屏東縣,東港鎮,大鵬里,178,42,17.79661017,194,82.20338983,236,14,250,0,316,79.11392405
屏東縣,恆春鎮,城南里,179,330,46.67609618,377,53.32390382,707,20,727,0,993,73.21248741
屏東縣,恆春鎮,城北里,180,398,60.39453718,261,39.60546282,659,24,683,0,937,72.89220918
屏東縣,恆春鎮,城北里,181,393,50.51413882,385,49.48586118,778,22,800,0,1117,71.62041182
屏東縣,恆春鎮,城西里,182,424,49.76525822,428,50.23474178,852,11,863,0,1178,73.25976231
屏東縣,恆春鎮,山腳里,183,418,49.64370546,424,50.35629454,842,16,858,0,1183,72.52747253
屏東縣,恆春鎮,山腳里,184,424,57.60869565,312,42.39130435,736,24,760,0,1082,70.24029575
屏東縣,恆春鎮,山腳里,185,412,48.13084112,444,51.86915888,856,25,881,0,1255,70.19920319
屏東縣,恆春鎮,網紗里,186,481,47.01857283,542,52.98142717,1023,23,1046,0,1462,71.54582763
屏東縣,恆春鎮,網紗里,187,447,56.22641509,348,43.77358491,795,36,831,0,1224,67.89215686
屏東縣,恆春鎮,仁壽里,188,309,58.63377609,218,41.36622391,527,27,554,0,807,68.64931846
屏東縣,恆春鎮,茄湖里,189,228,72.61146497,86,27.38853503,314,20,334,0,479,69.72860125
屏東縣,恆春鎮,頭溝里,190,189,64.50511945,104,35.49488055,293,16,309,0,467,66.16702355
屏東縣,恆春鎮,四溝里,191,387,63.23529412,225,36.76470588,612,38,650,0,920,70.65217391
屏東縣,恆春鎮,德和里,192,290,57.53968254,214,42.46031746,504,17,521,0,725,71.86206897
屏東縣,恆春鎮,龍水里,193,378,57.09969789,284,42.90030211,662,34,696,0,994,70.02012072
屏東縣,恆春鎮,山海里,194,359,66.35859519,182,33.64140481,541,18,559,0,771,72.50324254
屏東縣,恆春鎮,山海里,195,350,69.30693069,155,30.69306931,505,29,534,0,759,70.35573123
屏東縣,恆春鎮,大光里,196,355,56.34920635,275,43.65079365,630,26,656,0,938,69.93603412
屏東縣,恆春鎮,大光里,197,290,49.15254237,300,50.84745763,590,43,633,0,937,67.55602988
屏東縣,恆春鎮,水泉里,198,284,66.51053864,143,33.48946136,427,29,456,0,703,64.86486486
屏東縣,恆春鎮,水泉里,199,257,60.75650118,166,39.24349882,423,22,445,0,669,66.51718984
屏東縣,恆春鎮,南灣里,200,220,54.59057072,183,45.40942928,403,15,418,0,654,63.91437309
屏東縣,恆春鎮,南灣里,201,249,50.10060362,248,49.89939638,497,21,518,0,724,71.54696133
屏東縣,恆春鎮,墾丁里,202,498,55.33333333,402,44.66666667,900,16,916,0,1257,72.87191726
屏東縣,恆春鎮,鵝鑾里,203,481,67.36694678,233,32.63305322,714,12,726,0,1041,69.74063401
屏東縣,萬丹鄉,萬安村,216,261,57.23684211,195,42.76315789,456,10,466,0,562,82.91814947
屏東縣,萬丹鄉,萬惠村,212,352,57.32899023,262,42.67100977,614,24,638,0,769,82.96488947
屏東縣,萬丹鄉,萬全村,213,842,59.88620199,564,40.11379801,1406,37,1443,2,1799,80.21122846
屏東縣,萬丹鄉,萬全村,214,716,57.23421263,535,42.76578737,1251,21,1272,0,1525,83.40983607
屏東縣,萬丹鄉,萬後村,215,230,60.36745407,151,39.63254593,381,11,392,0,495,79.19191919
屏東縣,萬丹鄉,萬生村,217,599,58.61056751,423,41.38943249,1022,26,1048,1,1255,83.5059761
屏東縣,萬丹鄉,寶厝村,218,464,59.10828025,321,40.89171975,785,27,812,0,1000,81.2
屏東縣,萬丹鄉,寶厝村,219,490,58.7529976,344,41.2470024,834,19,853,0,1041,81.94044188
屏東縣,萬丹鄉,四維村,220,886,63.69518332,505,36.30481668,1391,17,1408,1,1741,80.87306146
屏東縣,萬丹鄉,竹林村,221,775,65.90136054,401,34.09863946,1176,48,1224,1,1508,81.16710875
屏東縣,萬丹鄉,廣安村,237,517,68.29590489,240,31.70409511,757,18,775,1,943,82.1845175
屏東縣,萬丹鄉,廣安村,238,535,61.9212963,329,38.0787037,864,18,882,0,1074,82.12290503
屏東縣,萬丹鄉,田厝村,223,555,73.21899736,203,26.78100264,758,19,777,0,902,86.14190687
屏東縣,萬丹鄉,崙頂村,224,852,63.77245509,484,36.22754491,1336,26,1362,1,1664,81.85096154
屏東縣,萬丹鄉,廈北村,225,953,73.81874516,338,26.18125484,1291,51,1342,1,1616,83.04455446
屏東縣,萬丹鄉,廈南村,226,724,66.54411765,364,33.45588235,1088,28,1116,0,1397,79.88546886
屏東縣,萬丹鄉,上村村,229,399,70.61946903,166,29.38053097,565,13,578,0,667,86.65667166
屏東縣,萬丹鄉,加興村,230,643,72.49154453,244,27.50845547,887,31,918,0,1108,82.85198556
屏東縣,萬丹鄉,社口村,231,552,56.32653061,428,43.67346939,980,29,1009,0,1209,83.45740281
屏東縣,萬丹鄉,磚寮村,232,464,59.10828025,321,40.89171975,785,8,793,0,928,85.45258621
屏東縣,萬丹鄉,社皮村,233,450,68.28528073,209,31.71471927,659,16,675,0,818,82.51833741
屏東縣,萬丹鄉,社皮村,234,497,62.67339218,296,37.32660782,793,16,809,0,990,81.71717172
屏東縣,萬丹鄉,社上村,236,785,65.41666667,415,34.58333333,1200,18,1218,0,1465,83.13993174
屏東縣,萬丹鄉,社中村,235,832,70.27027027,352,29.72972973,1184,30,1214,0,1463,82.98017772
屏東縣,萬丹鄉,水泉村,222,697,62.17662801,424,37.82337199,1121,35,1156,0,1381,83.70745836
屏東縣,萬丹鄉,新庄村,205,906,64.11889597,507,35.88110403,1413,73,1486,0,1821,81.60351455
屏東縣,萬丹鄉,香社村,204,692,59.91341991,463,40.08658009,1155,31,1186,0,1455,81.51202749
屏東縣,萬丹鄉,後村村,227,515,64.53634085,283,35.46365915,798,30,828,0,1005,82.3880597
屏東縣,萬丹鄉,新鐘村,206,340,45.94594595,400,54.05405405,740,31,771,1,935,82.45989305
屏東縣,萬丹鄉,新鐘村,207,408,56.74547983,311,43.25452017,719,26,745,0,924,80.62770563
屏東縣,萬丹鄉,灣內村,228,726,72.09533267,281,27.90466733,1007,37,1044,1,1258,82.98887122
屏東縣,萬丹鄉,興全村,209,513,57.64044944,377,42.35955056,890,41,931,0,1124,82.82918149
屏東縣,萬丹鄉,興安村,210,441,68.05555556,207,31.94444444,648,17,665,0,828,80.31400966
屏東縣,萬丹鄉,水仙村,208,218,50,218,50,436,12,448,0,521,85.98848369
屏東縣,萬丹鄉,甘棠村,211,160,55.55555556,128,44.44444444,288,11,299,0,371,80.59299191
屏東縣,長治鄉,進興村,239,490,67.67955801,234,32.32044199,724,26,750,0,943,79.53340403
屏東縣,長治鄉,進興村,240,529,51.71065494,494,48.28934506,1023,17,1040,0,1314,79.14764079
屏東縣,長治鄉,新潭村,241,493,53.52877307,428,46.47122693,921,33,954,0,1194,79.89949749
屏東縣,長治鄉,新潭村,242,686,54.05831363,583,45.94168637,1269,26,1295,0,1618,80.03708282
屏東縣,長治鄉,潭頭村,243,776,63.45053148,447,36.54946852,1223,28,1251,0,1532,81.65796345
屏東縣,長治鄉,香楊村,244,286,59.58333333,194,40.41666667,480,19,499,0,614,81.27035831
屏東縣,長治鄉,香楊村,245,583,56.32850242,452,43.67149758,1035,16,1051,0,1285,81.78988327
屏東縣,長治鄉,長興村,246,426,54.19847328,360,45.80152672,786,21,807,0,992,81.35080645
屏東縣,長治鄉,德成村,251,467,65.31468531,248,34.68531469,715,19,734,0,872,84.17431193
屏東縣,長治鄉,德協村,252,603,69.71098266,262,30.28901734,865,21,886,0,1115,79.46188341
屏東縣,長治鄉,復興村,250,696,62.08742194,425,37.91257806,1121,23,1144,0,1459,78.40986977
屏東縣,長治鄉,崙上村,247,740,63.5193133,425,36.4806867,1165,30,1195,1,1453,82.24363386
屏東縣,長治鄉,德榮村,248,567,65.70104287,296,34.29895713,863,21,884,0,1077,82.07985144
屏東縣,長治鄉,德和村,249,445,72.00647249,173,27.99352751,618,15,633,0,782,80.94629156
屏東縣,長治鄉,繁華村,256,673,67.70623742,321,32.29376258,994,18,1012,0,1228,82.41042345
屏東縣,長治鄉,繁華村,257,556,73.44782034,201,26.55217966,757,27,784,0,1015,77.24137931
屏東縣,長治鄉,繁昌村,254,901,69.20122888,401,30.79877112,1302,41,1343,0,1699,79.04649794
屏東縣,長治鄉,繁榮村,253,643,65.94871795,332,34.05128205,975,23,998,0,1321,75.54882665
屏東縣,長治鄉,繁隆村,255,495,58.30388693,354,41.69611307,849,24,873,2,1090,80.09174312
屏東縣,長治鄉,榮華村,258,67,15.19274376,374,84.80725624,441,10,451,0,576,78.29861111
屏東縣,麟洛鄉,新田村,259,380,67.25663717,185,32.74336283,565,16,581,0,698,83.23782235
屏東縣,麟洛鄉,新田村,260,586,63.55748373,336,36.44251627,922,13,935,0,1118,83.63148479
屏東縣,麟洛鄉,麟頂村,261,459,66.71511628,229,33.28488372,688,7,695,0,835,83.23353293
屏東縣,麟洛鄉,麟蹄村,262,413,63.93188854,233,36.06811146,646,6,652,0,805,80.99378882
屏東縣,麟洛鄉,麟蹄村,263,448,67.77609682,213,32.22390318,661,13,674,0,799,84.35544431
屏東縣,麟洛鄉,麟趾村,264,551,64.59554513,302,35.40445487,853,15,868,0,1054,82.35294118
屏東縣,麟洛鄉,麟趾村,265,635,65.32921811,337,34.67078189,972,9,981,0,1189,82.50630782
屏東縣,麟洛鄉,田中村,266,620,66.31016043,315,33.68983957,935,20,955,0,1116,85.5734767
屏東縣,麟洛鄉,田心村,267,457,66.32801161,232,33.67198839,689,19,708,0,837,84.58781362
屏東縣,麟洛鄉,田道村,268,369,66.12903226,189,33.87096774,558,7,565,0,689,82.00290276
屏東縣,九如鄉,九清村,269,978,75.34668721,320,24.65331279,1298,32,1330,0,1568,84.82142857
屏東縣,九如鄉,九塊村,270,747,72.73612463,280,27.26387537,1027,31,1058,0,1266,83.57030016
屏東縣,九如鄉,九明村,271,832,73.3686067,302,26.6313933,1134,38,1172,0,1407,83.29779673
屏東縣,九如鄉,玉水村,273,677,67.09613479,332,32.90386521,1009,32,1041,0,1228,84.77198697
屏東縣,九如鄉,大坵村,272,570,68.59205776,261,31.40794224,831,28,859,0,1033,83.15585673
屏東縣,九如鄉,三塊村,278,835,75.70262919,268,24.29737081,1103,38,1141,0,1382,82.56150507
屏東縣,九如鄉,後庄村,280,1083,75.89348283,344,24.10651717,1427,26,1453,1,1688,86.07819905
屏東縣,九如鄉,耆老村,279,733,71.58203125,291,28.41796875,1024,21,1045,0,1250,83.6
屏東縣,九如鄉,洽興村,281,728,67.28280961,354,32.71719039,1082,18,1100,0,1303,84.42056792
屏東縣,九如鄉,東寧村,275,338,64.87523992,183,35.12476008,521,9,530,0,622,85.20900322
屏東縣,九如鄉,東寧村,276,966,72.30538922,370,27.69461078,1336,21,1357,0,1677,80.9183065
屏東縣,九如鄉,東寧村,277,687,64.68926554,375,35.31073446,1062,19,1081,0,1306,82.77182236
屏東縣,九如鄉,玉泉村,274,783,68.02780191,368,31.97219809,1151,34,1185,0,1467,80.77709611
屏東縣,里港鄉,玉田村,282,563,69.16461916,251,30.83538084,814,5,819,0,983,83.31637843
屏東縣,里港鄉,玉田村,283,649,69.18976546,289,30.81023454,938,15,953,1,1195,79.74895397
屏東縣,里港鄉,大平村,286,557,58.8794926,389,41.1205074,946,15,961,0,1141,84.22436459
屏東縣,里港鄉,永春村,287,438,68.01242236,206,31.98757764,644,12,656,0,803,81.69364882
屏東縣,里港鄉,春林村,288,665,67.78797146,316,32.21202854,981,22,1003,0,1223,82.01144726
屏東縣,里港鄉,過江村,289,479,66.43550624,242,33.56449376,721,17,738,0,883,83.57870895
屏東縣,里港鄉,過江村,290,409,61.31934033,258,38.68065967,667,23,690,0,856,80.60747664
屏東縣,里港鄉,鐵店村,291,696,70.73170732,288,29.26829268,984,22,1006,0,1212,83.00330033
屏東縣,里港鄉,塔樓村,284,864,76.8,261,23.2,1125,32,1157,0,1383,83.65871294
屏東縣,里港鄉,潮厝村,285,901,77.40549828,263,22.59450172,1164,8,1172,0,1384,84.68208092
屏東縣,里港鄉,茄苳村,292,216,66.87306502,107,33.12693498,323,12,335,0,409,81.90709046
屏東縣,里港鄉,茄苳村,293,760,76.38190955,235,23.61809045,995,26,1021,0,1177,86.74596432
屏東縣,里港鄉,載興村,294,604,74.56790123,206,25.43209877,810,20,830,0,1004,82.66932271
屏東縣,里港鄉,載興村,295,766,73.93822394,270,26.06177606,1036,32,1068,0,1308,81.65137615
屏東縣,里港鄉,土庫村,296,768,66.66666667,384,33.33333333,1152,38,1190,0,1485,80.13468013
屏東縣,里港鄉,土庫村,297,29,7.416879795,362,92.5831202,391,14,405,0,500,81
屏東縣,里港鄉,三部村,298,440,65.96701649,227,34.03298351,667,27,694,0,855,81.16959064
屏東縣,里港鄉,三部村,299,458,63.34716459,265,36.65283541,723,33,756,0,900,84
屏東縣,里港鄉,中和村,300,424,67.94871795,200,32.05128205,624,19,643,0,820,78.41463415
屏東縣,里港鄉,瀰力村,301,240,64.69002695,131,35.30997305,371,19,390,0,456,85.52631579
屏東縣,鹽埔鄉,新圍村,311,756,67.43978591,365,32.56021409,1121,5,1126,1,1434,78.52161785
屏東縣,鹽埔鄉,新圍村,312,855,74.09012132,299,25.90987868,1154,8,1162,1,1452,80.02754821
屏東縣,鹽埔鄉,高朗村,307,616,62.34817814,372,37.65182186,988,51,1039,0,1358,76.5095729
屏東縣,鹽埔鄉,高朗村,308,605,60.13916501,401,39.86083499,1006,36,1042,3,1340,77.76119403
屏東縣,鹽埔鄉,鹽北村,302,619,45.71639586,735,54.28360414,1354,14,1368,1,1737,78.75647668
屏東縣,鹽埔鄉,鹽中村,303,371,47.62516046,408,52.37483954,779,27,806,0,1057,76.25354778
屏東縣,鹽埔鄉,鹽中村,304,490,52.97297297,435,47.02702703,925,33,958,0,1229,77.94955248
屏東縣,鹽埔鄉,鹽南村,305,565,45.78606159,669,54.21393841,1234,38,1272,0,1634,77.84577723
屏東縣,鹽埔鄉,仕絨村,306,263,37.14689266,445,62.85310734,708,36,744,0,917,81.13413304
屏東縣,鹽埔鄉,振興村,309,761,57.82674772,555,42.17325228,1316,65,1381,0,1866,74.00857449
屏東縣,鹽埔鄉,永隆村,317,325,71.58590308,129,28.41409692,454,16,470,0,567,82.89241623
屏東縣,鹽埔鄉,久愛村,310,328,49.62178517,333,50.37821483,661,21,682,0,877,77.76510832
屏東縣,鹽埔鄉,洛陽村,316,736,64.11149826,412,35.88850174,1148,42,1190,1,1476,80.62330623
屏東縣,鹽埔鄉,新二村,313,599,58.04263566,433,41.95736434,1032,21,1053,0,1293,81.43851508
屏東縣,鹽埔鄉,新二村,314,739,57.734375,541,42.265625,1280,33,1313,0,1702,77.14453584
屏東縣,鹽埔鄉,彭厝村,315,465,59.84555985,312,40.15444015,777,21,798,0,979,81.51174668
屏東縣,高樹鄉,高樹村,318,487,66.53005464,245,33.46994536,732,16,748,0,944,79.23728814
屏東縣,高樹鄉,高樹村,319,706,76.07758621,222,23.92241379,928,24,952,0,1234,77.14748784
屏東縣,高樹鄉,長榮村,320,797,75.47348485,259,24.52651515,1056,40,1096,0,1377,79.59331881
屏東縣,高樹鄉,東興村,321,525,81.64852255,118,18.35147745,643,22,665,0,837,79.45041816
屏東縣,高樹鄉,東振村,322,315,66.73728814,157,33.26271186,472,13,485,0,611,79.37806874
屏東縣,高樹鄉,源泉村,323,516,66.23876765,263,33.76123235,779,38,817,0,1013,80.65153011
屏東縣,高樹鄉,建興村,324,679,76.20650954,212,23.79349046,891,37,928,0,1170,79.31623932
屏東縣,高樹鄉,大埔村,325,329,64.76377953,179,35.23622047,508,23,531,0,686,77.40524781
屏東縣,高樹鄉,菜寮村,326,495,79.58199357,127,20.41800643,622,31,653,0,815,80.12269939
屏東縣,高樹鄉,司馬村,327,318,58.99814471,221,41.00185529,539,23,562,0,706,79.60339943
屏東縣,高樹鄉,舊寮村,328,645,66.35802469,327,33.64197531,972,40,1012,0,1321,76.60862983
屏東縣,高樹鄉,新豐村,329,750,66.90454951,371,33.09545049,1121,40,1161,1,1584,73.29545455
屏東縣,高樹鄉,泰山村,330,472,69.92592593,203,30.07407407,675,31,706,0,961,73.46514048
屏東縣,高樹鄉,泰山村,331,484,65.76086957,252,34.23913043,736,38,774,0,1018,76.03143418
屏東縣,高樹鄉,南華村,332,637,67.26504752,310,32.73495248,947,39,986,0,1253,78.69114126
屏東縣,高樹鄉,廣福村,333,571,75.72944297,183,24.27055703,754,28,782,0,966,80.95238095
屏東縣,高樹鄉,廣興村,334,569,70.68322981,236,29.31677019,805,40,845,0,1061,79.64184731
屏東縣,高樹鄉,舊庄村,335,569,71.57232704,226,28.42767296,795,27,822,0,1032,79.65116279
屏東縣,高樹鄉,田子村,336,588,68.05555556,276,31.94444444,864,32,896,0,1121,79.92863515
屏東縣,高樹鄉,鹽樹村,337,431,74.31034483,149,25.68965517,580,21,601,0,737,81.5468114
屏東縣,高樹鄉,鹽樹村,338,217,46.46680942,250,53.53319058,467,23,490,0,613,79.93474715
屏東縣,高樹鄉,新南村,339,811,71.01576182,331,28.98423818,1142,29,1171,0,1477,79.28232905
屏東縣,萬巒鄉,萬巒村,340,714,71.75879397,281,28.24120603,995,12,1007,0,1263,79.73079968
屏東縣,萬巒鄉,萬全村,341,446,73.1147541,164,26.8852459,610,11,621,0,790,78.60759494
屏東縣,萬巒鄉,萬和村,342,811,69.55403087,355,30.44596913,1166,7,1173,0,1444,81.23268698
屏東縣,萬巒鄉,鹿寮村,343,533,72.22222222,205,27.77777778,738,18,756,0,905,83.5359116
屏東縣,萬巒鄉,硫黃村,344,309,73.57142857,111,26.42857143,420,5,425,0,529,80.34026465
屏東縣,萬巒鄉,泗溝村,345,604,65.72361262,315,34.27638738,919,30,949,0,1229,77.2172498
屏東縣,萬巒鄉,五溝村,346,589,65.3718091,312,34.6281909,901,27,928,0,1144,81.11888112
屏東縣,萬巒鄉,成德村,347,819,66.85714286,406,33.14285714,1225,18,1243,0,1554,79.98712999
屏東縣,萬巒鄉,萬金村,350,524,67.78783959,249,32.21216041,773,19,792,0,1010,78.41584158
屏東縣,萬巒鄉,萬金村,351,501,69.68011127,218,30.31988873,719,24,743,0,928,80.06465517
屏東縣,萬巒鄉,赤山村,348,405,64.18383518,226,35.81616482,631,9,640,0,876,73.05936073
屏東縣,萬巒鄉,赤山村,349,375,63.55932203,215,36.44067797,590,34,624,0,817,76.37698898
屏東縣,萬巒鄉,佳佐村,352,829,68.73963516,377,31.26036484,1206,41,1247,0,1593,78.27997489
屏東縣,萬巒鄉,佳和村,353,662,54.84672742,545,45.15327258,1207,32,1239,0,1510,82.05298013
屏東縣,萬巒鄉,新厝村,354,626,72.53765933,237,27.46234067,863,26,889,0,1157,76.8366465
屏東縣,萬巒鄉,新置村,355,252,50.501002,247,49.498998,499,18,517,0,634,81.54574132
屏東縣,萬巒鄉,新置村,356,349,77.0419426,104,22.9580574,453,16,469,0,627,74.80063796
屏東縣,內埔鄉,內埔村,357,675,62.73234201,401,37.26765799,1076,24,1100,0,1381,79.65242578
屏東縣,內埔鄉,內埔村,358,919,60.54018445,599,39.45981555,1518,9,1527,0,1945,78.50899743
屏東縣,內埔鄉,內田村,359,503,61.11786148,320,38.88213852,823,22,845,0,1068,79.11985019
屏東縣,內埔鄉,內田村,360,758,59.08028059,525,40.91971941,1283,24,1307,0,1674,78.07646356
屏東縣,內埔鄉,興南村,361,757,69.32234432,335,30.67765568,1092,12,1104,0,1315,83.95437262
屏東縣,內埔鄉,義亭村,362,328,71.92982456,128,28.07017544,456,17,473,0,591,80.03384095
屏東縣,內埔鄉,美和村,363,516,63.54679803,296,36.45320197,812,22,834,0,1017,82.00589971
屏東縣,內埔鄉,美和村,364,515,61.60287081,321,38.39712919,836,24,860,0,1085,79.26267281
屏東縣,內埔鄉,和興村,365,494,72.32796486,189,27.67203514,683,11,694,0,836,83.01435407
屏東縣,內埔鄉,和興村,366,465,51.66666667,435,48.33333333,900,17,917,0,1125,81.51111111
屏東縣,內埔鄉,東寧村,367,530,64.63414634,290,35.36585366,820,16,836,0,1045,80
屏東縣,內埔鄉,東寧村,368,708,65.9832246,365,34.0167754,1073,22,1095,0,1370,79.9270073
屏東縣,內埔鄉,東寧村,369,746,56.51515152,574,43.48484848,1320,17,1337,0,1682,79.48870392
屏東縣,內埔鄉,豐田村,370,600,64.17112299,335,35.82887701,935,23,958,0,1242,77.13365539
屏東縣,內埔鄉,豐田村,371,639,66.01239669,329,33.98760331,968,19,987,0,1232,80.11363636
屏東縣,內埔鄉,振豐村,372,474,65.83333333,246,34.16666667,720,4,724,0,876,82.64840183
屏東縣,內埔鄉,振豐村,373,385,62.70358306,229,37.29641694,614,20,634,0,758,83.64116095
屏東縣,內埔鄉,富田村,374,402,64.52648475,221,35.47351525,623,15,638,0,789,80.86185044
屏東縣,內埔鄉,富田村,375,690,75.57502738,223,24.42497262,913,9,922,0,1123,82.1015138
屏東縣,內埔鄉,竹圍村,376,869,69.74317817,377,30.25682183,1246,27,1273,0,1587,80.21424071
屏東縣,內埔鄉,東勢村,377,622,70.6015891,259,29.3984109,881,20,901,0,1124,80.16014235
屏東縣,內埔鄉,東勢村,378,1000,74.29420505,346,25.70579495,1346,35,1381,0,1767,78.15506508
屏東縣,內埔鄉,東片村,379,518,70.76502732,214,29.23497268,732,23,755,0,924,81.70995671
屏東縣,內埔鄉,上樹村,380,609,69.91963261,262,30.08036739,871,24,895,0,1103,81.14233908
屏東縣,內埔鄉,老埤村,381,569,67.4970344,274,32.5029656,843,34,877,0,1164,75.34364261
屏東縣,內埔鄉,老埤村,382,654,72.10584344,253,27.89415656,907,43,950,0,1243,76.42799678
屏東縣,內埔鄉,中林村,383,827,72.35345582,316,27.64654418,1143,34,1177,0,1475,79.79661017
屏東縣,內埔鄉,龍泉村,384,615,58.4045584,438,41.5954416,1053,24,1077,0,1383,77.87418655
屏東縣,內埔鄉,龍泉村,385,392,46.66666667,448,53.33333333,840,35,875,2,1160,75.43103448
屏東縣,內埔鄉,龍潭村,386,12,9.677419355,112,90.32258065,124,4,128,0,174,73.56321839
屏東縣,內埔鄉,龍潭村,387,435,40.80675422,631,59.19324578,1066,28,1094,1,1419,77.09654686
屏東縣,內埔鄉,龍潭村,388,334,40.58323208,489,59.41676792,823,22,845,0,1070,78.97196262
屏東縣,內埔鄉,建興村,389,349,69.66067864,152,30.33932136,501,18,519,0,647,80.21638331
屏東縣,內埔鄉,建興村,390,19,4.645476773,390,95.35452323,409,56,465,0,953,48.79328437
屏東縣,內埔鄉,大新村,391,777,71.28440367,313,28.71559633,1090,20,1110,0,1369,81.08108108
屏東縣,內埔鄉,大新村,392,71,21.71253823,256,78.28746177,327,15,342,0,434,78.80184332
屏東縣,內埔鄉,黎明村,393,647,68.32101373,300,31.67898627,947,13,960,0,1179,81.42493639
屏東縣,內埔鄉,黎明村,394,551,63.55247982,316,36.44752018,867,31,898,0,1113,80.68283917
屏東縣,內埔鄉,隘寮村,395,517,57.31707317,385,42.68292683,902,29,931,0,1227,75.87612062
屏東縣,內埔鄉,水門村,396,354,53.47432024,308,46.52567976,662,7,669,0,862,77.61020882
屏東縣,竹田鄉,竹田村,397,737,62.88395904,435,37.11604096,1172,10,1182,1,1458,81.06995885
屏東縣,竹田鄉,竹南村,398,512,74.74452555,173,25.25547445,685,18,703,0,862,81.55452436
屏東縣,竹田鄉,糶糴村,399,366,65.24064171,195,34.75935829,561,7,568,0,687,82.6783115
屏東縣,竹田鄉,履豐村,400,360,71.85628743,141,28.14371257,501,9,510,0,614,83.06188925
屏東縣,竹田鄉,頭崙村,401,713,66.20241411,364,33.79758589,1077,28,1105,0,1335,82.77153558
屏東縣,竹田鄉,二崙村,402,510,65.30089629,271,34.69910371,781,21,802,0,966,83.02277433
屏東縣,竹田鄉,美崙村,403,340,68,160,32,500,8,508,0,611,83.14238953
屏東縣,竹田鄉,南勢村,404,300,75.56675063,97,24.43324937,397,2,399,0,469,85.07462687
屏東縣,竹田鄉,西勢村,405,678,63.60225141,388,36.39774859,1066,22,1088,0,1336,81.43712575
屏東縣,竹田鄉,西勢村,406,665,69.12681913,297,30.87318087,962,17,979,0,1227,79.78810106
屏東縣,竹田鄉,福田村,407,277,76.51933702,85,23.48066298,362,8,370,0,440,84.09090909
屏東縣,竹田鄉,永豐村,408,314,63.05220884,184,36.94779116,498,8,506,0,606,83.49834983
屏東縣,竹田鄉,六巷村,409,410,73.47670251,148,26.52329749,558,9,567,0,681,83.25991189
屏東縣,竹田鄉,泗洲村,410,500,62.6566416,298,37.3433584,798,29,827,0,1085,76.22119816
屏東縣,竹田鄉,大湖村,411,589,65.22702104,314,34.77297896,903,28,931,1,1154,80.67590988
屏東縣,竹田鄉,鳳明村,412,432,52.74725275,387,47.25274725,819,20,839,0,1022,82.09393346
屏東縣,新埤鄉,新埤村,413,694,57.26072607,518,42.73927393,1212,34,1246,0,1628,76.53562654
屏東縣,新埤鄉,新埤村,414,143,53.1598513,126,46.8401487,269,7,276,0,341,80.93841642
屏東縣,新埤鄉,建功村,415,380,63.43906511,219,36.56093489,599,29,628,0,811,77.4352651
屏東縣,新埤鄉,建功村,416,169,58.68055556,119,41.31944444,288,7,295,0,382,77.22513089
屏東縣,新埤鄉,打鐵村,417,457,58.06861499,330,41.93138501,787,23,810,0,1001,80.91908092
屏東縣,新埤鄉,南豐村,418,338,59.1943958,233,40.8056042,571,17,588,1,759,77.47035573
屏東縣,新埤鄉,萬隆村,419,281,53.52380952,244,46.47619048,525,24,549,0,701,78.31669044
屏東縣,新埤鄉,萬隆村,420,149,52.65017668,134,47.34982332,283,10,293,0,366,80.05464481
屏東縣,新埤鄉,萬隆村,421,248,54.38596491,208,45.61403509,456,20,476,0,652,73.00613497
屏東縣,新埤鄉,箕湖村,423,256,64.81012658,139,35.18987342,395,17,412,0,561,73.4402852
屏東縣,新埤鄉,箕湖村,424,187,45.16908213,227,54.83091787,414,18,432,0,544,79.41176471
屏東縣,新埤鄉,餉潭村,422,602,63.23529412,350,36.76470588,952,47,999,0,1368,73.02631579
屏東縣,枋寮鄉,枋寮村,425,438,48.39779006,467,51.60220994,905,12,917,0,1236,74.19093851
屏東縣,枋寮鄉,新龍村,426,247,39.45686901,379,60.54313099,626,17,643,1,873,73.65406644
屏東縣,枋寮鄉,保生村,427,486,64.28571429,270,35.71428571,756,21,777,1,984,78.96341463
屏東縣,枋寮鄉,中寮村,428,322,63.1372549,188,36.8627451,510,21,531,0,675,78.66666667
屏東縣,枋寮鄉,安樂村,429,415,59.37052933,284,40.62947067,699,26,725,0,907,79.93384785
屏東縣,枋寮鄉,安樂村,430,395,57.16353111,296,42.83646889,691,19,710,0,920,77.17391304
屏東縣,枋寮鄉,隆山村,431,575,62.43213898,346,37.56786102,921,31,952,0,1293,73.62722351
屏東縣,枋寮鄉,隆山村,432,551,58.43054083,392,41.56945917,943,35,978,1,1317,74.25968109
屏東縣,枋寮鄉,隆山村,433,639,66.49323621,322,33.50676379,961,30,991,0,1274,77.78649922
屏東縣,枋寮鄉,天時村,434,488,63.95806029,275,36.04193971,763,19,782,0,1001,78.12187812
屏東縣,枋寮鄉,天時村,435,525,61.98347107,322,38.01652893,847,20,867,0,1092,79.3956044
屏東縣,枋寮鄉,地利村,436,835,63.69183829,476,36.30816171,1311,21,1332,0,1650,80.72727273
屏東縣,枋寮鄉,人和村,437,456,57.94155019,331,42.05844981,787,19,806,0,1055,76.39810427
屏東縣,枋寮鄉,人和村,438,542,61.1048478,345,38.8951522,887,18,905,0,1161,77.95004307
屏東縣,枋寮鄉,內寮村,439,359,73.41513292,130,26.58486708,489,21,510,0,756,67.46031746
屏東縣,枋寮鄉,新開村,440,320,51.61290323,300,48.38709677,620,43,663,0,994,66.70020121
屏東縣,枋寮鄉,太源村,444,393,57.37226277,292,42.62773723,685,22,707,0,964,73.34024896
屏東縣,枋寮鄉,玉泉村,445,174,54.20560748,147,45.79439252,321,26,347,0,450,77.11111111
屏東縣,枋寮鄉,東海村,441,650,57.93226381,472,42.06773619,1122,10,1132,0,1430,79.16083916
屏東縣,枋寮鄉,東海村,442,610,57.76515152,446,42.23484848,1056,24,1080,0,1391,77.64198418
屏東縣,枋寮鄉,大庄村,443,280,57.85123967,204,42.14876033,484,15,499,0,634,78.70662461
屏東縣,新園鄉,瓦窯村,446,490,66.39566396,248,33.60433604,738,32,770,0,900,85.55555556
屏東縣,新園鄉,瓦窯村,447,405,70.3125,171,29.6875,576,18,594,0,724,82.0441989
屏東縣,新園鄉,仙吉村,448,582,66.51428571,293,33.48571429,875,11,886,0,1106,80.1084991
屏東縣,新園鄉,仙吉村,449,650,64.03940887,365,35.96059113,1015,26,1041,0,1288,80.82298137
屏東縣,新園鄉,田洋村,450,562,71.86700767,220,28.13299233,782,27,809,3,996,81.2248996
屏東縣,新園鄉,田洋村,451,576,70.41564792,242,29.58435208,818,27,845,0,1030,82.03883495
屏東縣,新園鄉,港墘村,452,399,67.05882353,196,32.94117647,595,29,624,1,764,81.67539267
屏東縣,新園鄉,內庄村,453,438,67.17791411,214,32.82208589,652,8,660,0,809,81.58220025
屏東縣,新園鄉,新東村,454,641,64.74747475,349,35.25252525,990,30,1020,0,1232,82.79220779
屏東縣,新園鄉,新東村,455,473,60.17811705,313,39.82188295,786,23,809,0,997,81.14343029
屏東縣,新園鄉,新園村,456,463,59.20716113,319,40.79283887,782,19,801,0,974,82.23819302
屏東縣,新園鄉,新園村,457,546,65.86248492,283,34.13751508,829,27,856,0,1066,80.30018762
屏東縣,新園鄉,烏龍村,463,770,76.011846,243,23.988154,1013,35,1048,0,1268,82.64984227
屏東縣,新園鄉,興龍村,464,624,78,176,22,800,13,813,1,1005,80.89552239
屏東縣,新園鄉,興龍村,465,693,74.67672414,235,25.32327586,928,28,956,0,1167,81.91945159
屏東縣,新園鄉,中洲村,466,631,83.57615894,124,16.42384106,755,23,778,0,927,83.92664509
屏東縣,新園鄉,中洲村,467,475,76.86084142,143,23.13915858,618,15,633,0,794,79.72292191
屏東縣,新園鄉,南龍村,468,868,77.63864043,250,22.36135957,1118,36,1154,0,1424,81.03932584
屏東縣,新園鄉,港西村,458,490,57.10955711,368,42.89044289,858,27,885,0,1057,83.72753075
屏東縣,新園鄉,港西村,459,595,66.92913386,294,33.07086614,889,32,921,0,1125,81.86666667
屏東縣,新園鄉,五房村,460,530,70.57256991,221,29.42743009,751,20,771,0,968,79.64876033
屏東縣,新園鄉,五房村,461,506,74.19354839,176,25.80645161,682,17,699,0,849,82.33215548
屏東縣,新園鄉,五房村,462,419,51.53751538,394,48.46248462,813,44,857,0,1112,77.06834532
屏東縣,新園鄉,鹽埔村,469,847,78.93755825,226,21.06244175,1073,34,1107,0,1418,78.06770099
屏東縣,新園鄉,鹽埔村,470,809,75.53688142,262,24.46311858,1071,27,1098,0,1384,79.33526012
屏東縣,新園鄉,鹽埔村,471,742,73.90438247,262,26.09561753,1004,18,1022,0,1300,78.61538462
屏東縣,新園鄉,共和村,472,602,72.61761158,227,27.38238842,829,13,842,0,1072,78.54477612
屏東縣,新園鄉,共和村,473,690,77.87810384,196,22.12189616,886,27,913,0,1153,79.18473547
屏東縣,崁頂鄉,崁頂村,474,979,59.80452046,658,40.19547954,1637,48,1685,0,2075,81.20481928
屏東縣,崁頂鄉,園寮村,475,771,61.09350238,491,38.90649762,1262,34,1296,0,1681,77.09696609
屏東縣,崁頂鄉,圍內村,477,610,69.476082,268,30.523918,878,22,900,0,1137,79.15567282
屏東縣,崁頂鄉,力社村,476,632,67.52136752,304,32.47863248,936,27,963,1,1155,83.37662338
屏東縣,崁頂鄉,洲子村,478,494,67.76406036,235,32.23593964,729,26,755,0,924,81.70995671
屏東縣,崁頂鄉,北勢村,479,861,73.02798982,318,26.97201018,1179,37,1216,2,1486,81.83041723
屏東縣,崁頂鄉,越溪村,480,407,63.79310345,231,36.20689655,638,20,658,0,817,80.53855569
屏東縣,崁頂鄉,港東村,481,1030,75.95870206,326,24.04129794,1356,56,1412,0,1776,79.5045045
屏東縣,林邊鄉,林邊村,482,799,69.05790838,358,30.94209162,1157,32,1189,0,1482,80.2294197
屏東縣,林邊鄉,光林村,483,825,66.15878107,422,33.84121893,1247,39,1286,0,1650,77.93939394
屏東縣,林邊鄉,仁和村,485,838,66.71974522,418,33.28025478,1256,31,1287,0,1576,81.66243655
屏東縣,林邊鄉,中林村,484,409,61.6892911,254,38.3107089,663,24,687,0,825,83.27272727
屏東縣,林邊鄉,永樂村,486,846,69.00489396,380,30.99510604,1226,26,1252,0,1529,81.88358404
屏東縣,林邊鄉,永樂村,487,947,68.52387844,435,31.47612156,1382,34,1416,0,1741,81.33256749
屏東縣,林邊鄉,水利村,490,909,64.46808511,501,35.53191489,1410,43,1453,1,1938,74.97420021
屏東縣,林邊鄉,崎峰村,489,587,61.85458377,362,38.14541623,949,31,980,0,1353,72.43163341
屏東縣,林邊鄉,田厝村,488,445,63.84505022,252,36.15494978,697,22,719,0,925,77.72972973
屏東縣,林邊鄉,竹林村,491,759,63.25,441,36.75,1200,32,1232,0,1522,80.94612352
屏東縣,林邊鄉,竹林村,492,331,31.73537872,712,68.26462128,1043,34,1077,0,1384,77.81791908
屏東縣,林邊鄉,鎮安村,493,634,71.3963964,254,28.6036036,888,32,920,0,1147,80.2092415
屏東縣,南州鄉,溪洲村,494,872,62.15253029,531,37.84746971,1403,34,1437,0,1777,80.86662915
屏東縣,南州鄉,溪南村,495,474,61.24031008,300,38.75968992,774,18,792,0,986,80.32454361
屏東縣,南州鄉,仁里村,496,254,61.20481928,161,38.79518072,415,10,425,0,537,79.1433892
屏東縣,南州鄉,溪北村,497,236,37.82051282,388,62.17948718,624,7,631,0,784,80.48469388
屏東縣,南州鄉,七塊村,498,476,58.47665848,338,41.52334152,814,36,850,3,1056,80.49242424
屏東縣,南州鄉,萬華村,499,530,66.58291457,266,33.41708543,796,11,807,0,1009,79.98017839
屏東縣,南州鄉,米崙村,500,488,60.3960396,320,39.6039604,808,10,818,0,1021,80.11753183
屏東縣,南州鄉,壽元村,501,702,80.22857143,173,19.77142857,875,26,901,1,1138,79.17398946
屏東縣,南州鄉,同安村,502,510,68.64064603,233,31.35935397,743,25,768,0,955,80.41884817
屏東縣,南州鄉,南安村,503,330,70.66381156,137,29.33618844,467,19,486,0,590,82.37288136
屏東縣,佳冬鄉,佳冬村,504,730,63.64428945,417,36.35571055,1147,39,1186,0,1513,78.38730998
屏東縣,佳冬鄉,六根村,505,730,59.49470253,497,40.50529747,1227,30,1257,0,1603,78.41547099
屏東縣,佳冬鄉,賴家村,506,481,68.51851852,221,31.48148148,702,18,720,0,923,78.00650054
屏東縣,佳冬鄉,萬建村,507,862,67.34375,418,32.65625,1280,25,1305,0,1683,77.54010695
屏東縣,佳冬鄉,石光村,508,1084,72.75167785,406,27.24832215,1490,73,1563,0,1959,79.7856049
屏東縣,佳冬鄉,玉光村,509,527,74.75177305,178,25.24822695,705,27,732,0,959,76.32950991
屏東縣,佳冬鄉,玉光村,510,592,63.18036286,345,36.81963714,937,32,969,0,1268,76.41955836
屏東縣,佳冬鄉,昌隆村,511,606,68.86363636,274,31.13636364,880,34,914,0,1126,81.1722913
屏東縣,佳冬鄉,豐隆村,512,438,68.97637795,197,31.02362205,635,22,657,1,850,77.29411765
屏東縣,佳冬鄉,大同村,513,670,70.74973601,277,29.25026399,947,38,985,0,1196,82.35785953
屏東縣,佳冬鄉,羌園村,514,589,71.74177832,232,28.25822168,821,28,849,0,1042,81.47792706
屏東縣,佳冬鄉,燄溫村,515,525,60,350,40,875,30,905,0,1131,80.01768347
屏東縣,佳冬鄉,塭豐村,516,385,47.5308642,425,52.4691358,810,31,841,2,1079,77.94253939
屏東縣,佳冬鄉,塭豐村,517,505,55.25164114,409,44.74835886,914,32,946,0,1218,77.6683087
屏東縣,琉球鄉,本福村,518,658,51.64835165,616,48.35164835,1274,41,1315,0,2001,65.71714143
屏東縣,琉球鄉,中福村,519,321,45.85714286,379,54.14285714,700,29,729,0,1124,64.85765125
屏東縣,琉球鄉,漁福村,520,176,33.46007605,350,66.53992395,526,22,548,0,916,59.82532751
屏東縣,琉球鄉,大福村,521,330,38.96103896,517,61.03896104,847,45,892,0,1519,58.72284398
屏東縣,琉球鄉,南福村,522,313,50.9771987,301,49.0228013,614,32,646,0,1181,54.69940728
屏東縣,琉球鄉,天福村,523,314,53.04054054,278,46.95945946,592,33,625,0,1054,59.29791271
屏東縣,琉球鄉,上福村,524,391,48.33127318,418,51.66872682,809,46,855,0,1499,57.03802535
屏東縣,琉球鄉,杉福村,525,215,45.45454545,258,54.54545455,473,15,488,0,792,61.61616162
屏東縣,車城鄉,福興村,526,202,63.72239748,115,36.27760252,317,16,333,0,447,74.4966443
屏東縣,車城鄉,福興村,527,400,60.88280061,257,39.11719939,657,23,680,0,948,71.72995781
屏東縣,車城鄉,福安村,528,320,72.39819005,122,27.60180995,442,15,457,0,588,77.72108844
屏東縣,車城鄉,田中村,529,305,61.24497992,193,38.75502008,498,4,502,0,737,68.11397558
屏東縣,車城鄉,海口村,530,320,60.26365348,211,39.73634652,531,21,552,0,777,71.04247104
屏東縣,車城鄉,統埔村,531,174,57.80730897,127,42.19269103,301,13,314,1,433,72.51732102
屏東縣,車城鄉,溫泉村,532,379,60.64,246,39.36,625,32,657,0,987,66.56534954
屏東縣,車城鄉,保力村,533,291,67.36111111,141,32.63888889,432,27,459,0,666,68.91891892
屏東縣,車城鄉,保力村,534,295,67.19817768,144,32.80182232,439,27,466,0,698,66.76217765
屏東縣,車城鄉,新街村,535,224,70,96,30,320,9,329,0,424,77.59433962
屏東縣,車城鄉,埔墘村,536,187,62.54180602,112,37.45819398,299,9,308,0,463,66.52267819
屏東縣,車城鄉,射寮村,537,191,57.35735736,142,42.64264264,333,14,347,0,509,68.17288802
屏東縣,車城鄉,後灣村,538,186,60.38961039,122,39.61038961,308,31,339,0,494,68.62348178
屏東縣,滿州鄉,滿州村,539,543,56.44490644,419,43.55509356,962,51,1013,0,1460,69.38356164
屏東縣,滿州鄉,里德村,543,164,66.66666667,82,33.33333333,246,8,254,0,382,66.4921466
屏東縣,滿州鄉,永靖村,540,490,54.20353982,414,45.79646018,904,40,944,0,1365,69.15750916
屏東縣,滿州鄉,港口村,541,518,64.8310388,281,35.1689612,799,35,834,0,1186,70.32040472
屏東縣,滿州鄉,響林村,542,236,74.92063492,79,25.07936508,315,17,332,0,500,66.4
屏東縣,滿州鄉,長樂村,544,340,42.82115869,454,57.17884131,794,56,850,0,1333,63.76594149
屏東縣,滿州鄉,九棚村,545,104,63.03030303,61,36.96969697,165,8,173,0,272,63.60294118
屏東縣,滿州鄉,港仔村,546,131,57.20524017,98,42.79475983,229,1,230,0,357,64.42577031
屏東縣,枋山鄉,枋山村,549,200,49.5049505,204,50.4950495,404,21,425,0,596,71.30872483
屏東縣,枋山鄉,枋山村,550,175,52.08333333,161,47.91666667,336,4,340,0,465,73.11827957
屏東縣,枋山鄉,加祿村,547,451,64.42857143,249,35.57142857,700,31,731,0,912,80.15350877
屏東縣,枋山鄉,加祿村,548,357,50.42372881,351,49.57627119,708,29,737,0,916,80.45851528
屏東縣,枋山鄉,楓港村,551,420,63.34841629,243,36.65158371,663,43,706,0,1076,65.6133829
屏東縣,枋山鄉,善餘村,552,426,64.64339909,233,35.35660091,659,8,667,0,1005,66.3681592
屏東縣,三地門鄉,三地村,553,124,13.13559322,820,86.86440678,944,22,966,0,1238,78.02907916
屏東縣,三地門鄉,達來村,554,22,11,178,89,200,3,203,0,268,75.74626866
屏東縣,三地門鄉,德文村,555,87,25.51319648,254,74.48680352,341,26,367,1,501,73.25349301
屏東縣,三地門鄉,大社村,556,42,12.28070175,300,87.71929825,342,14,356,0,473,75.26427061
屏東縣,三地門鄉,賽嘉村,557,75,18.29268293,335,81.70731707,410,9,419,1,575,72.86956522
屏東縣,三地門鄉,口社村,558,66,18.33333333,294,81.66666667,360,7,367,0,495,74.14141414
屏東縣,三地門鄉,馬兒村,559,31,14.35185185,185,85.64814815,216,1,217,0,298,72.81879195
屏東縣,三地門鄉,安坡村,560,52,18.90909091,223,81.09090909,275,9,284,0,373,76.13941019
屏東縣,三地門鄉,青山村,561,36,8.017817372,413,91.98218263,449,18,467,0,622,75.08038585
屏東縣,三地門鄉,青葉村,562,51,11.94379391,376,88.05620609,427,14,441,0,559,78.89087657
屏東縣,霧臺鄉,霧臺村,563,31,29.80769231,73,70.19230769,104,1,105,0,137,76.64233577
屏東縣,霧臺鄉,霧臺村,564,47,21.36363636,173,78.63636364,220,13,233,0,292,79.79452055
屏東縣,霧臺鄉,霧臺村,565,51,10.96774194,414,89.03225806,465,12,477,2,603,79.10447761
屏東縣,霧臺鄉,阿禮村,567,12,8,138,92,150,3,153,0,201,76.11940299
屏東縣,霧臺鄉,吉露村,566,14,14.89361702,80,85.10638298,94,8,102,0,123,82.92682927
屏東縣,霧臺鄉,大武村,568,67,23.50877193,218,76.49122807,285,12,297,0,394,75.38071066
屏東縣,霧臺鄉,佳暮村,569,22,10.0456621,197,89.9543379,219,3,222,0,292,76.02739726
屏東縣,霧臺鄉,好茶村,570,98,39.2,152,60.8,250,1,251,0,335,74.92537313
屏東縣,瑪家鄉,瑪家村,571,50,22.83105023,169,77.16894977,219,1,220,0,305,72.13114754
屏東縣,瑪家鄉,北葉村,572,71,11.83333333,529,88.16666667,600,11,611,0,743,82.23418573
屏東縣,瑪家鄉,涼山村,573,82,12.14814815,593,87.85185185,675,23,698,0,933,74.81243301
屏東縣,瑪家鄉,佳義村,574,112,19.27710843,469,80.72289157,581,10,591,0,769,76.85305592
屏東縣,瑪家鄉,排灣村,575,36,14.63414634,210,85.36585366,246,14,260,0,351,74.07407407
屏東縣,瑪家鄉,三和村,576,76,15.8004158,405,84.1995842,481,10,491,0,636,77.20125786
屏東縣,瑪家鄉,三和村,577,44,10.86419753,361,89.13580247,405,2,407,0,495,82.22222222
屏東縣,瑪家鄉,三和村,578,54,13.60201511,343,86.39798489,397,17,414,0,564,73.40425532
屏東縣,泰武鄉,佳平村,579,27,6.221198157,407,93.77880184,434,8,442,0,531,83.23917137
屏東縣,泰武鄉,佳平村,580,18,13.84615385,112,86.15384615,130,6,136,0,160,85
屏東縣,泰武鄉,武潭村,581,51,8.319738989,562,91.68026101,613,26,639,0,825,77.45454545
屏東縣,泰武鄉,平和村,582,132,36.4640884,230,63.5359116,362,5,367,0,464,79.09482759
屏東縣,泰武鄉,佳興村,583,19,7.480314961,235,92.51968504,254,3,257,0,333,77.17717718
屏東縣,泰武鄉,泰武村,584,15,3.731343284,387,96.26865672,402,17,419,0,574,72.99651568
屏東縣,泰武鄉,萬安村,585,28,5.46875,484,94.53125,512,10,522,0,657,79.45205479
屏東縣,來義鄉,來義村,586,48,7.631160572,581,92.36883943,629,14,643,0,824,78.03398058
屏東縣,來義鄉,義林村,587,17,6.995884774,226,93.00411523,243,4,247,0,310,79.67741935
屏東縣,來義鄉,義林村,588,10,6.849315068,136,93.15068493,146,1,147,0,195,75.38461538
屏東縣,來義鄉,丹林村,589,13,4.0625,307,95.9375,320,2,322,0,393,81.93384224
屏東縣,來義鄉,丹林村,590,28,14.65968586,163,85.34031414,191,0,191,0,239,79.91631799
屏東縣,來義鄉,古樓村,591,94,12.84153005,638,87.15846995,732,23,755,0,1020,74.01960784
屏東縣,來義鄉,文樂村,592,32,5.306799337,571,94.69320066,603,25,628,0,810,77.5308642
屏東縣,來義鄉,望嘉村,593,27,3.935860058,659,96.06413994,686,6,692,0,836,82.77511962
屏東縣,來義鄉,南和村,594,60,6.976744186,800,93.02325581,860,35,895,1,1155,77.48917749
屏東縣,春日鄉,春日村,595,48,9.486166008,458,90.51383399,506,30,536,0,772,69.43005181
屏東縣,春日鄉,古華村,596,38,8.695652174,399,91.30434783,437,20,457,0,624,73.23717949
屏東縣,春日鄉,士文村,597,8,3.603603604,214,96.3963964,222,9,231,0,312,74.03846154
屏東縣,春日鄉,七佳村,599,61,9.918699187,554,90.08130081,615,38,653,0,839,77.83075089
屏東縣,春日鄉,歸崇村,598,45,9.698275862,419,90.30172414,464,26,490,0,671,73.02533532
屏東縣,春日鄉,力里村,600,14,4.334365325,309,95.66563467,323,6,329,0,426,77.23004695
屏東縣,獅子鄉,楓林村,601,60,14.11764706,365,85.88235294,425,9,434,0,656,66.15853659
屏東縣,獅子鄉,丹路村,602,41,8.631578947,434,91.36842105,475,23,498,0,739,67.38836265
屏東縣,獅子鄉,草埔村,603,21,4.635761589,432,95.36423841,453,3,456,0,649,70.26194145
屏東縣,獅子鄉,內文村,604,7,4.861111111,137,95.13888889,144,6,150,0,243,61.72839506
屏東縣,獅子鄉,竹坑村,605,15,9.036144578,151,90.96385542,166,0,166,0,250,66.4
屏東縣,獅子鄉,獅子村,606,15,6.52173913,215,93.47826087,230,8,238,0,382,62.30366492
屏東縣,獅子鄉,內獅村,607,21,5.357142857,371,94.64285714,392,3,395,0,534,73.97003745
屏東縣,獅子鄉,南世村,608,7,2.953586498,230,97.0464135,237,6,243,0,335,72.53731343
屏東縣,牡丹鄉,石門村,609,92,12.97602257,617,87.02397743,709,28,737,0,1054,69.92409867
屏東縣,牡丹鄉,石門村,610,27,14.67391304,157,85.32608696,184,8,192,0,278,69.0647482
屏東縣,牡丹鄉,牡丹村,611,44,10.06864989,393,89.93135011,437,31,468,0,674,69.43620178
屏東縣,牡丹鄉,東源村,612,52,20.15503876,206,79.84496124,258,8,266,0,396,67.17171717
屏東縣,牡丹鄉,旭海村,613,64,26.44628099,178,73.55371901,242,4,246,0,387,63.56589147
屏東縣,牡丹鄉,高士村,614,22,6.50887574,316,93.49112426,338,8,346,0,484,71.48760331
屏東縣,牡丹鄉,四林村,615,35,11.40065147,272,88.59934853,307,27,334,0,543,61.51012891
臺東縣,台東市,富岡里,48,325,32.86147624,664,67.13852376,989,50,1039,0,1537,67.59921926
臺東縣,台東市,富豐里,49,211,38.29401089,340,61.70598911,551,16,567,0,866,65.47344111
臺東縣,台東市,岩灣里,52,249,33.15579228,502,66.84420772,751,20,771,0,1231,62.6320065
臺東縣,台東市,南王里,54,281,31.11849391,622,68.88150609,903,13,916,0,1296,70.67901235
臺東縣,台東市,南王里,55,217,30.73654391,489,69.26345609,706,23,729,0,1071,68.06722689
臺東縣,台東市,卑南里,53,837,51.89088655,776,48.10911345,1613,10,1623,0,2085,77.84172662
臺東縣,台東市,南榮里,50,150,20.80443828,571,79.19556172,721,27,748,0,1069,69.97193639
臺東縣,台東市,南榮里,51,259,36.42756681,452,63.57243319,711,24,735,0,1191,61.71284635
臺東縣,台東市,新生里,26,428,40.41548631,631,59.58451369,1059,14,1073,0,1581,67.8684377
臺東縣,台東市,新生里,27,464,32.83793347,949,67.16206653,1413,28,1441,0,1972,73.07302231
臺東縣,台東市,新生里,28,449,34.27480916,861,65.72519084,1310,23,1333,1,1898,70.23182297
臺東縣,台東市,民生里,4,554,37.61031908,919,62.38968092,1473,17,1490,0,1970,75.63451777
臺東縣,台東市,民生里,5,468,39.62743438,713,60.37256562,1181,13,1194,0,1609,74.20758235
臺東縣,台東市,民生里,6,410,43.89721627,524,56.10278373,934,29,963,0,1313,73.34348819
臺東縣,台東市,寶桑里,7,245,37.34756098,411,62.65243902,656,22,678,0,964,70.33195021
臺東縣,台東市,馬蘭里,31,339,32.59615385,701,67.40384615,1040,22,1062,0,1406,75.53342817
臺東縣,台東市,馬蘭里,32,349,33.17490494,703,66.82509506,1052,12,1064,0,1390,76.54676259
臺東縣,台東市,中心里,29,325,37.48558247,542,62.51441753,867,24,891,0,1228,72.55700326
臺東縣,台東市,中心里,30,411,37.06041479,698,62.93958521,1109,17,1126,0,1462,77.01778386
臺東縣,台東市,自強里,3,480,39.6039604,732,60.3960396,1212,19,1231,0,1664,73.97836538
臺東縣,台東市,民族里,2,523,46.24226348,608,53.75773652,1131,13,1144,0,1471,77.77022434
臺東縣,台東市,四維里,9,128,26.5560166,354,73.4439834,482,17,499,0,729,68.44993141
臺東縣,台東市,中華里,10,310,47.47320061,343,52.52679939,653,10,663,0,916,72.37991266
臺東縣,台東市,中華里,11,218,41.92307692,302,58.07692308,520,6,526,0,752,69.94680851
臺東縣,台東市,強國里,13,197,43.97321429,251,56.02678571,448,16,464,0,581,79.86230637
臺東縣,台東市,建國里,16,369,40.23991276,548,59.76008724,917,29,946,0,1371,69.00072939
臺東縣,台東市,民權里,8,325,37.31343284,546,62.68656716,871,9,880,0,1196,73.57859532
臺東縣,台東市,仁愛里,12,240,44.03669725,305,55.96330275,545,13,558,0,743,75.10094213
臺東縣,台東市,中正里,17,340,51.67173252,318,48.32826748,658,9,667,0,907,73.53914002
臺東縣,台東市,大同里,14,229,42.01834862,316,57.98165138,545,6,551,0,773,71.28072445
臺東縣,台東市,成功里,15,290,50.43478261,285,49.56521739,575,13,588,0,846,69.5035461
臺東縣,台東市,文化里,1,258,35.29411765,473,64.70588235,731,9,740,0,1016,72.83464567
臺東縣,台東市,中山里,18,356,49.17127072,368,50.82872928,724,12,736,0,951,77.39221872
臺東縣,台東市,復國里,23,193,42.04793028,266,57.95206972,459,19,478,0,692,69.07514451
臺東縣,台東市,興國里,19,293,51.76678445,273,48.23321555,566,3,569,0,743,76.58142665
臺東縣,台東市,復興里,24,132,37.07865169,224,62.92134831,356,8,364,0,504,72.22222222
臺東縣,台東市,鐵花里,20,171,56.81063123,130,43.18936877,301,5,306,0,442,69.23076923
臺東縣,台東市,新園里,58,364,36.84210526,624,63.15789474,988,32,1020,0,1503,67.86427146
臺東縣,台東市,豐田里,56,329,50.69337442,320,49.30662558,649,17,666,0,914,72.86652079
臺東縣,台東市,豐田里,57,335,49.33726068,344,50.66273932,679,22,701,0,951,73.71188223
臺東縣,台東市,豐年里,34,248,36.09898108,439,63.90101892,687,19,706,0,1094,64.53382084
臺東縣,台東市,豐年里,35,247,27.87810384,639,72.12189616,886,30,916,0,1289,71.06283941
臺東縣,台東市,光明里,33,420,32.25806452,882,67.74193548,1302,19,1321,0,1841,71.75448126
臺東縣,台東市,豐樂里,36,389,42.56017505,525,57.43982495,914,24,938,0,1326,70.73906486
臺東縣,台東市,永樂里,37,464,43.89782403,593,56.10217597,1057,23,1080,0,1453,74.32897454
臺東縣,台東市,康樂里,38,424,50.59665871,414,49.40334129,838,19,857,0,1211,70.76796036
臺東縣,台東市,東海里,21,335,35.41226216,611,64.58773784,946,18,964,0,1278,75.43035994
臺東縣,台東市,東海里,22,491,37.88580247,805,62.11419753,1296,28,1324,0,1764,75.05668934
臺東縣,台東市,新興里,25,372,45.47677262,446,54.52322738,818,20,838,0,1191,70.36104114
臺東縣,台東市,豐榮里,39,303,30.20937188,700,69.79062812,1003,23,1026,0,1429,71.79846046
臺東縣,台東市,豐榮里,40,326,33.47022587,648,66.52977413,974,27,1001,0,1480,67.63513514
臺東縣,台東市,豐榮里,41,378,33.57015986,748,66.42984014,1126,14,1140,0,1563,72.93666027
臺東縣,台東市,豐榮里,42,543,36.07973422,962,63.92026578,1505,22,1527,0,2095,72.88782816
臺東縣,台東市,豐谷里,43,340,34.06813627,658,65.93186373,998,24,1022,0,1495,68.36120401
臺東縣,台東市,豐谷里,44,367,35.98039216,653,64.01960784,1020,33,1053,0,1516,69.4591029
臺東縣,台東市,豐谷里,45,350,35.3892821,639,64.6107179,989,20,1009,0,1434,70.36262204
臺東縣,台東市,豐里里,46,692,51.18343195,660,48.81656805,1352,54,1406,0,2068,67.98839458
臺東縣,台東市,豐原里,47,420,60.34482759,276,39.65517241,696,23,719,0,1015,70.83743842
臺東縣,台東市,建和里,59,335,38.11149033,544,61.88850967,879,30,909,0,1330,68.34586466
臺東縣,台東市,建興里,60,330,50.92592593,318,49.07407407,648,23,671,0,914,73.41356674
臺東縣,台東市,建業里,61,294,34.02777778,570,65.97222222,864,22,886,0,1288,68.78881988
臺東縣,台東市,知本里,62,313,37.52997602,521,62.47002398,834,14,848,0,1163,72.91487532
臺東縣,台東市,建農里,63,182,18.87966805,782,81.12033195,964,40,1004,0,1511,66.44606221
臺東縣,成功鎮,博愛里,78,23,10.13215859,204,89.86784141,227,10,237,0,428,55.37383178
臺東縣,成功鎮,博愛里,79,33,19.07514451,140,80.92485549,173,3,176,0,325,54.15384615
臺東縣,成功鎮,忠孝里,76,84,25.1497006,250,74.8502994,334,2,336,0,629,53.41812401
臺東縣,成功鎮,忠孝里,77,76,26.76056338,208,73.23943662,284,12,296,0,540,54.81481481
臺東縣,成功鎮,三仙里,74,106,33.65079365,209,66.34920635,315,5,320,0,598,53.51170569
臺東縣,成功鎮,三仙里,75,119,22.92870906,400,77.07129094,519,24,543,0,1094,49.63436929
臺東縣,成功鎮,三民里,72,143,21.69954476,516,78.30045524,659,16,675,0,1222,55.23731588
臺東縣,成功鎮,三民里,73,166,19.27990708,695,80.72009292,861,38,899,0,1570,57.2611465
臺東縣,成功鎮,忠智里,70,284,28.28685259,720,71.71314741,1004,22,1026,0,1501,68.35443038
臺東縣,成功鎮,忠智里,71,245,31.69469599,528,68.30530401,773,14,787,0,1132,69.5229682
臺東縣,成功鎮,忠仁里,68,55,29.41176471,132,70.58823529,187,13,200,0,383,52.21932115
臺東縣,成功鎮,忠仁里,69,288,36.36363636,504,63.63636364,792,19,811,0,1228,66.04234528
臺東縣,成功鎮,忠仁里,70,284,28.28685259,720,71.71314741,1004,22,1026,0,1501,68.35443038
臺東縣,成功鎮,和平里,67,83,20.44334975,323,79.55665025,406,13,419,0,854,49.06323185
臺東縣,成功鎮,信義里,64,64,20.12578616,254,79.87421384,318,14,332,0,606,54.78547855
臺東縣,成功鎮,信義里,65,88,17.49502982,415,82.50497018,503,17,520,0,1059,49.10292729
臺東縣,成功鎮,信義里,66,46,20.53571429,178,79.46428571,224,13,237,0,432,54.86111111
臺東縣,關山鎮,德高里,86,139,23.63945578,449,76.36054422,588,24,612,1,1005,60.89552239
臺東縣,關山鎮,德高里,87,237,42.54937163,320,57.45062837,557,8,565,0,825,68.48484848
臺東縣,關山鎮,豐泉里,84,227,31.18131868,501,68.81868132,728,19,747,0,1101,67.84741144
臺東縣,關山鎮,新福里,83,212,37.12784588,359,62.87215412,571,22,593,0,941,63.01806589
臺東縣,關山鎮,中福里,82,259,41.37380192,367,58.62619808,626,16,642,0,868,73.96313364
臺東縣,關山鎮,里壟里,80,218,33.28244275,437,66.71755725,655,7,662,1,925,71.56756757
臺東縣,關山鎮,里壟里,81,136,24.72727273,414,75.27272727,550,19,569,0,863,65.93279258
臺東縣,關山鎮,電光里,88,73,22.88401254,246,77.11598746,319,15,334,0,597,55.94639866
臺東縣,關山鎮,月眉里,85,209,44.84978541,257,55.15021459,466,28,494,0,757,65.25759577
臺東縣,卑南鄉,嘉豐村,98,98,51.04166667,94,48.95833333,192,11,203,0,324,62.65432099
臺東縣,卑南鄉,嘉豐村,99,37,28.68217054,92,71.31782946,129,6,135,0,236,57.20338983
臺東縣,卑南鄉,利吉村,110,117,42.54545455,158,57.45454545,275,10,285,0,470,60.63829787
臺東縣,卑南鄉,富山村,108,147,40.83333333,213,59.16666667,360,12,372,0,582,63.91752577
臺東縣,卑南鄉,富源村,109,142,58.43621399,101,41.56378601,243,7,250,0,356,70.2247191
臺東縣,卑南鄉,明峰村,96,282,55.51181102,226,44.48818898,508,22,530,0,814,65.11056511
臺東縣,卑南鄉,明峰村,97,112,37.58389262,186,62.41610738,298,9,307,0,473,64.90486258
臺東縣,卑南鄉,初鹿村,94,236,45.2975048,285,54.7024952,521,10,531,0,805,65.96273292
臺東縣,卑南鄉,初鹿村,95,193,47.07317073,217,52.92682927,410,4,414,0,576,71.875
臺東縣,卑南鄉,美農村,91,110,69.62025316,48,30.37974684,158,6,164,0,238,68.90756303
臺東縣,卑南鄉,美農村,92,206,62.04819277,126,37.95180723,332,8,340,0,459,74.07407407
臺東縣,卑南鄉,美農村,93,126,56.75675676,96,43.24324324,222,7,229,0,329,69.60486322
臺東縣,卑南鄉,賓朗村,89,425,60.02824859,283,39.97175141,708,26,734,0,986,74.44219067
臺東縣,卑南鄉,賓朗村,90,328,40.94881398,473,59.05118602,801,25,826,0,1201,68.77601998
臺東縣,卑南鄉,泰安村,103,178,25.98540146,507,74.01459854,685,19,704,0,1020,69.01960784
臺東縣,卑南鄉,太平村,100,413,39.78805395,625,60.21194605,1038,17,1055,0,1434,73.57043236
臺東縣,卑南鄉,太平村,101,39,8.705357143,409,91.29464286,448,44,492,0,791,62.19974716
臺東縣,卑南鄉,太平村,102,213,32.37082067,445,67.62917933,658,10,668,0,953,70.09443861
臺東縣,卑南鄉,利嘉村,104,143,21.40718563,525,78.59281437,668,20,688,0,959,71.74139729
臺東縣,卑南鄉,東興村,105,73,10.31073446,635,89.68926554,708,25,733,0,1108,66.15523466
臺東縣,卑南鄉,溫泉村,106,391,59.96932515,261,40.03067485,652,25,677,0,933,72.56162915
臺東縣,卑南鄉,溫泉村,107,92,73.6,33,26.4,125,2,127,0,185,68.64864865
臺東縣,鹿野鄉,瑞和村,118,143,34.87804878,267,65.12195122,410,14,424,0,731,58.00273598
臺東縣,鹿野鄉,瑞豐村,119,155,50.48859935,152,49.51140065,307,15,322,0,472,68.22033898
臺東縣,鹿野鄉,瑞豐村,120,277,75.89041096,88,24.10958904,365,12,377,0,552,68.29710145
臺東縣,鹿野鄉,瑞源村,117,183,30.60200669,415,69.39799331,598,12,610,0,924,66.01731602
臺東縣,鹿野鄉,永安村,114,214,34.51612903,406,65.48387097,620,15,635,0,1027,61.83057449
臺東縣,鹿野鄉,永安村,115,57,23.07692308,190,76.92307692,247,5,252,0,394,63.95939086
臺東縣,鹿野鄉,瑞隆村,116,219,36.13861386,387,63.86138614,606,19,625,0,999,62.56256256
臺東縣,鹿野鄉,鹿野村,111,75,22.72727273,255,77.27272727,330,4,334,0,551,60.61705989
臺東縣,鹿野鄉,鹿野村,112,181,47.88359788,197,52.11640212,378,9,387,0,605,63.96694215
臺東縣,鹿野鄉,龍田村,113,415,57.24137931,310,42.75862069,725,30,755,0,1116,67.65232975
臺東縣,池上鄉,福文村,123,170,45.57640751,203,54.42359249,373,13,386,0,603,64.013267
臺東縣,池上鄉,福文村,124,149,30.59548255,338,69.40451745,487,11,498,0,847,58.7957497
臺東縣,池上鄉,慶豐村,125,192,42.76169265,257,57.23830735,449,15,464,0,736,63.04347826
臺東縣,池上鄉,大坡村,126,59,29.20792079,143,70.79207921,202,8,210,0,388,54.12371134
臺東縣,池上鄉,大埔村,127,154,33.18965517,310,66.81034483,464,18,482,0,822,58.63746959
臺東縣,池上鄉,福原村,121,249,35.6223176,450,64.3776824,699,25,724,0,1078,67.16141002
臺東縣,池上鄉,福原村,122,318,50.55643879,311,49.44356121,629,10,639,0,936,68.26923077
臺東縣,池上鄉,錦園村,129,127,50,127,50,254,12,266,0,410,64.87804878
臺東縣,池上鄉,新興村,128,205,39.96101365,308,60.03898635,513,22,535,0,868,61.6359447
臺東縣,池上鄉,萬安村,130,150,69.44444444,66,30.55555556,216,4,220,0,369,59.62059621
臺東縣,池上鄉,富興村,131,98,34.62897527,185,65.37102473,283,12,295,1,454,64.97797357
臺東縣,池上鄉,振興村,132,41,18.63636364,179,81.36363636,220,11,231,0,426,54.22535211
臺東縣,東河鄉,北源村,140,96,22.85714286,324,77.14285714,420,15,435,0,833,52.22088836
臺東縣,東河鄉,北源村,141,50,22.52252252,172,77.47747748,222,7,229,0,421,54.39429929
臺東縣,東河鄉,北源村,142,89,29.96632997,208,70.03367003,297,11,308,0,501,61.47704591
臺東縣,東河鄉,泰源村,139,186,22.79411765,630,77.20588235,816,27,843,1,1504,56.05053191
臺東縣,東河鄉,東河村,138,89,15.18771331,497,84.81228669,586,12,598,0,1082,55.26802218
臺東縣,東河鄉,尚德村,143,45,30,105,70,150,4,154,0,261,59.00383142
臺東縣,東河鄉,隆昌村,137,112,31.46067416,244,68.53932584,356,10,366,0,597,61.30653266
臺東縣,東河鄉,興昌村,136,247,39.26868045,382,60.73131955,629,27,656,0,1071,61.25116713
臺東縣,東河鄉,都蘭村,133,97,50.25906736,96,49.74093264,193,13,206,0,350,58.85714286
臺東縣,東河鄉,都蘭村,134,180,39.30131004,278,60.69868996,458,14,472,0,758,62.26912929
臺東縣,東河鄉,都蘭村,135,208,29.67189729,493,70.32810271,701,29,730,0,1243,58.72888174
臺東縣,長濱鄉,樟原村,152,35,25.17985612,104,74.82014388,139,4,143,0,277,51.62454874
臺東縣,長濱鄉,樟原村,153,113,25.85812357,324,74.14187643,437,15,452,0,740,61.08108108
臺東縣,長濱鄉,三間村,150,100,25,300,75,400,12,412,0,786,52.4173028
臺東縣,長濱鄉,三間村,151,55,19.64285714,225,80.35714286,280,7,287,0,464,61.85344828
臺東縣,長濱鄉,三間村,152,35,25.17985612,104,74.82014388,139,4,143,0,277,51.62454874
臺東縣,長濱鄉,忠勇村,149,117,37.74193548,193,62.25806452,310,16,326,0,664,49.09638554
臺東縣,長濱鄉,長濱村,147,261,35.27027027,479,64.72972973,740,30,770,0,1335,57.67790262
臺東縣,長濱鄉,長濱村,148,98,21.77777778,352,78.22222222,450,21,471,0,855,55.0877193
臺東縣,長濱鄉,竹湖村,146,204,34.05676127,395,65.94323873,599,10,609,0,1119,54.42359249
臺東縣,長濱鄉,寧埔村,144,90,27.77777778,234,72.22222222,324,4,328,0,674,48.66468843
臺東縣,長濱鄉,寧埔村,145,108,22.31404959,376,77.68595041,484,14,498,1,924,53.8961039
臺東縣,太麻里鄉,美和村,154,398,50.06289308,397,49.93710692,795,28,823,0,1239,66.42453592
臺東縣,太麻里鄉,三和村,155,225,53.06603774,199,46.93396226,424,11,435,0,637,68.288854
臺東縣,太麻里鄉,華源村,156,301,64.04255319,169,35.95744681,470,20,490,0,709,69.11142454
臺東縣,太麻里鄉,北里村,157,163,42.78215223,218,57.21784777,381,12,393,0,590,66.61016949
臺東縣,太麻里鄉,泰和村,160,259,42.38952537,352,57.61047463,611,17,628,0,854,73.53629977
臺東縣,太麻里鄉,泰和村,161,178,41.68618267,249,58.31381733,427,18,445,0,663,67.11915535
臺東縣,太麻里鄉,大王村,158,143,24.03361345,452,75.96638655,595,10,605,0,892,67.82511211
臺東縣,太麻里鄉,大王村,159,294,54.34380776,247,45.65619224,541,13,554,0,815,67.97546012
臺東縣,太麻里鄉,香蘭村,162,129,44.94773519,158,55.05226481,287,10,297,0,503,59.04572565
臺東縣,太麻里鄉,香蘭村,163,68,30.22222222,157,69.77777778,225,13,238,0,375,63.46666667
臺東縣,太麻里鄉,金崙村,164,20,3.992015968,481,96.00798403,501,12,513,0,749,68.49132176
臺東縣,太麻里鄉,金崙村,165,48,14.58966565,281,85.41033435,329,13,342,0,517,66.15087041
臺東縣,太麻里鄉,金崙村,166,41,16.80327869,203,83.19672131,244,8,252,0,418,60.28708134
臺東縣,太麻里鄉,多良村,167,7,4.166666667,161,95.83333333,168,7,175,0,283,61.83745583
臺東縣,太麻里鄉,多良村,168,58,14.4638404,343,85.5361596,401,3,404,0,681,59.32452276
臺東縣,大武鄉,大竹村,173,17,6.093189964,262,93.90681004,279,9,288,0,515,55.9223301
臺東縣,大武鄉,大竹村,174,18,9,182,91,200,11,211,0,358,58.93854749
臺東縣,大武鄉,大鳥村,172,52,7.232267038,667,92.76773296,719,19,738,0,1144,64.51048951
臺東縣,大武鄉,大武村,171,269,30.32694476,618,69.67305524,887,19,906,0,1539,58.86939571
臺東縣,大武鄉,尚武村,170,468,45.34883721,564,54.65116279,1032,25,1057,0,1817,58.17281233
臺東縣,大武鄉,南興村,169,137,34.50881612,260,65.49118388,397,11,408,0,642,63.55140187
臺東縣,綠島鄉,公館村,177,22,8.396946565,240,91.60305344,262,9,271,0,486,55.76131687
臺東縣,綠島鄉,公館村,178,5,5.555555556,85,94.44444444,90,2,92,0,143,64.33566434
臺東縣,綠島鄉,中寮村,176,72,14.4,428,85.6,500,6,506,0,911,55.54335895
臺東縣,綠島鄉,南寮村,175,57,11.51515152,438,88.48484848,495,9,504,0,817,61.68910649
臺東縣,海端鄉,廣原村,182,33,7.482993197,408,92.5170068,441,12,453,0,726,62.39669421
臺東縣,海端鄉,霧鹿村,183,9,4.891304348,175,95.10869565,184,8,192,0,263,73.00380228
臺東縣,海端鄉,利稻村,184,32,18.18181818,144,81.81818182,176,4,180,0,253,71.14624506
臺東縣,海端鄉,海端村,181,57,10.47794118,487,89.52205882,544,15,559,0,910,61.42857143
臺東縣,海端鄉,崁頂村,180,32,8.767123288,333,91.23287671,365,14,379,0,572,66.25874126
臺東縣,海端鄉,加拿村,179,14,4.713804714,283,95.28619529,297,16,313,0,496,63.10483871
臺東縣,延平鄉,武陵村,188,28,7.82122905,330,92.17877095,358,12,370,0,580,63.79310345
臺東縣,延平鄉,永康村,187,16,8.695652174,168,91.30434783,184,2,186,0,270,68.88888889
臺東縣,延平鄉,紅葉村,186,35,13.61867704,222,86.38132296,257,9,266,0,412,64.5631068
臺東縣,延平鄉,鸞山村,189,13,4.304635762,289,95.69536424,302,4,306,0,504,60.71428571
臺東縣,延平鄉,鸞山村,190,31,54.38596491,26,45.61403509,57,6,63,0,90,70
臺東縣,延平鄉,桃源村,185,120,20.94240838,453,79.05759162,573,18,591,0,870,67.93103448
臺東縣,金峰鄉,新興村,193,35,12.15277778,253,87.84722222,288,9,297,0,392,75.76530612
臺東縣,金峰鄉,正興村,192,26,7.344632768,328,92.65536723,354,0,354,0,481,73.5966736
臺東縣,金峰鄉,嘉蘭村,191,45,6.726457399,624,93.2735426,669,17,686,0,990,69.29292929
臺東縣,金峰鄉,賓茂村,194,3,1.428571429,207,98.57142857,210,4,214,0,287,74.56445993
臺東縣,金峰鄉,歷坵村,195,12,5.555555556,204,94.44444444,216,3,219,0,296,73.98648649
臺東縣,達仁鄉,台板村,201,26,6.878306878,352,93.12169312,378,13,391,0,596,65.60402685
臺東縣,達仁鄉,土板村,202,20,4.192872117,457,95.80712788,477,2,479,0,807,59.35563817
臺東縣,達仁鄉,新化村,200,27,11.68831169,204,88.31168831,231,12,243,0,361,67.31301939
臺東縣,達仁鄉,安朔村,196,34,17,166,83,200,8,208,0,319,65.20376176
臺東縣,達仁鄉,安朔村,197,23,11.00478469,186,88.99521531,209,7,216,0,343,62.97376093
臺東縣,達仁鄉,森永村,199,47,20.70484581,180,79.29515419,227,3,230,0,380,60.52631579
臺東縣,達仁鄉,南田村,198,11,7.432432432,137,92.56756757,148,0,148,0,236,62.71186441
臺東縣,蘭嶼鄉,東清村,205,82,23.22946176,271,76.77053824,353,32,385,0,755,50.99337748
臺東縣,蘭嶼鄉,朗島村,206,105,49.52830189,107,50.47169811,212,9,221,0,446,49.55156951
臺東縣,蘭嶼鄉,紅頭村,204,53,15.91591592,280,84.08408408,333,42,375,0,699,53.64806867
臺東縣,蘭嶼鄉,椰油村,203,46,15.6996587,247,84.3003413,293,26,319,0,590,54.06779661
花蓮縣,花蓮市,民立里,17,304,29.17466411,738,70.82533589,1042,15,1057,1,1373,76.98470503
花蓮縣,花蓮市,民運里,13,258,33.59375,510,66.40625,768,18,786,0,1030,76.31067961
花蓮縣,花蓮市,民運里,14,178,25.79710145,512,74.20289855,690,16,706,0,941,75.02656748
花蓮縣,花蓮市,民族里,22,167,40.14423077,249,59.85576923,416,7,423,0,568,74.47183099
花蓮縣,花蓮市,主信里,28,208,40.46692607,306,59.53307393,514,12,526,0,713,73.77279102
花蓮縣,花蓮市,主睦里,29,318,40.10088272,475,59.89911728,793,14,807,0,1085,74.37788018
花蓮縣,花蓮市,主和里,31,241,34.92753623,449,65.07246377,690,14,704,0,930,75.69892473
花蓮縣,花蓮市,主和里,32,308,41.73441734,430,58.26558266,738,8,746,0,1032,72.28682171
花蓮縣,花蓮市,主和里,33,320,42.66666667,430,57.33333333,750,22,772,0,1012,76.28458498
花蓮縣,花蓮市,國威里,48,244,42.14162349,335,57.85837651,579,7,586,0,737,79.51153324
花蓮縣,花蓮市,國威里,49,222,36.69421488,383,63.30578512,605,5,610,0,1000,61
花蓮縣,花蓮市,國風里,46,441,36.84210526,756,63.15789474,1197,16,1213,0,1541,78.71512005
花蓮縣,花蓮市,國風里,47,421,37.62287757,698,62.37712243,1119,14,1133,0,1514,74.8348745
花蓮縣,花蓮市,民德里,1,289,26.2966333,810,73.7033667,1099,16,1115,0,1429,78.02659202
花蓮縣,花蓮市,民意里,5,141,20.056899,562,79.943101,703,9,712,0,964,73.85892116
花蓮縣,花蓮市,民意里,6,28,6.496519722,403,93.50348028,431,60,491,0,858,57.22610723
花蓮縣,花蓮市,民意里,7,27,4.770318021,539,95.22968198,566,21,587,0,828,70.89371981
花蓮縣,花蓮市,民治里,21,70,23.89078498,223,76.10921502,293,5,298,0,382,78.0104712
花蓮縣,花蓮市,主義里,29,318,40.10088272,475,59.89911728,793,14,807,0,1085,74.37788018
花蓮縣,花蓮市,主工里,27,208,43.60587002,269,56.39412998,477,2,479,1,633,75.671406
花蓮縣,花蓮市,主農里,36,326,32.05506391,691,67.94493609,1017,11,1028,0,1375,74.76363636
花蓮縣,花蓮市,主農里,37,436,37.20136519,736,62.79863481,1172,10,1182,0,1543,76.60401815
花蓮縣,花蓮市,國治里,50,247,31.54533844,536,68.45466156,783,5,788,0,1054,74.76280835
花蓮縣,花蓮市,國富里,63,379,35.55347092,687,64.44652908,1066,17,1083,0,1434,75.52301255
花蓮縣,花蓮市,國富里,64,429,34.12887828,828,65.87112172,1257,23,1280,0,1684,76.00950119
花蓮縣,花蓮市,國富里,65,422,35.82342954,756,64.17657046,1178,12,1190,0,1543,77.12248866
花蓮縣,花蓮市,民政里,15,243,23.96449704,771,76.03550296,1014,8,1022,0,1332,76.72672673
花蓮縣,花蓮市,民政里,16,344,29.5532646,820,70.4467354,1164,13,1177,0,1522,77.33245729
花蓮縣,花蓮市,民勤里,2,128,17.32070365,611,82.67929635,739,11,750,0,964,77.80082988
花蓮縣,花蓮市,民勤里,3,97,15.69579288,521,84.30420712,618,9,627,0,812,77.21674877
花蓮縣,花蓮市,民勤里,4,186,18.5443669,817,81.4556331,1003,14,1017,0,1264,80.45886076
花蓮縣,花蓮市,民生里,23,406,38.59315589,646,61.40684411,1052,9,1061,0,1395,76.05734767
花蓮縣,花蓮市,主商里,25,207,39.73128599,314,60.26871401,521,7,528,0,680,77.64705882
花蓮縣,花蓮市,主學里,34,226,36.4516129,394,63.5483871,620,15,635,0,821,77.34470158
花蓮縣,花蓮市,主學里,35,258,38.91402715,405,61.08597285,663,15,678,0,880,77.04545455
花蓮縣,花蓮市,國光里,52,326,34.4973545,619,65.5026455,945,26,971,0,1290,75.27131783
花蓮縣,花蓮市,國聯里,58,348,42.43902439,472,57.56097561,820,16,836,0,1151,72.63249348
花蓮縣,花蓮市,國聯里,59,274,36.53333333,476,63.46666667,750,6,756,0,1079,70.06487488
花蓮縣,花蓮市,國強里,62,375,36.26692456,659,63.73307544,1034,19,1053,0,1343,78.40655249
花蓮縣,花蓮市,民心里,8,214,35.48922056,389,64.51077944,603,11,614,0,840,73.0952381
花蓮縣,花蓮市,民樂里,18,117,26,333,74,450,6,456,0,611,74.63175123
花蓮縣,花蓮市,民主里,20,136,29.89010989,319,70.10989011,455,9,464,0,604,76.82119205
花蓮縣,花蓮市,主勤里,26,250,34.53038674,474,65.46961326,724,16,740,0,986,75.05070994
花蓮縣,花蓮市,主力里,44,372,40.61135371,544,59.38864629,916,12,928,0,1247,74.41860465
花蓮縣,花蓮市,主力里,45,334,36.90607735,571,63.09392265,905,10,915,0,1205,75.93360996
花蓮縣,花蓮市,國安里,51,148,34.4988345,281,65.5011655,429,5,434,0,533,81.42589118
花蓮縣,花蓮市,國魂里,56,342,40.47337278,503,59.52662722,845,12,857,0,1146,74.78184991
花蓮縣,花蓮市,國魂里,57,168,33.53293413,333,66.46706587,501,10,511,0,693,73.73737374
花蓮縣,花蓮市,國慶里,69,244,34.07821229,472,65.92178771,716,13,729,0,931,78.30290011
花蓮縣,花蓮市,民享里,9,134,20.08995502,533,79.91004498,667,15,682,0,895,76.20111732
花蓮縣,花蓮市,民享里,10,175,21.875,625,78.125,800,20,820,0,1079,75.99629286
花蓮縣,花蓮市,民有里,19,209,41.46825397,295,58.53174603,504,10,514,0,665,77.29323308
花蓮縣,花蓮市,民權里,24,91,25.27777778,269,74.72222222,360,2,362,0,473,76.53276956
花蓮縣,花蓮市,主計里,30,208,34.09836066,402,65.90163934,610,8,618,0,856,72.19626168
花蓮縣,花蓮市,主權里,40,277,30.37280702,635,69.62719298,912,14,926,0,1242,74.55716586
花蓮縣,花蓮市,主權里,41,265,31.39810427,579,68.60189573,844,19,863,0,1189,72.58200168
花蓮縣,花蓮市,主權里,42,270,33.70786517,531,66.29213483,801,12,813,0,1109,73.30928765
花蓮縣,花蓮市,主權里,43,262,32.91457286,534,67.08542714,796,6,802,0,1015,79.01477833
花蓮縣,花蓮市,國華里,54,326,39.18269231,506,60.81730769,832,13,845,0,1174,71.97614991
花蓮縣,花蓮市,國華里,55,254,36.97234352,433,63.02765648,687,5,692,0,859,80.55878929
花蓮縣,花蓮市,國防里,53,210,34.2019544,404,65.7980456,614,19,633,0,826,76.63438257
花蓮縣,花蓮市,國福里,72,320,35.20352035,589,64.79647965,909,29,938,0,1339,70.05227782
花蓮縣,花蓮市,國裕里,66,312,38.85429639,491,61.14570361,803,13,816,0,1093,74.65690759
花蓮縣,花蓮市,國裕里,67,302,31.89017951,645,68.10982049,947,17,964,0,1298,74.26810478
花蓮縣,花蓮市,國裕里,68,246,29.60288809,585,70.39711191,831,14,845,0,1160,72.84482759
花蓮縣,花蓮市,主安里,38,242,35.85185185,433,64.14814815,675,10,685,0,915,74.86338798
花蓮縣,花蓮市,主安里,39,383,35.33210332,701,64.66789668,1084,17,1101,0,1430,76.99300699
花蓮縣,花蓮市,國盛里,60,257,27.16701903,689,72.83298097,946,24,970,0,1366,71.0102489
花蓮縣,花蓮市,國盛里,61,306,32.0754717,648,67.9245283,954,3,957,1,1357,70.52321297
花蓮縣,花蓮市,國興里,70,310,24.8,940,75.2,1250,18,1268,0,1729,73.33718913
花蓮縣,花蓮市,國興里,71,311,30.19417476,719,69.80582524,1030,14,1044,0,1398,74.67811159
花蓮縣,花蓮市,民孝里,11,160,28.62254025,399,71.37745975,559,11,570,0,783,72.79693487
花蓮縣,花蓮市,民孝里,12,274,20.40208488,1069,79.59791512,1343,31,1374,0,1777,77.32132808
花蓮縣,新城鄉,新城村,73,113,40.35714286,167,59.64285714,280,9,289,0,377,76.65782493
花蓮縣,新城鄉,新城村,74,264,36.76880223,454,63.23119777,718,26,744,0,1037,71.74541948
花蓮縣,新城鄉,順安村,75,265,63.85542169,150,36.14457831,415,13,428,0,618,69.25566343
花蓮縣,新城鄉,順安村,76,134,58.00865801,97,41.99134199,231,1,232,0,299,77.59197324
花蓮縣,新城鄉,康樂村,77,78,32.36514523,163,67.63485477,241,10,251,0,331,75.83081571
花蓮縣,新城鄉,康樂村,78,310,35.22727273,570,64.77272727,880,30,910,0,1249,72.85828663
花蓮縣,新城鄉,康樂村,79,174,31.07142857,386,68.92857143,560,17,577,0,803,71.85554172
花蓮縣,新城鄉,北埔村,83,355,31.08581436,787,68.91418564,1142,10,1152,0,1639,70.28676022
花蓮縣,新城鄉,北埔村,84,300,27.57352941,788,72.42647059,1088,20,1108,0,1499,73.91594396
花蓮縣,新城鄉,佳林村,85,147,29.4,353,70.6,500,10,510,0,727,70.15130674
花蓮縣,新城鄉,嘉里村,86,163,16.01178782,855,83.98821218,1018,23,1041,0,1372,75.87463557
花蓮縣,新城鄉,嘉里村,87,237,29.11547912,577,70.88452088,814,21,835,0,1095,76.25570776
花蓮縣,新城鄉,嘉里村,88,122,17.78425656,564,82.21574344,686,14,700,0,986,70.99391481
花蓮縣,新城鄉,嘉新村,89,91,15.50255537,496,84.49744463,587,22,609,0,782,77.87723785
花蓮縣,新城鄉,嘉新村,90,64,18.28571429,286,81.71428571,350,18,368,0,567,64.90299824
花蓮縣,新城鄉,大漢村,80,89,16.24087591,459,83.75912409,548,13,561,0,797,70.38895859
花蓮縣,新城鄉,大漢村,81,132,14.69933185,766,85.30066815,898,29,927,0,1298,71.41756549
花蓮縣,新城鄉,大漢村,82,98,31.11111111,217,68.88888889,315,10,325,0,448,72.54464286
花蓮縣,秀林鄉,崇德村,93,90,10.98901099,729,89.01098901,819,36,855,0,1187,72.03032856
花蓮縣,秀林鄉,富世村,94,202,22.90249433,680,77.09750567,882,25,907,0,1289,70.36462374
花蓮縣,秀林鄉,富世村,95,26,18.18181818,117,81.81818182,143,3,146,0,217,67.28110599
花蓮縣,秀林鄉,秀林村,96,151,14.84759095,866,85.15240905,1017,35,1052,0,1502,70.03994674
花蓮縣,秀林鄉,水源村,100,56,9.240924092,550,90.75907591,606,17,623,0,826,75.42372881
花蓮縣,秀林鄉,銅門村,101,50,6.570302234,711,93.42969777,761,16,777,0,995,78.09045226
花蓮縣,秀林鄉,文蘭村,102,36,8.23798627,401,91.76201373,437,23,460,0,601,76.5391015
花蓮縣,秀林鄉,文蘭村,103,36,17.64705882,168,82.35294118,204,2,206,0,280,73.57142857
花蓮縣,秀林鄉,景美村,97,118,19.37602627,491,80.62397373,609,29,638,0,919,69.42328618
花蓮縣,秀林鄉,景美村,98,63,17.74647887,292,82.25352113,355,12,367,0,541,67.83733826
花蓮縣,秀林鄉,佳民村,99,55,9.945750452,498,90.05424955,553,20,573,1,782,73.27365729
花蓮縣,秀林鄉,和平村,91,71,15.99099099,373,84.00900901,444,17,461,0,629,73.290938
花蓮縣,秀林鄉,和平村,92,47,15.35947712,259,84.64052288,306,31,337,0,468,72.00854701
花蓮縣,吉安鄉,北昌村,126,411,36.37168142,719,63.62831858,1130,35,1165,0,1561,74.63164638
花蓮縣,吉安鄉,北昌村,127,430,36.62691652,744,63.37308348,1174,16,1190,0,1524,78.0839895
花蓮縣,吉安鄉,北昌村,128,433,36.14357262,765,63.85642738,1198,21,1219,0,1540,79.15584416
花蓮縣,吉安鄉,北昌村,129,378,33.68983957,744,66.31016043,1122,19,1141,0,1482,76.99055331
花蓮縣,吉安鄉,勝安村,130,444,34.66042155,837,65.33957845,1281,22,1303,1,1712,76.10981308
花蓮縣,吉安鄉,勝安村,131,622,39.89737011,937,60.10262989,1559,21,1580,0,2020,78.21782178
花蓮縣,吉安鄉,太昌村,106,502,42.61460102,676,57.38539898,1178,15,1193,0,1637,72.87721442
花蓮縣,吉安鄉,太昌村,107,269,26.60731949,742,73.39268051,1011,25,1036,0,1441,71.8945177
花蓮縣,吉安鄉,永安村,104,399,32.25545675,838,67.74454325,1237,20,1257,0,1656,75.9057971
花蓮縣,吉安鄉,永安村,105,423,34.11290323,817,65.88709677,1240,28,1268,0,1753,72.33314318
花蓮縣,吉安鄉,慶豐村,108,473,35.37771129,864,64.62228871,1337,25,1362,0,1855,73.42318059
花蓮縣,吉安鄉,慶豐村,109,489,39.08872902,762,60.91127098,1251,32,1283,0,1647,77.89921069
花蓮縣,吉安鄉,慶豐村,110,386,33.39100346,770,66.60899654,1156,18,1174,0,1573,74.63445645
花蓮縣,吉安鄉,吉安村,111,393,36.52416357,683,63.47583643,1076,14,1090,0,1441,75.64191534
花蓮縣,吉安鄉,吉安村,112,219,28.40466926,552,71.59533074,771,14,785,0,1148,68.37979094
花蓮縣,吉安鄉,吉安村,113,294,33.37116913,587,66.62883087,881,20,901,0,1204,74.83388704
花蓮縣,吉安鄉,福興村,114,268,34.58064516,507,65.41935484,775,26,801,0,1101,72.7520436
花蓮縣,吉安鄉,福興村,115,407,44.38386041,510,55.61613959,917,27,944,0,1253,75.33918595
花蓮縣,吉安鄉,南華村,116,502,45.76116682,595,54.23883318,1097,42,1139,0,1508,75.53050398
花蓮縣,吉安鄉,干城村,117,138,18.52348993,607,81.47651007,745,20,765,0,1120,68.30357143
花蓮縣,吉安鄉,永興村,118,435,36.70886076,750,63.29113924,1185,44,1229,0,1694,72.5501771
花蓮縣,吉安鄉,永興村,119,133,22.27805695,464,77.72194305,597,9,606,0,840,72.14285714
花蓮縣,吉安鄉,稻香村,120,297,32.14285714,627,67.85714286,924,15,939,0,1250,75.12
花蓮縣,吉安鄉,稻香村,121,335,35.41226216,611,64.58773784,946,39,985,0,1348,73.07121662
花蓮縣,吉安鄉,南昌村,122,252,24.11483254,793,75.88516746,1045,29,1074,0,1438,74.68706537
花蓮縣,吉安鄉,南昌村,123,383,30.91202583,856,69.08797417,1239,17,1256,0,1710,73.4502924
花蓮縣,吉安鄉,宜昌村,124,401,32.02875399,851,67.97124601,1252,19,1271,0,1695,74.98525074
花蓮縣,吉安鄉,宜昌村,125,405,31.76470588,870,68.23529412,1275,21,1296,0,1693,76.55050207
花蓮縣,吉安鄉,仁里村,132,285,30.7775378,641,69.2224622,926,16,942,0,1238,76.0904685
花蓮縣,吉安鄉,仁里村,133,324,30.59490085,735,69.40509915,1059,21,1080,0,1387,77.86589762
花蓮縣,吉安鄉,仁里村,134,280,29.31937173,675,70.68062827,955,18,973,0,1348,72.1810089
花蓮縣,吉安鄉,仁里村,135,327,33.95638629,636,66.04361371,963,11,974,0,1299,74.98075443
花蓮縣,吉安鄉,東昌村,136,288,25.53191489,840,74.46808511,1128,20,1148,0,1528,75.13089005
花蓮縣,吉安鄉,東昌村,137,311,25.04025765,931,74.95974235,1242,17,1259,0,1692,74.40898345
花蓮縣,吉安鄉,東昌村,138,192,21.52466368,700,78.47533632,892,27,919,0,1266,72.59083728
花蓮縣,吉安鄉,仁安村,139,408,33.03643725,827,66.96356275,1235,34,1269,0,1818,69.8019802
花蓮縣,吉安鄉,仁和村,140,292,27.08719852,786,72.91280148,1078,16,1094,0,1515,72.21122112
花蓮縣,吉安鄉,仁和村,141,298,37.86531131,489,62.13468869,787,16,803,0,1137,70.62445031
花蓮縣,吉安鄉,仁和村,142,211,25.98522167,601,74.01477833,812,31,843,0,1230,68.53658537
花蓮縣,吉安鄉,光華村,143,100,12.65822785,690,87.34177215,790,20,810,0,1072,75.55970149
花蓮縣,壽豐鄉,樹湖村,145,93,39.24050633,144,60.75949367,237,6,243,0,340,71.47058824
花蓮縣,壽豐鄉,溪口村,144,248,32.93492696,505,67.06507304,753,37,790,0,1105,71.49321267
花蓮縣,壽豐鄉,豐山村,146,529,40.28941356,784,59.71058644,1313,51,1364,2,1920,71.04166667
花蓮縣,壽豐鄉,豐裡村,147,315,35.31390135,577,64.68609865,892,34,926,0,1319,70.20470053
花蓮縣,壽豐鄉,豐坪村,148,190,33.86809269,371,66.13190731,561,19,580,0,841,68.96551724
花蓮縣,壽豐鄉,共和村,150,136,29.12205567,331,70.87794433,467,18,485,0,619,78.35218094
花蓮縣,壽豐鄉,壽豐村,149,382,33.59718558,755,66.40281442,1137,35,1172,0,1581,74.13029728
花蓮縣,壽豐鄉,光榮村,151,117,20.78152753,446,79.21847247,563,4,567,0,753,75.29880478
花蓮縣,壽豐鄉,池南村,152,233,38.89816361,366,61.10183639,599,19,618,0,865,71.44508671
花蓮縣,壽豐鄉,池南村,156,65,21.66666667,235,78.33333333,300,5,305,0,407,74.93857494
花蓮縣,壽豐鄉,平和村,153,275,39.2296719,426,60.7703281,701,22,723,0,988,73.17813765
花蓮縣,壽豐鄉,平和村,154,96,38.86639676,151,61.13360324,247,3,250,0,343,72.88629738
花蓮縣,壽豐鄉,志學村,155,563,38.35149864,905,61.64850136,1468,52,1520,0,2084,72.93666027
花蓮縣,壽豐鄉,志學村,156,65,21.66666667,235,78.33333333,300,5,305,0,407,74.93857494
花蓮縣,壽豐鄉,米棧村,157,33,26.61290323,91,73.38709677,124,7,131,0,189,69.31216931
花蓮縣,壽豐鄉,米棧村,158,16,23.88059701,51,76.11940299,67,3,70,0,98,71.42857143
花蓮縣,壽豐鄉,月眉村,159,105,18.78354204,454,81.21645796,559,10,569,0,803,70.85927771
花蓮縣,壽豐鄉,水璉村,161,150,30.42596349,343,69.57403651,493,24,517,0,768,67.31770833
花蓮縣,壽豐鄉,水璉村,162,19,20.87912088,72,79.12087912,91,1,92,0,133,69.17293233
花蓮縣,壽豐鄉,鹽寮村,160,109,28.68421053,271,71.31578947,380,9,389,0,574,67.77003484
花蓮縣,鳳林鎮,鳳仁里,163,300,35.50295858,545,64.49704142,845,15,860,0,1185,72.57383966
花蓮縣,鳳林鎮,鳳義里,164,120,26.03036876,341,73.96963124,461,14,475,0,627,75.75757576
花蓮縣,鳳林鎮,鳳禮里,165,161,31.08108108,357,68.91891892,518,8,526,0,696,75.57471264
花蓮縣,鳳林鎮,鳳智里,166,212,25.05910165,634,74.94089835,846,6,852,0,1148,74.21602787
花蓮縣,鳳林鎮,鳳信里,167,99,18.85714286,426,81.14285714,525,22,547,0,878,62.30068337
花蓮縣,鳳林鎮,鳳信里,168,90,23.07692308,300,76.92307692,390,14,404,0,558,72.40143369
花蓮縣,鳳林鎮,山興里,169,51,22.76785714,173,77.23214286,224,12,236,0,355,66.47887324
花蓮縣,鳳林鎮,山興里,170,30,22.22222222,105,77.77777778,135,7,142,0,223,63.67713004
花蓮縣,鳳林鎮,大榮里,171,202,42.08333333,278,57.91666667,480,31,511,0,759,67.32542819
花蓮縣,鳳林鎮,大榮里,172,140,32.71028037,288,67.28971963,428,6,434,0,623,69.66292135
花蓮縣,鳳林鎮,北林里,173,199,48.30097087,213,51.69902913,412,16,428,0,633,67.61453397
花蓮縣,鳳林鎮,南平里,174,170,38.90160183,267,61.09839817,437,12,449,0,673,66.71619614
花蓮縣,鳳林鎮,林榮里,175,171,27.09984152,460,72.90015848,631,31,662,0,876,75.57077626
花蓮縣,鳳林鎮,長橋里,176,286,37.9814077,467,62.0185923,753,34,787,0,1143,68.85389326
花蓮縣,鳳林鎮,森榮里,177,32,22.85714286,108,77.14285714,140,2,142,0,192,73.95833333
花蓮縣,光復鄉,大安村,179,238,36.33587786,417,63.66412214,655,5,660,0,889,74.24071991
花蓮縣,光復鄉,大華村,178,345,37.70491803,570,62.29508197,915,23,938,0,1346,69.68796434
花蓮縣,光復鄉,大平村,181,172,27.12933754,462,72.87066246,634,26,660,0,979,67.41573034
花蓮縣,光復鄉,大馬村,180,140,21.40672783,514,78.59327217,654,29,683,0,1059,64.49480642
花蓮縣,光復鄉,大同村,182,224,31.15438108,495,68.84561892,719,21,740,0,1051,70.40913416
花蓮縣,光復鄉,大進村,189,69,18.59838275,302,81.40161725,371,8,379,0,517,73.30754352
花蓮縣,光復鄉,大全村,190,132,29.72972973,312,70.27027027,444,26,470,0,730,64.38356164
花蓮縣,光復鄉,大全村,191,29,32.95454545,59,67.04545455,88,5,93,0,124,75
花蓮縣,光復鄉,大興村,192,71,24.14965986,223,75.85034014,294,18,312,0,513,60.81871345
花蓮縣,光復鄉,大富村,193,108,44.62809917,134,55.37190083,242,11,253,0,386,65.54404145
花蓮縣,光復鄉,大豐村,194,143,39.50276243,219,60.49723757,362,11,373,0,567,65.78483245
花蓮縣,光復鄉,東富村,183,16,13.33333333,104,86.66666667,120,4,124,0,248,50
花蓮縣,光復鄉,東富村,184,50,9.225092251,492,90.77490775,542,11,553,0,904,61.17256637
花蓮縣,光復鄉,西富村,185,45,12.26158038,322,87.73841962,367,9,376,0,592,63.51351351
花蓮縣,光復鄉,西富村,186,109,38.24561404,176,61.75438596,285,16,301,0,475,63.36842105
花蓮縣,光復鄉,南富村,187,90,16.54411765,454,83.45588235,544,12,556,0,883,62.96715742
花蓮縣,光復鄉,北富村,188,77,13.60424028,489,86.39575972,566,17,583,0,903,64.56256921
花蓮縣,豐濱鄉,豐濱村,197,20,16.66666667,100,83.33333333,120,4,124,0,197,62.94416244
花蓮縣,豐濱鄉,豐濱村,198,166,21.55844156,604,78.44155844,770,36,806,0,1382,58.32127352
花蓮縣,豐濱鄉,豐濱村,199,41,16.53225806,207,83.46774194,248,1,249,0,445,55.95505618
花蓮縣,豐濱鄉,新社村,200,43,10.8040201,355,89.1959799,398,9,407,0,673,60.47548291
花蓮縣,豐濱鄉,磯崎村,201,21,10.71428571,175,89.28571429,196,11,207,0,346,59.8265896
花蓮縣,豐濱鄉,港口村,196,132,27.84810127,342,72.15189873,474,23,497,0,835,59.52095808
花蓮縣,豐濱鄉,靜浦村,195,54,14.21052632,326,85.78947368,380,16,396,0,783,50.57471264
花蓮縣,萬榮鄉,西林村,202,58,8.430232558,630,91.56976744,688,33,721,0,1041,69.26032661
花蓮縣,萬榮鄉,見晴村,203,23,6.990881459,306,93.00911854,329,11,340,0,511,66.53620352
花蓮縣,萬榮鄉,萬榮村,204,78,16.88311688,384,83.11688312,462,12,474,0,705,67.23404255
花蓮縣,萬榮鄉,明利村,205,37,9.61038961,348,90.38961039,385,13,398,0,598,66.55518395
花蓮縣,萬榮鄉,馬遠村,206,31,12.3015873,221,87.6984127,252,6,258,0,380,67.89473684
花蓮縣,萬榮鄉,馬遠村,207,40,10.86956522,328,89.13043478,368,10,378,0,628,60.1910828
花蓮縣,萬榮鄉,紅葉村,208,49,7.585139319,597,92.41486068,646,14,660,0,1076,61.33828996
花蓮縣,瑞穗鄉,瑞穗村,209,187,30.90909091,418,69.09090909,605,8,613,0,860,71.27906977
花蓮縣,瑞穗鄉,瑞穗村,210,279,37.10106383,473,62.89893617,752,22,774,0,1137,68.07387863
花蓮縣,瑞穗鄉,瑞美村,211,217,37.47841105,362,62.52158895,579,7,586,0,836,70.09569378
花蓮縣,瑞穗鄉,瑞美村,212,245,37.12121212,415,62.87878788,660,23,683,0,1015,67.29064039
花蓮縣,瑞穗鄉,瑞良村,213,114,30.15873016,264,69.84126984,378,9,387,0,558,69.35483871
花蓮縣,瑞穗鄉,瑞祥村,214,224,34.25076453,430,65.74923547,654,29,683,0,1051,64.98572788
花蓮縣,瑞穗鄉,瑞北村,215,118,31.97831978,251,68.02168022,369,8,377,0,607,62.10873147
花蓮縣,瑞穗鄉,舞鶴村,216,152,24.79608483,461,75.20391517,613,26,639,0,1004,63.64541833
花蓮縣,瑞穗鄉,鶴岡村,217,66,13.17365269,435,86.82634731,501,20,521,0,898,58.01781737
花蓮縣,瑞穗鄉,奇美村,218,21,10.82474227,173,89.17525773,194,5,199,0,361,55.12465374
花蓮縣,瑞穗鄉,富源村,219,166,29.69588551,393,70.30411449,559,32,591,0,907,65.1598677
花蓮縣,瑞穗鄉,富民村,220,79,14.23423423,476,85.76576577,555,39,594,0,1037,57.28061716
花蓮縣,瑞穗鄉,富興村,221,215,53.34987593,188,46.65012407,403,17,420,0,704,59.65909091
花蓮縣,玉里鎮,中城里,222,413,30.16800584,956,69.83199416,1369,25,1394,0,2030,68.66995074
花蓮縣,玉里鎮,中城里,223,390,36.07770583,691,63.92229417,1081,27,1108,0,1582,70.03792668
花蓮縣,玉里鎮,中城里,224,266,35.80080754,477,64.19919246,743,21,764,0,1054,72.4857685
花蓮縣,玉里鎮,啟模里,226,217,34.83146067,406,65.16853933,623,8,631,0,926,68.1425486
花蓮縣,玉里鎮,啟模里,227,169,26.28304821,474,73.71695179,643,19,662,0,928,71.3362069
花蓮縣,玉里鎮,永昌里,231,195,24.59016393,598,75.40983607,793,23,816,0,1216,67.10526316
花蓮縣,玉里鎮,泰昌里,228,181,21.70263789,653,78.29736211,834,25,859,0,1169,73.48160821
花蓮縣,玉里鎮,泰昌里,229,97,44.70046083,120,55.29953917,217,45,262,0,874,29.9771167
花蓮縣,玉里鎮,泰昌里,230,8,12.30769231,57,87.69230769,65,14,79,0,583,13.55060034
花蓮縣,玉里鎮,國武里,225,371,38.24742268,599,61.75257732,970,10,980,0,1352,72.4852071
花蓮縣,玉里鎮,源城里,232,277,33.29326923,555,66.70673077,832,36,868,0,1331,65.21412472
花蓮縣,玉里鎮,長良里,233,64,15.92039801,338,84.07960199,402,28,430,0,828,51.93236715
花蓮縣,玉里鎮,樂合里,234,102,14.3864598,607,85.6135402,709,34,743,0,1179,63.01950806
花蓮縣,玉里鎮,東豐里,235,89,26.88821752,242,73.11178248,331,8,339,0,572,59.26573427
花蓮縣,玉里鎮,觀音里,236,206,34.44816054,392,65.55183946,598,26,624,0,1039,60.05774783
花蓮縣,玉里鎮,觀音里,237,102,23.39449541,334,76.60550459,436,1,437,0,727,60.11004127
花蓮縣,玉里鎮,松浦里,238,212,23.34801762,696,76.65198238,908,55,963,0,1765,54.56090652
花蓮縣,玉里鎮,春日里,239,149,27.14025501,400,72.85974499,549,34,583,0,1019,57.21295388
花蓮縣,玉里鎮,德武里,240,44,9.6069869,414,90.3930131,458,14,472,0,803,58.77957659
花蓮縣,玉里鎮,三民里,241,308,47.38461538,342,52.61538462,650,35,685,0,1044,65.61302682
花蓮縣,玉里鎮,大禹里,242,275,37.16216216,465,62.83783784,740,32,772,0,1202,64.22628952
花蓮縣,富里鄉,吳江村,243,97,27.87356322,251,72.12643678,348,3,351,0,566,62.01413428
花蓮縣,富里鄉,東里村,244,215,30.41018388,492,69.58981612,707,29,736,0,1299,56.65896844
花蓮縣,富里鄉,萬寧村,245,132,32.03883495,280,67.96116505,412,24,436,0,763,57.14285714
花蓮縣,富里鄉,新興村,246,62,15.57788945,336,84.42211055,398,18,416,0,706,58.92351275
花蓮縣,富里鄉,竹田村,247,145,20.36516854,567,79.63483146,712,23,735,0,1099,66.87898089
花蓮縣,富里鄉,羅山村,248,78,28.57142857,195,71.42857143,273,16,289,0,467,61.88436831
花蓮縣,富里鄉,石牌村,249,174,33.0170778,353,66.9829222,527,23,550,0,861,63.87921022
花蓮縣,富里鄉,明里村,250,98,37.83783784,161,62.16216216,259,3,262,0,423,61.93853428
花蓮縣,富里鄉,富里村,251,386,37.88027478,633,62.11972522,1019,3,1022,0,1583,64.5609602
花蓮縣,富里鄉,永豐村,252,94,31.43812709,205,68.56187291,299,0,299,0,526,56.84410646
花蓮縣,富里鄉,豐南村,253,80,19.75308642,325,80.24691358,405,33,438,0,719,60.91794159
花蓮縣,富里鄉,富南村,254,105,30.08595989,244,69.91404011,349,15,364,0,568,64.08450704
花蓮縣,富里鄉,學田村,255,149,37.06467662,253,62.93532338,402,19,421,0,649,64.86902928
花蓮縣,卓溪鄉,崙山村,256,20,6.430868167,291,93.56913183,311,7,318,0,501,63.47305389
花蓮縣,卓溪鄉,立山村,257,26,9.122807018,259,90.87719298,285,6,291,0,467,62.31263383
花蓮縣,卓溪鄉,立山村,258,29,9.731543624,269,90.26845638,298,14,312,0,519,60.11560694
花蓮縣,卓溪鄉,太平村,259,8,4.020100503,191,95.9798995,199,7,206,0,301,68.43853821
花蓮縣,卓溪鄉,太平村,260,36,15.65217391,194,84.34782609,230,9,239,0,354,67.51412429
花蓮縣,卓溪鄉,卓溪村,261,33,8.527131783,354,91.47286822,387,8,395,0,654,60.39755352
花蓮縣,卓溪鄉,卓清村,262,19,4.97382199,363,95.02617801,382,3,385,0,581,66.26506024
花蓮縣,卓溪鄉,卓清村,263,11,4.621848739,227,95.37815126,238,7,245,0,399,61.40350877
花蓮縣,卓溪鄉,古風村,264,17,9.090909091,170,90.90909091,187,5,192,0,361,53.18559557
花蓮縣,卓溪鄉,古風村,265,17,6.15942029,259,93.84057971,276,6,282,0,441,63.94557823
花蓮縣,卓溪鄉,古風村,266,11,10,99,90,110,0,110,0,171,64.32748538
澎湖縣,馬公市,新復里,1,17,7.391304348,213,92.60869565,230,5,235,0,313,75.0798722
澎湖縣,馬公市,復興里,2,89,38.03418803,145,61.96581197,234,3,237,0,319,74.29467085
澎湖縣,馬公市,長安里,3,186,47.81491003,203,52.18508997,389,11,400,0,533,75.04690432
澎湖縣,馬公市,中央里,4,212,59.21787709,146,40.78212291,358,8,366,0,492,74.3902439
澎湖縣,馬公市,啟明里,5,349,56.74796748,266,43.25203252,615,7,622,0,859,72.40977881
澎湖縣,馬公市,重慶里,6,397,55.44692737,319,44.55307263,716,12,728,0,990,73.53535354
澎湖縣,馬公市,中興里,7,203,38.22975518,328,61.77024482,531,10,541,0,715,75.66433566
澎湖縣,馬公市,光復里,8,351,54.84375,289,45.15625,640,9,649,0,939,69.11608094
澎湖縣,馬公市,光復里,9,253,38.56707317,403,61.43292683,656,6,662,0,908,72.90748899
澎湖縣,馬公市,光榮里,12,324,36.94412771,553,63.05587229,877,17,894,0,1190,75.12605042
澎湖縣,馬公市,光榮里,13,301,36.39661427,526,63.60338573,827,14,841,0,1176,71.51360544
澎湖縣,馬公市,光明里,10,150,36.14457831,265,63.85542169,415,0,415,0,566,73.32155477
澎湖縣,馬公市,光明里,11,122,29.11694511,297,70.88305489,419,13,432,0,615,70.24390244
澎湖縣,馬公市,朝陽里,14,467,48.84937238,489,51.15062762,956,22,978,0,1431,68.34381551
澎湖縣,馬公市,朝陽里,15,417,48.8862837,436,51.1137163,853,24,877,0,1258,69.71383148
澎湖縣,馬公市,朝陽里,16,527,39.59429001,804,60.40570999,1331,31,1362,0,1930,70.56994819
澎湖縣,馬公市,陽明里,17,363,46.65809769,415,53.34190231,778,18,796,0,1127,70.62999113
澎湖縣,馬公市,陽明里,18,427,52.200489,391,47.799511,818,14,832,0,1142,72.85464098
澎湖縣,馬公市,重光里,19,386,46.67472793,441,53.32527207,827,22,849,0,1138,74.60456942
澎湖縣,馬公市,西衛里,20,388,40.97148891,559,59.02851109,947,15,962,0,1370,70.2189781
澎湖縣,馬公市,西衛里,21,467,44.22348485,589,55.77651515,1056,23,1079,0,1480,72.90540541
澎湖縣,馬公市,西文里,22,354,45.55984556,423,54.44015444,777,15,792,0,1051,75.35680304
澎湖縣,馬公市,西文里,23,266,39.76083707,403,60.23916293,669,25,694,0,950,73.05263158
澎湖縣,馬公市,東文里,24,399,48.65853659,421,51.34146341,820,10,830,0,1114,74.50628366
澎湖縣,馬公市,東文里,25,281,44.11302983,356,55.88697017,637,6,643,0,900,71.44444444
澎湖縣,馬公市,案山里,26,426,48.63013699,450,51.36986301,876,19,895,0,1227,72.94213529
澎湖縣,馬公市,光華里,27,86,17.44421907,407,82.55578093,493,8,501,0,695,72.08633094
澎湖縣,馬公市,前寮里,28,209,51.73267327,195,48.26732673,404,4,408,0,574,71.08013937
澎湖縣,馬公市,石泉里,29,420,38.60294118,668,61.39705882,1088,14,1102,0,1499,73.51567712
澎湖縣,馬公市,菜園里,30,104,48.59813084,110,51.40186916,214,5,219,0,316,69.30379747
澎湖縣,馬公市,東衛里,31,417,42.76923077,558,57.23076923,975,25,1000,0,1391,71.8907261
澎湖縣,馬公市,安宅里,32,176,56.41025641,136,43.58974359,312,3,315,0,445,70.78651685
澎湖縣,馬公市,烏崁里,34,368,66.66666667,184,33.33333333,552,19,571,0,816,69.9754902
澎湖縣,馬公市,興仁里,33,244,58.37320574,174,41.62679426,418,14,432,0,591,73.0964467
澎湖縣,馬公市,鐵線里,35,184,64.78873239,100,35.21126761,284,12,296,0,391,75.70332481
澎湖縣,馬公市,山水里,38,590,64.62212486,323,35.37787514,913,34,947,0,1405,67.40213523
澎湖縣,馬公市,鎖港里,36,435,63.87665198,246,36.12334802,681,18,699,0,1072,65.20522388
澎湖縣,馬公市,鎖港里,37,433,68.08176101,203,31.91823899,636,18,654,0,973,67.21479959
澎湖縣,馬公市,五德里,39,43,34.4,82,65.6,125,5,130,0,176,73.86363636
澎湖縣,馬公市,井垵里,40,125,54.8245614,103,45.1754386,228,8,236,0,335,70.44776119
澎湖縣,馬公市,時裡里,41,258,40.88748019,373,59.11251981,631,7,638,0,1071,59.57049486
澎湖縣,馬公市,風櫃里,42,487,64.332893,270,35.667107,757,24,781,0,1248,62.58012821
澎湖縣,馬公市,虎井里,43,106,45.10638298,129,54.89361702,235,9,244,0,619,39.4184168
澎湖縣,馬公市,桶盤里,44,30,36.58536585,52,63.41463415,82,1,83,0,204,40.68627451
澎湖縣,湖西鄉,湖西村,45,297,52.75310835,266,47.24689165,563,20,583,0,852,68.42723005
澎湖縣,湖西鄉,湖東村,46,107,50.23474178,106,49.76525822,213,5,218,0,307,71.00977199
澎湖縣,湖西鄉,青螺村,47,67,53.17460317,59,46.82539683,126,4,130,0,206,63.10679612
澎湖縣,湖西鄉,白坑村,48,85,50,85,50,170,1,171,0,242,70.66115702
澎湖縣,湖西鄉,南寮村,49,270,69.23076923,120,30.76923077,390,11,401,0,604,66.39072848
澎湖縣,湖西鄉,北寮村,50,130,62.5,78,37.5,208,3,211,0,277,76.1732852
澎湖縣,湖西鄉,紅羅村,51,240,67.03910615,118,32.96089385,358,20,378,0,553,68.35443038
澎湖縣,湖西鄉,西溪村,52,154,53.84615385,132,46.15384615,286,15,301,0,453,66.44591611
澎湖縣,湖西鄉,成功村,53,174,58.78378378,122,41.21621622,296,10,306,0,426,71.83098592
澎湖縣,湖西鄉,東石村,54,39,54.16666667,33,45.83333333,72,3,75,0,113,66.37168142
澎湖縣,湖西鄉,中西村,56,55,55,45,45,100,1,101,0,169,59.76331361
澎湖縣,湖西鄉,潭邊村,58,105,61.04651163,67,38.95348837,172,2,174,0,232,75
澎湖縣,湖西鄉,鼎灣村,57,94,51.08695652,90,48.91304348,184,8,192,0,298,64.4295302
澎湖縣,湖西鄉,許家村,59,55,44,70,56,125,0,125,0,175,71.42857143
澎湖縣,湖西鄉,沙港村,55,364,73.09236948,134,26.90763052,498,19,517,0,719,71.9054242
澎湖縣,湖西鄉,城北村,60,54,40.90909091,78,59.09090909,132,7,139,0,193,72.02072539
澎湖縣,湖西鄉,太武村,61,29,41.42857143,41,58.57142857,70,5,75,0,114,65.78947368
澎湖縣,湖西鄉,隘門村,62,201,46.10091743,235,53.89908257,436,15,451,0,635,71.02362205
澎湖縣,湖西鄉,林投村,63,360,64.86486486,195,35.13513514,555,23,578,0,876,65.98173516
澎湖縣,湖西鄉,尖山村,64,218,64.11764706,122,35.88235294,340,18,358,0,537,66.66666667
澎湖縣,湖西鄉,龍門村,65,313,59.73282443,211,40.26717557,524,15,539,0,801,67.29088639
澎湖縣,湖西鄉,龍門村,66,297,58.3497053,212,41.6502947,509,13,522,0,746,69.97319035
澎湖縣,湖西鄉,果葉村,67,265,65.27093596,141,34.72906404,406,14,420,0,640,65.625
澎湖縣,白沙鄉,中屯村,68,159,53.89830508,136,46.10169492,295,12,307,0,449,68.37416481
澎湖縣,白沙鄉,講美村,69,205,56.31868132,159,43.68131868,364,8,372,0,537,69.27374302
澎湖縣,白沙鄉,城前村,70,23,41.81818182,32,58.18181818,55,3,58,0,92,63.04347826
澎湖縣,白沙鄉,鎮海村,71,27,34.61538462,51,65.38461538,78,0,78,0,109,71.55963303
澎湖縣,白沙鄉,港子村,72,69,44.51612903,86,55.48387097,155,2,157,0,245,64.08163265
澎湖縣,白沙鄉,岐頭村,73,67,55.37190083,54,44.62809917,121,5,126,0,214,58.87850467
澎湖縣,白沙鄉,小赤村,74,51,48.57142857,54,51.42857143,105,2,107,0,146,73.28767123
澎湖縣,白沙鄉,赤崁村,75,424,49.53271028,432,50.46728972,856,27,883,0,1344,65.69940476
澎湖縣,白沙鄉,瓦硐村,76,94,56.62650602,72,43.37349398,166,3,169,0,282,59.92907801
澎湖縣,白沙鄉,後寮村,77,234,59.69387755,158,40.30612245,392,13,405,0,642,63.08411215
澎湖縣,白沙鄉,通梁村,78,215,51.06888361,206,48.93111639,421,9,430,0,683,62.95754026
澎湖縣,白沙鄉,吉貝村,79,477,78.32512315,132,21.67487685,609,15,624,0,1214,51.40032949
澎湖縣,白沙鄉,鳥嶼村,80,104,23.37078652,341,76.62921348,445,4,449,0,986,45.53752535
澎湖縣,白沙鄉,員貝村,81,33,27.5,87,72.5,120,1,121,0,213,56.80751174
澎湖縣,白沙鄉,大倉村,82,62,67.39130435,30,32.60869565,92,4,96,0,180,53.33333333
澎湖縣,西嶼鄉,橫礁村,83,63,42.56756757,85,57.43243243,148,8,156,0,254,61.41732283
澎湖縣,西嶼鄉,合界村,84,128,57.39910314,95,42.60089686,223,17,240,0,394,60.91370558
澎湖縣,西嶼鄉,小門村,86,12,8.391608392,131,91.60839161,143,2,145,0,266,54.5112782
澎湖縣,西嶼鄉,竹灣村,85,283,64.1723356,158,35.8276644,441,18,459,0,769,59.68790637
澎湖縣,西嶼鄉,大池村,87,191,54.10764873,162,45.89235127,353,11,364,0,605,60.16528926
澎湖縣,西嶼鄉,二崁村,88,53,62.35294118,32,37.64705882,85,1,86,0,126,68.25396825
澎湖縣,西嶼鄉,池東村,89,152,46.62576687,174,53.37423313,326,12,338,0,512,66.015625
澎湖縣,西嶼鄉,池西村,90,69,57.98319328,50,42.01680672,119,4,123,0,202,60.89108911
澎湖縣,西嶼鄉,赤馬村,91,235,71.21212121,95,28.78787879,330,14,344,0,595,57.81512605
澎湖縣,西嶼鄉,內垵村,92,472,66.01398601,243,33.98601399,715,21,736,0,1193,61.69321039
澎湖縣,西嶼鄉,外垵村,93,148,31.89655172,316,68.10344828,464,10,474,0,795,59.62264151
澎湖縣,西嶼鄉,外垵村,94,153,26.65505226,421,73.34494774,574,9,583,1,980,59.48979592
澎湖縣,望安鄉,東安村,95,108,48.64864865,114,51.35135135,222,10,232,0,424,54.71698113
澎湖縣,望安鄉,西安村,96,63,40.12738854,94,59.87261146,157,6,163,0,314,51.91082803
澎湖縣,望安鄉,中社村,97,48,57.8313253,35,42.1686747,83,9,92,0,224,41.07142857
澎湖縣,望安鄉,水垵村,98,73,54.07407407,62,45.92592593,135,11,146,0,288,50.69444444
澎湖縣,望安鄉,將軍村,99,178,74.78991597,60,25.21008403,238,16,254,0,570,44.56140351
澎湖縣,望安鄉,將軍村,100,202,84.87394958,36,15.12605042,238,23,261,0,592,44.08783784
澎湖縣,望安鄉,東坪村,102,76,72.38095238,29,27.61904762,105,6,111,0,320,34.6875
澎湖縣,望安鄉,西坪村,103,32,64,18,36,50,0,50,0,166,30.12048193
澎湖縣,望安鄉,東吉村,101,75,78.125,21,21.875,96,3,99,0,274,36.13138686
澎湖縣,望安鄉,花嶼村,104,16,15.84158416,85,84.15841584,101,8,109,0,222,49.0990991
澎湖縣,七美鄉,東湖村,105,22,22.44897959,76,77.55102041,98,6,104,0,220,47.27272727
澎湖縣,七美鄉,西湖村,106,56,25.68807339,162,74.31192661,218,14,232,0,413,56.17433414
澎湖縣,七美鄉,中和村,107,40,19.8019802,162,80.1980198,202,14,216,0,450,48
澎湖縣,七美鄉,平和村,108,41,30.59701493,93,69.40298507,134,7,141,0,264,53.40909091
澎湖縣,七美鄉,海豐村,109,39,36.44859813,68,63.55140187,107,4,111,0,248,44.75806452
澎湖縣,七美鄉,南港村,110,80,19.5599022,329,80.4400978,409,22,431,0,807,53.40768278
基隆市,中正區,德義里,34,279,42.98921418,370,57.01078582,649,13,662,0,818,80.92909535
基隆市,中正區,正義里,32,479,42.57777778,646,57.42222222,1125,34,1159,0,1475,78.57627119
基隆市,中正區,信義里,33,362,43.56197353,469,56.43802647,831,10,841,0,1050,80.0952381
基隆市,中正區,義重里,31,371,41.40625,525,58.59375,896,24,920,0,1187,77.50631845
基隆市,中正區,港通里,30,481,48.1,519,51.9,1000,23,1023,0,1277,80.10963195
基隆市,中正區,中船里,29,364,35.93287266,649,64.06712734,1013,34,1047,0,1338,78.25112108
基隆市,中正區,正船里,28,416,36.45924628,725,63.54075372,1141,19,1160,0,1471,78.85791978
基隆市,中正區,入船里,27,376,38.64337102,597,61.35662898,973,28,1001,1,1305,76.70498084
基隆市,中正區,中砂里,26,384,35.88785047,686,64.11214953,1070,8,1078,0,1331,80.99173554
基隆市,中正區,正砂里,24,402,34.625323,759,65.374677,1161,24,1185,0,1505,78.73754153
基隆市,中正區,正砂里,25,213,28.32446809,539,71.67553191,752,6,758,0,959,79.04066736
基隆市,中正區,真砂里,23,444,37.43676223,742,62.56323777,1186,25,1211,0,1516,79.88126649
基隆市,中正區,砂灣里,22,501,31.76918199,1076,68.23081801,1577,49,1626,0,2110,77.06161137
基隆市,中正區,建國里,20,278,29.04911181,679,70.95088819,957,23,980,0,1231,79.61007311
基隆市,中正區,建國里,21,190,23.48578492,619,76.51421508,809,21,830,0,1044,79.50191571
基隆市,中正區,中濱里,19,361,33.2718894,724,66.7281106,1085,26,1111,0,1469,75.62968005
基隆市,中正區,海濱里,15,308,31.20567376,679,68.79432624,987,25,1012,2,1392,72.70114943
基隆市,中正區,社寮里,13,737,51.50244584,694,48.49755416,1431,47,1478,0,1961,75.36970933
基隆市,中正區,和憲里,14,184,24.50066578,567,75.49933422,751,19,770,0,1087,70.83716651
基隆市,中正區,平寮里,12,542,46.80483592,616,53.19516408,1158,28,1186,2,1525,77.7704918
基隆市,中正區,八斗里,4,768,66.43598616,388,33.56401384,1156,40,1196,0,1545,77.41100324
基隆市,中正區,碧砂里,5,507,51.160444,484,48.839556,991,38,1029,0,1350,76.22222222
基隆市,中正區,長潭里,1,280,59.57446809,190,40.42553191,470,12,482,1,570,84.56140351
基隆市,中正區,砂子里,2,724,43.69342185,933,56.30657815,1657,31,1688,0,2210,76.3800905
基隆市,中正區,砂子里,3,286,37.33681462,480,62.66318538,766,9,775,0,1032,75.09689922
基隆市,中正區,中正里,17,274,40,411,60,685,22,707,0,919,76.93144723
基隆市,中正區,中正里,18,303,39.76377953,459,60.23622047,762,24,786,1,1168,67.29452055
基隆市,中正區,正濱里,16,341,37.43139407,570,62.56860593,911,32,943,0,1249,75.50040032
基隆市,中正區,新豐里,9,186,37.57575758,309,62.42424242,495,13,508,0,749,67.82376502
基隆市,中正區,新豐里,10,295,34.26248548,566,65.73751452,861,11,872,0,1196,72.909699
基隆市,中正區,新豐里,11,344,30.79677708,773,69.20322292,1117,10,1127,0,1469,76.71885636
基隆市,中正區,新富里,6,479,35.37666174,875,64.62333826,1354,22,1376,0,1881,73.15257842
基隆市,中正區,新富里,7,378,36.20689655,666,63.79310345,1044,11,1055,0,1384,76.2283237
基隆市,中正區,新富里,8,152,29.28709056,367,70.71290944,519,12,531,0,749,70.89452603
基隆市,信義區,仁壽里,35,370,39.31987248,571,60.68012752,941,16,957,0,1158,82.64248705
基隆市,信義區,仁義里,36,327,33.67662204,644,66.32337796,971,16,987,0,1202,82.11314476
基隆市,信義區,義昭里,37,238,30.59125964,540,69.40874036,778,14,792,0,996,79.51807229
基隆市,信義區,義幸里,38,343,36.1814346,605,63.8185654,948,27,975,0,1173,83.1202046
基隆市,信義區,義幸里,39,331,34.37175493,632,65.62824507,963,30,993,0,1203,82.5436409
基隆市,信義區,義民里,40,298,43.88807069,381,56.11192931,679,12,691,0,833,82.95318127
基隆市,信義區,義和里,41,353,34.95049505,657,65.04950495,1010,15,1025,0,1259,81.41382049
基隆市,信義區,智慧里,42,198,36.26373626,348,63.73626374,546,6,552,0,684,80.70175439
基隆市,信義區,智誠里,43,285,52.29357798,260,47.70642202,545,10,555,0,706,78.61189802
基隆市,信義區,智誠里,44,358,45.8974359,422,54.1025641,780,4,784,0,1027,76.33885102
基隆市,信義區,禮儀里,45,425,36.41816624,742,63.58183376,1167,21,1188,0,1478,80.37889039
基隆市,信義區,禮東里,46,389,31.99013158,827,68.00986842,1216,33,1249,0,1555,80.32154341
基隆市,信義區,信綠里,47,324,32.86004057,662,67.13995943,986,9,995,0,1220,81.55737705
基隆市,信義區,信綠里,48,295,34.30232558,565,65.69767442,860,11,871,0,1130,77.07964602
基隆市,信義區,東光里,51,486,33.70319001,956,66.29680999,1442,35,1477,1,1840,80.27173913
基隆市,信義區,東明里,52,381,34.32432432,729,65.67567568,1110,27,1137,0,1524,74.60629921
基隆市,信義區,東明里,53,401,27.65517241,1049,72.34482759,1450,29,1479,0,1849,79.98918334
基隆市,信義區,東安里,54,345,33.46265761,686,66.53734239,1031,11,1042,0,1314,79.29984779
基隆市,信義區,東安里,55,369,33.97790055,717,66.02209945,1086,23,1109,0,1382,80.24602026
基隆市,信義區,孝岡里,61,258,38.79699248,407,61.20300752,665,19,684,0,915,74.75409836
基隆市,信義區,東信里,49,247,33.243607,496,66.756393,743,16,759,0,946,80.23255814
基隆市,信義區,東信里,50,564,29.49790795,1348,70.50209205,1912,25,1937,0,2462,78.67587327
基隆市,信義區,孝深里,60,712,39.64365256,1084,60.35634744,1796,44,1840,0,2491,73.8659173
基隆市,信義區,孝賢里,56,558,37.17521652,943,62.82478348,1501,24,1525,0,1958,77.88559755
基隆市,信義區,孝賢里,57,456,30.831643,1023,69.168357,1479,28,1507,1,1845,81.6802168
基隆市,信義區,孝德里,58,479,39.71807629,727,60.28192371,1206,31,1237,1,1613,76.68939864
基隆市,信義區,孝德里,59,591,34.44055944,1125,65.55944056,1716,24,1740,0,2368,73.47972973
基隆市,仁愛區,林泉里,62,618,46.8892261,700,53.1107739,1318,33,1351,0,1757,76.89243028
基隆市,仁愛區,花崗里,63,355,47.01986755,400,52.98013245,755,18,773,0,955,80.94240838
基隆市,仁愛區,虹橋里,64,554,44.96753247,678,55.03246753,1232,22,1254,0,1544,81.21761658
基隆市,仁愛區,水錦里,65,585,41.63701068,820,58.36298932,1405,29,1434,0,1754,81.75598632
基隆市,仁愛區,智仁里,66,405,44.90022173,497,55.09977827,902,18,920,0,1145,80.34934498
基隆市,仁愛區,智仁里,67,357,41.65694282,500,58.34305718,857,24,881,0,1113,79.15543576
基隆市,仁愛區,和明里,68,413,48.24766355,443,51.75233645,856,16,872,0,1091,79.92667278
基隆市,仁愛區,忠勇里,69,377,48.51994852,400,51.48005148,777,8,785,0,1013,77.49259625
基隆市,仁愛區,玉田里,70,414,48.87839433,433,51.12160567,847,18,865,0,1080,80.09259259
基隆市,仁愛區,仁德里,71,401,51.54241645,377,48.45758355,778,24,802,0,1014,79.09270217
基隆市,仁愛區,博愛里,72,435,45.50209205,521,54.49790795,956,13,969,0,1210,80.08264463
基隆市,仁愛區,博愛里,73,194,46.0807601,227,53.9192399,421,12,433,0,524,82.63358779
基隆市,仁愛區,福仁里,74,354,54.12844037,300,45.87155963,654,14,668,0,875,76.34285714
基隆市,仁愛區,誠仁里,75,424,53.26633166,372,46.73366834,796,26,822,0,1037,79.26711668
基隆市,仁愛區,吉仁里,76,584,50.91543156,563,49.08456844,1147,13,1160,0,1471,78.85791978
基隆市,仁愛區,吉仁里,77,489,46.70487106,558,53.29512894,1047,27,1074,0,1399,76.7691208
基隆市,仁愛區,育仁里,78,345,52.19364599,316,47.80635401,661,17,678,0,882,76.8707483
基隆市,仁愛區,英仁里,79,298,54.18181818,252,45.81818182,550,13,563,0,724,77.76243094
基隆市,仁愛區,英仁里,80,219,43.36633663,286,56.63366337,505,17,522,0,666,78.37837838
基隆市,仁愛區,龍門里,81,328,51.98098257,303,48.01901743,631,4,635,0,864,73.49537037
基隆市,仁愛區,德厚里,82,461,45.55335968,551,54.44664032,1012,28,1040,0,1372,75.80174927
基隆市,仁愛區,曲水里,83,408,52.44215938,370,47.55784062,778,18,796,0,975,81.64102564
基隆市,仁愛區,崇文里,84,352,47.69647696,386,52.30352304,738,19,757,0,954,79.35010482
基隆市,仁愛區,文安里,85,396,49.9369483,397,50.0630517,793,30,823,0,1041,79.0585975
基隆市,仁愛區,兆連里,86,211,37.08260105,358,62.91739895,569,7,576,0,712,80.8988764
基隆市,仁愛區,獅球里,87,390,43.47826087,507,56.52173913,897,26,923,0,1185,77.89029536
基隆市,仁愛區,書院里,88,445,49.94388328,446,50.05611672,891,37,928,0,1197,77.52715121
基隆市,仁愛區,朝棟里,89,190,18.25168108,851,81.74831892,1041,30,1071,0,1265,84.66403162
基隆市,仁愛區,朝棟里,90,469,38.69636964,743,61.30363036,1212,35,1247,0,1606,77.64632628
基隆市,仁愛區,明德里,93,243,41.18644068,347,58.81355932,590,23,613,0,770,79.61038961
基隆市,仁愛區,同風里,94,245,45.20295203,297,54.79704797,542,14,556,0,669,83.10911809
基隆市,仁愛區,文昌里,95,417,59.06515581,289,40.93484419,706,4,710,0,858,82.75058275
基隆市,仁愛區,新店里,96,293,49.74533107,296,50.25466893,589,12,601,0,722,83.24099723
基隆市,仁愛區,光華里,91,385,43.1131019,508,56.8868981,893,14,907,0,1155,78.52813853
基隆市,仁愛區,光華里,92,396,43.37349398,517,56.62650602,913,12,925,0,1143,80.92738408
基隆市,中山區,新建里,97,325,54.25709516,274,45.74290484,599,18,617,0,788,78.29949239
基隆市,中山區,安民里,98,432,49.5412844,440,50.4587156,872,29,901,0,1121,80.37466548
基隆市,中山區,安平里,99,376,48.83116883,394,51.16883117,770,27,797,0,991,80.42381433
基隆市,中山區,中山里,100,447,52.21962617,409,47.78037383,856,16,872,0,1117,78.06624888
基隆市,中山區,民治里,101,333,45.30612245,402,54.69387755,735,7,742,0,985,75.32994924
基隆市,中山區,中興里,102,413,41.13545817,591,58.86454183,1004,37,1041,0,1312,79.3445122
基隆市,中山區,仁正里,103,218,35.6792144,393,64.3207856,611,12,623,0,837,74.43249701
基隆市,中山區,健民里,104,537,48.64130435,567,51.35869565,1104,26,1130,0,1452,77.82369146
基隆市,中山區,通化里,105,372,40.39087948,549,59.60912052,921,32,953,0,1238,76.97899838
基隆市,中山區,居仁里,106,192,37.20930233,324,62.79069767,516,21,537,0,723,74.27385892
基隆市,中山區,居仁里,107,263,47.13261649,295,52.86738351,558,17,575,0,772,74.48186528
基隆市,中山區,通明里,108,281,39.19107392,436,60.80892608,717,19,736,0,953,77.22980063
基隆市,中山區,通明里,109,377,46.42857143,435,53.57142857,812,35,847,0,1071,79.08496732
基隆市,中山區,協和里,113,308,44.89795918,378,55.10204082,686,8,694,0,896,77.45535714
基隆市,中山區,協和里,114,272,45.56113903,325,54.43886097,597,19,616,0,763,80.73394495
基隆市,中山區,文化里,115,328,42.10526316,451,57.89473684,779,24,803,0,1132,70.93639576
基隆市,中山區,仙洞里,111,285,50.80213904,276,49.19786096,561,21,582,0,758,76.78100264
基隆市,中山區,太白里,112,336,48.06866953,363,51.93133047,699,23,722,0,960,75.20833333
基隆市,中山區,西榮里,129,287,44.42724458,359,55.57275542,646,15,661,0,852,77.58215962
基隆市,中山區,西華里,128,364,46.84684685,413,53.15315315,777,18,795,0,996,79.81927711
基隆市,中山區,西定里,127,322,44.4137931,403,55.5862069,725,29,754,0,998,75.5511022
基隆市,中山區,西康里,126,597,48.14516129,643,51.85483871,1240,41,1281,0,1669,76.75254643
基隆市,中山區,德和里,118,535,38.4063173,858,61.5936827,1393,31,1424,0,1730,82.31213873
基隆市,中山區,德和里,119,342,30.89430894,765,69.10569106,1107,8,1115,0,1299,85.83525789
基隆市,中山區,德和里,120,555,39.72798855,842,60.27201145,1397,32,1429,0,1770,80.73446328
基隆市,中山區,中和里,121,448,39.78685613,678,60.21314387,1126,23,1149,0,1483,77.47808496
基隆市,中山區,中和里,122,261,41.42857143,369,58.57142857,630,14,644,0,828,77.77777778
基隆市,中山區,中和里,123,576,32.82051282,1179,67.17948718,1755,29,1784,0,2328,76.63230241
基隆市,中山區,德安里,116,536,40.57532173,785,59.42467827,1321,37,1358,0,1706,79.6014068
基隆市,中山區,德安里,117,500,42.5170068,676,57.4829932,1176,24,1200,0,1469,81.68822328
基隆市,中山區,和平里,110,170,34.41295547,324,65.58704453,494,16,510,0,674,75.66765579
基隆市,中山區,和慶里,124,756,40.97560976,1089,59.02439024,1845,38,1883,0,2565,73.41130604
基隆市,中山區,和慶里,125,699,38.83333333,1101,61.16666667,1800,31,1831,0,2398,76.35529608
基隆市,安樂區,西川里,131,419,40.79844206,608,59.20155794,1027,33,1060,0,1353,78.34441981
基隆市,安樂區,定國里,132,409,44.02583423,520,55.97416577,929,34,963,0,1243,77.47385358
基隆市,安樂區,新西里,130,469,44.28706327,590,55.71293673,1059,49,1108,0,1467,75.52828903
基隆市,安樂區,定邦里,133,496,48.86699507,519,51.13300493,1015,28,1043,0,1306,79.86217458
基隆市,安樂區,慈仁里,134,401,52.28161669,366,47.71838331,767,22,789,0,1034,76.30560928
基隆市,安樂區,干城里,135,476,41.71779141,665,58.28220859,1141,31,1172,0,1498,78.2376502
基隆市,安樂區,干城里,136,269,46.7826087,306,53.2173913,575,37,612,0,804,76.11940299
基隆市,安樂區,永康里,137,578,50.74626866,561,49.25373134,1139,31,1170,0,1537,76.1223162
基隆市,安樂區,永康里,138,163,45.27777778,197,54.72222222,360,12,372,0,466,79.82832618
基隆市,安樂區,嘉仁里,141,780,53.02515296,691,46.97484704,1471,40,1511,0,1958,77.17058223
基隆市,安樂區,嘉仁里,142,529,50.67049808,515,49.32950192,1044,29,1073,0,1354,79.24667651
基隆市,安樂區,安和里,139,347,48.12760055,374,51.87239945,721,12,733,0,912,80.37280702
基隆市,安樂區,樂一里,140,263,51.26705653,250,48.73294347,513,18,531,0,653,81.31699847
基隆市,安樂區,外寮里,162,595,41.55027933,837,58.44972067,1432,34,1466,0,1903,77.03625854
基隆市,安樂區,外寮里,163,431,38.72416891,682,61.27583109,1113,27,1140,0,1443,79.002079
基隆市,安樂區,中崙里,168,415,41.5,585,58.5,1000,23,1023,0,1315,77.79467681
基隆市,安樂區,內寮里,169,509,37.34409391,854,62.65590609,1363,33,1396,0,1860,75.05376344
基隆市,安樂區,內寮里,170,531,42.54807692,717,57.45192308,1248,35,1283,0,1717,74.72335469
基隆市,安樂區,新崙里,164,636,40.56122449,932,59.43877551,1568,16,1584,0,2048,77.34375
基隆市,安樂區,新崙里,165,361,45.58080808,431,54.41919192,792,19,811,0,1050,77.23809524
基隆市,安樂區,三民里,143,466,37.85540211,765,62.14459789,1231,22,1253,0,1565,80.06389776
基隆市,安樂區,三民里,144,440,38.06228374,716,61.93771626,1156,30,1186,0,1514,78.33553501
基隆市,安樂區,三民里,145,591,35.11586453,1092,64.88413547,1683,18,1701,0,2112,80.53977273
基隆市,安樂區,四維里,146,522,38.38235294,838,61.61764706,1360,21,1381,0,1648,83.79854369
基隆市,安樂區,四維里,147,304,37.3006135,511,62.6993865,815,21,836,0,997,83.85155466
基隆市,安樂區,四維里,148,463,37.04,787,62.96,1250,23,1273,0,1548,82.23514212
基隆市,安樂區,五福里,149,554,35.08549715,1025,64.91450285,1579,23,1602,0,1958,81.81818182
基隆市,安樂區,五福里,150,426,37.40122915,713,62.59877085,1139,30,1169,0,1526,76.60550459
基隆市,安樂區,六合里,151,489,36.5470852,849,63.4529148,1338,24,1362,0,1724,79.00232019
基隆市,安樂區,六合里,152,518,36.68555241,894,63.31444759,1412,35,1447,0,1834,78.89858233
基隆市,安樂區,七賢里,153,481,41.46551724,679,58.53448276,1160,26,1186,0,1470,80.68027211
基隆市,安樂區,七賢里,154,452,41.85185185,628,58.14814815,1080,36,1116,0,1395,80
基隆市,安樂區,鶯歌里,157,430,39.74121996,652,60.25878004,1082,36,1118,0,1540,72.5974026
基隆市,安樂區,鶯歌里,158,387,37.94117647,633,62.05882353,1020,7,1027,0,1301,78.93927748
基隆市,安樂區,武崙里,166,356,39.12087912,554,60.87912088,910,25,935,0,1220,76.63934426
基隆市,安樂區,武崙里,167,605,35.46307151,1101,64.53692849,1706,33,1739,0,2173,80.0276116
基隆市,安樂區,長樂里,155,460,29.09550917,1121,70.90449083,1581,17,1598,0,1907,83.79653907
基隆市,安樂區,長樂里,156,206,34.7386172,387,65.2613828,593,9,602,0,737,81.68249661
基隆市,安樂區,興寮里,160,651,39.21686747,1009,60.78313253,1660,28,1688,0,2240,75.35714286
基隆市,安樂區,興寮里,161,367,37.71839671,606,62.28160329,973,19,992,0,1279,77.56059421
基隆市,安樂區,鶯安里,159,727,36.55103067,1262,63.44896933,1989,31,2020,0,2505,80.63872255
基隆市,暖暖區,八西里,171,466,43.55140187,604,56.44859813,1070,25,1095,0,1375,79.63636364
基隆市,暖暖區,八堵里,173,235,43.35793358,307,56.64206642,542,15,557,0,713,78.12061711
基隆市,暖暖區,八南里,174,221,49.33035714,227,50.66964286,448,15,463,0,625,74.08
基隆市,暖暖區,過港里,175,475,35.68745304,856,64.31254696,1331,21,1352,0,1737,77.8353483
基隆市,暖暖區,過港里,176,422,35.22537563,776,64.77462437,1198,31,1229,0,1572,78.18066158
基隆市,暖暖區,碇內里,184,283,33.02217036,574,66.97782964,857,21,878,0,1081,81.22109158
基隆市,暖暖區,碇內里,185,251,28.45804989,631,71.54195011,882,27,909,0,1201,75.68692756
基隆市,暖暖區,碇和里,186,30,4.694835681,609,95.30516432,639,18,657,0,778,84.44730077
基隆市,暖暖區,碇和里,187,447,38.23781009,722,61.76218991,1169,18,1187,0,1541,77.02790396
基隆市,暖暖區,暖同里,179,312,41.05263158,448,58.94736842,760,16,776,0,962,80.66528067
基隆市,暖暖區,暖同里,180,365,36.53653654,634,63.46346346,999,18,1017,0,1312,77.5152439
基隆市,暖暖區,暖暖里,177,424,39.62616822,646,60.37383178,1070,18,1088,0,1305,83.37164751
基隆市,暖暖區,暖暖里,178,321,45.08426966,391,54.91573034,712,22,734,1,952,77.10084034
基隆市,暖暖區,暖東里,181,125,44.01408451,159,55.98591549,284,11,295,0,397,74.30730479
基隆市,暖暖區,暖西里,182,655,41.96028187,906,58.03971813,1561,25,1586,0,2000,79.3
基隆市,暖暖區,暖西里,183,512,40.50632911,752,59.49367089,1264,26,1290,0,1654,77.99274486
基隆市,暖暖區,八中里,172,224,46.76409186,255,53.23590814,479,18,497,0,637,78.02197802
基隆市,暖暖區,碇安里,190,729,37.42299795,1219,62.57700205,1948,32,1980,0,2530,78.26086957
基隆市,暖暖區,碇安里,191,471,33.05263158,954,66.94736842,1425,31,1456,0,1908,76.31027254
基隆市,暖暖區,碇祥里,188,396,34.52484743,751,65.47515257,1147,19,1166,0,1594,73.14930991
基隆市,暖暖區,碇祥里,189,473,32.9846583,961,67.0153417,1434,23,1457,1,1858,78.41765339
基隆市,七堵區,長興里,192,505,43.0153322,669,56.9846678,1174,27,1201,0,1470,81.70068027
基隆市,七堵區,長興里,193,422,37.18061674,713,62.81938326,1135,24,1159,0,1471,78.78993882
基隆市,七堵區,長興里,194,235,37.78135048,387,62.21864952,622,15,637,0,808,78.83663366
基隆市,七堵區,正光里,195,378,44.94649227,463,55.05350773,841,12,853,1,1112,76.70863309
基隆市,七堵區,正光里,196,378,43.90243902,483,56.09756098,861,29,890,0,1103,80.68902992
基隆市,七堵區,富民里,199,435,31.56748911,943,68.43251089,1378,38,1416,0,1766,80.18120045
基隆市,七堵區,富民里,200,620,41.25083167,883,58.74916833,1503,27,1530,0,1860,82.25806452
基隆市,七堵區,永平里,201,312,40.6779661,455,59.3220339,767,19,786,0,974,80.69815195
基隆市,七堵區,永平里,202,314,36.98468787,535,63.01531213,849,17,866,0,1075,80.55813953
基隆市,七堵區,永安里,203,341,37.18647764,576,62.81352236,917,18,935,1,1184,78.96959459
基隆市,七堵區,永安里,204,278,41.74174174,388,58.25825826,666,17,683,1,871,78.41561424
基隆市,七堵區,八德里,205,104,44.25531915,131,55.74468085,235,2,237,0,296,80.06756757
基隆市,七堵區,八德里,206,461,45.91633466,543,54.08366534,1004,19,1023,0,1245,82.1686747
基隆市,七堵區,自強里,207,326,44.65753425,404,55.34246575,730,9,739,0,934,79.12205567
基隆市,七堵區,六堵里,211,476,44.19684308,601,55.80315692,1077,36,1113,0,1431,77.77777778
基隆市,七堵區,泰安里,208,280,44.58598726,348,55.41401274,628,10,638,0,794,80.35264484
基隆市,七堵區,泰安里,209,504,41.34536505,715,58.65463495,1219,7,1226,1,1546,79.30142303
基隆市,七堵區,泰安里,210,316,42.35924933,430,57.64075067,746,34,780,0,958,81.41962422
基隆市,七堵區,堵北里,214,1075,47.35682819,1195,52.64317181,2270,46,2316,0,3095,74.83037157
基隆市,七堵區,堵南里,212,558,47.57033248,615,52.42966752,1173,23,1196,0,1538,77.763329
基隆市,七堵區,堵南里,213,592,40.16282225,882,59.83717775,1474,22,1496,0,2001,74.76261869
基隆市,七堵區,瑪南里,221,194,56.06936416,152,43.93063584,346,3,349,0,453,77.0419426
基隆市,七堵區,瑪東里,222,101,45.90909091,119,54.09090909,220,15,235,0,307,76.54723127
基隆市,七堵區,瑪西里,223,164,59.20577617,113,40.79422383,277,12,289,0,360,80.27777778
基隆市,七堵區,友一里,224,474,43.28767123,621,56.71232877,1095,23,1118,0,1380,81.01449275
基隆市,七堵區,友二里,225,199,56.53409091,153,43.46590909,352,19,371,0,445,83.37078652
基隆市,七堵區,正明里,197,432,44.67425026,535,55.32574974,967,23,990,0,1196,82.77591973
基隆市,七堵區,正明里,198,246,39.54983923,376,60.45016077,622,9,631,0,789,79.97465146
基隆市,七堵區,百福里,215,531,48.01084991,575,51.98915009,1106,21,1127,0,1410,79.92907801
基隆市,七堵區,百福里,216,613,49.07926341,636,50.92073659,1249,25,1274,0,1622,78.54500617
基隆市,七堵區,百福里,217,550,43.23899371,722,56.76100629,1272,20,1292,0,1641,78.7324802
基隆市,七堵區,實踐里,218,412,44.83133841,507,55.16866159,919,21,940,0,1210,77.68595041
基隆市,七堵區,實踐里,219,351,46.98795181,396,53.01204819,747,15,762,0,969,78.6377709
基隆市,七堵區,實踐里,220,427,44.66527197,529,55.33472803,956,27,983,0,1250,78.64
新竹市,東區,南門里,79,311,57.48613678,230,42.51386322,541,11,552,0,701,78.7446505
新竹市,東區,福德里,81,550,54.78087649,454,45.21912351,1004,30,1034,0,1292,80.03095975
新竹市,東區,南市里,80,446,61.17969822,283,38.82030178,729,9,738,0,911,81.00987925
新竹市,東區,關帝里,78,268,57.26495726,200,42.73504274,468,5,473,0,601,78.70216306
新竹市,東區,東門里,4,331,58.27464789,237,41.72535211,568,18,586,0,715,81.95804196
新竹市,東區,榮光里,6,175,50.72463768,170,49.27536232,345,8,353,0,467,75.5888651
新竹市,東區,成功里,5,331,57.36568458,246,42.63431542,577,10,587,0,758,77.44063325
新竹市,東區,下竹里,90,235,40.10238908,351,59.89761092,586,25,611,0,766,79.76501305
新竹市,東區,竹蓮里,89,416,63.41463415,240,36.58536585,656,17,673,0,806,83.49875931
新竹市,東區,寺前里,88,354,55.57299843,283,44.42700157,637,20,657,0,858,76.57342657
新竹市,東區,育賢里,1,327,44.73324213,404,55.26675787,731,18,749,0,1207,62.05468103
新竹市,東區,中正里,7,202,53.58090186,175,46.41909814,377,10,387,0,505,76.63366337
新竹市,東區,公園里,24,270,36.53585927,469,63.46414073,739,13,752,0,965,77.92746114
新竹市,東區,公園里,25,435,40.57835821,637,59.42164179,1072,28,1100,0,1291,85.20526723
新竹市,東區,頂竹里,91,382,50.93333333,368,49.06666667,750,24,774,2,956,80.9623431
新竹市,東區,頂竹里,92,384,48.54614412,407,51.45385588,791,9,800,0,985,81.21827411
新竹市,東區,頂竹里,93,436,51.9047619,404,48.0952381,840,17,857,0,1055,81.23222749
新竹市,東區,南大里,94,293,58.48303393,208,41.51696607,501,15,516,0,656,78.65853659
新竹市,東區,南大里,95,318,46.69603524,363,53.30396476,681,19,700,0,850,82.35294118
新竹市,東區,振興里,82,639,52.37704918,581,47.62295082,1220,26,1246,0,1602,77.77777778
新竹市,東區,振興里,83,528,42.58064516,712,57.41935484,1240,13,1253,0,1560,80.32051282
新竹市,東區,振興里,84,431,42.71555996,578,57.28444004,1009,26,1035,0,1328,77.93674699
新竹市,東區,親仁里,2,180,24.3902439,558,75.6097561,738,22,760,0,953,79.74816369
新竹市,東區,親仁里,3,115,18.0533752,522,81.9466248,637,10,647,0,820,78.90243902
新竹市,東區,文華里,10,354,37.5397667,589,62.4602333,943,18,961,0,1176,81.71768707
新竹市,東區,文華里,11,354,44.6969697,438,55.3030303,792,16,808,0,963,83.90446521
新竹市,東區,文華里,12,464,40.66608238,677,59.33391762,1141,14,1155,0,1397,82.67716535
新竹市,東區,復中里,13,397,39.15187377,617,60.84812623,1014,17,1031,0,1281,80.48399688
新竹市,東區,復中里,14,426,42.68537074,572,57.31462926,998,15,1013,0,1236,81.9579288
新竹市,東區,復中里,15,496,46.61654135,568,53.38345865,1064,21,1085,0,1316,82.44680851
新竹市,東區,三民里,19,562,53.21969697,494,46.78030303,1056,32,1088,0,1297,83.88589052
新竹市,東區,三民里,20,521,45.50218341,624,54.49781659,1145,23,1168,0,1405,83.1316726
新竹市,東區,三民里,21,448,44.00785855,570,55.99214145,1018,14,1032,0,1225,84.24489796
新竹市,東區,東園里,22,326,41.05793451,468,58.94206549,794,19,813,0,997,81.5446339
新竹市,東區,東園里,23,548,43.28593997,718,56.71406003,1266,23,1289,0,1613,79.91320521
新竹市,東區,東勢里,34,445,51.92532089,412,48.07467911,857,11,868,0,1063,81.65569144
新竹市,東區,光復里,35,293,41.56028369,412,58.43971631,705,16,721,0,871,82.77841561
新竹市,東區,光復里,36,435,56.56697009,334,43.43302991,769,36,805,0,973,82.73381295
新竹市,東區,豐功里,43,380,36.50336215,661,63.49663785,1041,30,1071,0,1333,80.34508627
新竹市,東區,豐功里,44,269,27.76057792,700,72.23942208,969,23,992,0,1218,81.44499179
新竹市,東區,武功里,46,204,10.46690611,1745,89.53309389,1949,48,1997,0,2353,84.87037824
新竹市,東區,武功里,47,105,18.75,455,81.25,560,17,577,0,655,88.09160305
新竹市,東區,綠水里,31,300,32.01707577,637,67.98292423,937,15,952,0,1199,79.39949958
新竹市,東區,綠水里,32,443,37.44716822,740,62.55283178,1183,21,1204,0,1503,80.10645376
新竹市,東區,綠水里,33,360,31.41361257,786,68.58638743,1146,23,1169,0,1405,83.20284698
新竹市,東區,東山里,28,300,42.55319149,405,57.44680851,705,22,727,0,901,80.68812431
新竹市,東區,東山里,29,327,39.06810036,510,60.93189964,837,10,847,0,1012,83.69565217
新竹市,東區,東山里,30,260,32.41895262,542,67.58104738,802,10,812,0,990,82.02020202
新竹市,東區,光鎮里,99,558,47.44897959,618,52.55102041,1176,14,1190,0,1477,80.56872038
新竹市,東區,光鎮里,100,581,46.48,669,53.52,1250,29,1279,0,1551,82.46292714
新竹市,東區,新興里,85,434,55.00633714,355,44.99366286,789,7,796,0,972,81.89300412
新竹市,東區,新興里,86,422,48.33906071,451,51.66093929,873,22,895,0,1096,81.66058394
新竹市,東區,新興里,87,429,53.96226415,366,46.03773585,795,19,814,0,1010,80.59405941
新竹市,東區,柴橋里,107,447,47.25158562,499,52.74841438,946,20,966,0,1201,80.43297252
新竹市,東區,柴橋里,108,326,34.64399575,615,65.35600425,941,14,955,0,1145,83.40611354
新竹市,東區,柴橋里,109,359,36.48373984,625,63.51626016,984,14,998,0,1146,87.08551483
新竹市,東區,高峰里,101,461,44.5410628,574,55.4589372,1035,19,1054,0,1307,80.64269319
新竹市,東區,高峰里,102,451,54.93300853,370,45.06699147,821,19,840,0,1086,77.3480663
新竹市,東區,高峰里,103,443,41.75306315,618,58.24693685,1061,29,1090,0,1373,79.38820102
新竹市,東區,高峰里,104,400,42.19409283,548,57.80590717,948,18,966,0,1179,81.93384224
新竹市,東區,仙宮里,77,266,37.89173789,436,62.10826211,702,20,722,0,871,82.89322618
新竹市,東區,光明里,54,218,22.99578059,730,77.00421941,948,16,964,0,1254,76.87400319
新竹市,東區,光明里,55,148,35.49160671,269,64.50839329,417,1,418,0,526,79.46768061
新竹市,東區,光明里,56,353,29.46577629,845,70.53422371,1198,17,1215,0,1493,81.37977227
新竹市,東區,偉功里,45,9,9.090909091,90,90.90909091,99,4,103,0,168,61.30952381
新竹市,東區,立功里,50,120,17.6730486,559,82.3269514,679,19,698,0,857,81.44690782
新竹市,東區,軍功里,48,225,17.75848461,1042,82.24151539,1267,54,1321,0,1584,83.39646465
新竹市,東區,軍功里,49,321,23.65512159,1036,76.34487841,1357,25,1382,0,1651,83.70684434
新竹市,東區,建功里,51,63,8.823529412,651,91.17647059,714,7,721,0,912,79.05701754
新竹市,東區,建功里,52,177,24.34662999,550,75.65337001,727,17,744,0,872,85.32110092
新竹市,東區,建功里,53,62,10.65292096,520,89.34707904,582,14,596,0,687,86.75400291
新竹市,東區,前溪里,37,659,55.14644351,536,44.85355649,1195,18,1213,0,1493,81.2458138
新竹市,東區,前溪里,38,389,52.85326087,347,47.14673913,736,30,766,0,955,80.20942408
新竹市,東區,水源里,39,704,61.2173913,446,38.7826087,1150,56,1206,0,1478,81.59675237
新竹市,東區,水源里,40,679,54.32,571,45.68,1250,44,1294,0,1579,81.95060165
新竹市,東區,千甲里,41,308,47.2392638,344,52.7607362,652,32,684,0,849,80.56537102
新竹市,東區,千甲里,42,300,41.84100418,417,58.15899582,717,31,748,0,902,82.92682927
新竹市,東區,埔頂里,64,462,48.37696335,493,51.62303665,955,31,986,0,1203,81.96176226
新竹市,東區,埔頂里,65,434,51.17924528,414,48.82075472,848,5,853,0,1044,81.70498084
新竹市,東區,龍山里,57,328,40.64436183,479,59.35563817,807,21,828,0,972,85.18518519
新竹市,東區,龍山里,58,187,31.06312292,415,68.93687708,602,11,613,0,749,81.84245661
新竹市,東區,龍山里,59,306,35.58139535,554,64.41860465,860,15,875,0,1051,83.25404377
新竹市,東區,新莊里,66,470,40.41272571,693,59.58727429,1163,33,1196,0,1443,82.88288288
新竹市,東區,新莊里,67,425,36.86036427,728,63.13963573,1153,27,1180,0,1433,82.34473133
新竹市,東區,新莊里,68,272,29.05982906,664,70.94017094,936,12,948,0,1139,83.2309043
新竹市,東區,仙水里,75,424,31.01682516,943,68.98317484,1367,34,1401,0,1695,82.65486726
新竹市,東區,仙水里,76,524,38.75739645,828,61.24260355,1352,21,1373,0,1621,84.70080197
新竹市,東區,金山里,72,423,35.8778626,756,64.1221374,1179,30,1209,2,1481,81.63403106
新竹市,東區,金山里,73,276,23.40966921,903,76.59033079,1179,43,1222,0,1497,81.62992652
新竹市,東區,金山里,74,308,27.84810127,798,72.15189873,1106,20,1126,0,1394,80.77474892
新竹市,東區,關東里,69,280,32.18390805,590,67.81609195,870,26,896,0,1087,82.42870285
新竹市,東區,關東里,70,279,29.39936776,670,70.60063224,949,34,983,0,1209,81.30686518
新竹市,東區,關東里,71,386,34.40285205,736,65.59714795,1122,32,1154,0,1392,82.90229885
新竹市,東區,科園里,60,386,33.77077865,757,66.22922135,1143,29,1172,0,1369,85.60993426
新竹市,東區,科園里,61,275,26.06635071,780,73.93364929,1055,11,1066,0,1266,84.20221169
新竹市,東區,科園里,62,387,33.71080139,761,66.28919861,1148,19,1167,0,1335,87.41573034
新竹市,東區,科園里,63,318,33.5089568,631,66.4910432,949,18,967,0,1133,85.34863195
新竹市,東區,建華里,26,468,48.49740933,497,51.50259067,965,18,983,0,1206,81.50912106
新竹市,東區,建華里,27,372,48.24902724,399,51.75097276,771,20,791,0,951,83.17560463
新竹市,東區,新光里,96,189,40.9978308,272,59.0021692,461,17,478,0,585,81.70940171
新竹市,東區,新光里,97,566,48.62542955,598,51.37457045,1164,46,1210,0,1508,80.23872679
新竹市,東區,新光里,98,488,50.9394572,470,49.0605428,958,16,974,0,1182,82.40270728
新竹市,東區,復興里,16,415,44.86486486,510,55.13513514,925,17,942,0,1142,82.48686515
新竹市,東區,復興里,17,348,35.91331269,621,64.08668731,969,21,990,0,1215,81.48148148
新竹市,東區,復興里,18,423,42.21556886,579,57.78443114,1002,20,1022,0,1225,83.42857143
新竹市,東區,錦華里,8,289,37.82722513,475,62.17277487,764,10,774,0,975,79.38461538
新竹市,東區,錦華里,9,98,17.13286713,474,82.86713287,572,13,585,0,747,78.31325301
新竹市,東區,湖濱里,105,623,44.59556192,774,55.40443808,1397,18,1415,0,1732,81.69745958
新竹市,東區,湖濱里,106,475,50.96566524,457,49.03433476,932,16,948,0,1182,80.20304569
新竹市,東區,明湖里,110,320,38.97685749,501,61.02314251,821,20,841,0,1063,79.11571025
新竹市,東區,明湖里,111,301,35.53719008,546,64.46280992,847,18,865,0,1050,82.38095238
新竹市,東區,明湖里,112,286,33.52872216,567,66.47127784,853,12,865,0,1158,74.69775475
新竹市,北區,西門里,113,220,53.92156863,188,46.07843137,408,14,422,0,521,80.99808061
新竹市,北區,仁德里,117,369,60.89108911,237,39.10891089,606,15,621,0,761,81.60315375
新竹市,北區,潛園里,114,374,57.80525502,273,42.19474498,647,12,659,0,808,81.55940594
新竹市,北區,中央里,115,276,66.99029126,136,33.00970874,412,17,429,0,523,82.02676864
新竹市,北區,崇禮里,118,561,60.64864865,364,39.35135135,925,32,957,0,1154,82.92894281
新竹市,北區,石坊里,116,217,52.92682927,193,47.07317073,410,13,423,0,550,76.90909091
新竹市,北區,興南里,119,563,56.13160518,440,43.86839482,1003,21,1024,0,1238,82.71405493
新竹市,北區,北門里,144,460,63.10013717,269,36.89986283,729,10,739,0,924,79.97835498
新竹市,北區,中興里,141,283,62.33480176,171,37.66519824,454,13,467,0,588,79.42176871
新竹市,北區,大同里,139,258,38.91402715,405,61.08597285,663,19,682,0,838,81.38424821
新竹市,北區,中山里,140,328,60.74074074,212,39.25925926,540,7,547,0,664,82.37951807
新竹市,北區,長和里,143,533,57.99782372,386,42.00217628,919,24,943,0,1167,80.80548415
新竹市,北區,新民里,142,542,52.21579961,496,47.78420039,1038,19,1057,0,1312,80.56402439
新竹市,北區,民富里,145,561,59.4279661,383,40.5720339,944,26,970,1,1201,80.76602831
新竹市,北區,民富里,146,621,55.34759358,501,44.65240642,1122,27,1149,0,1447,79.4056669
新竹市,北區,民富里,147,496,48.4375,528,51.5625,1024,24,1048,0,1366,76.72035139
新竹市,北區,水田里,156,433,44.59320288,538,55.40679712,971,24,995,0,1248,79.7275641
新竹市,北區,水田里,157,557,49.204947,575,50.795053,1132,23,1155,0,1415,81.6254417
新竹市,北區,文雅里,154,702,55.27559055,568,44.72440945,1270,31,1301,0,1553,83.77334192
新竹市,北區,文雅里,155,605,46.11280488,707,53.88719512,1312,22,1334,0,1624,82.14285714
新竹市,北區,光田里,158,359,49.31318681,369,50.68681319,728,11,739,0,919,80.41349293
新竹市,北區,光田里,159,431,47.57174393,475,52.42825607,906,18,924,0,1102,83.84754991
新竹市,北區,士林里,183,625,60.62075655,406,39.37924345,1031,31,1062,0,1280,82.96875
新竹市,北區,士林里,184,71,11.37820513,553,88.62179487,624,16,640,0,770,83.11688312
新竹市,北區,士林里,185,180,24.3902439,558,75.6097561,738,24,762,0,886,86.00451467
新竹市,北區,福林里,178,465,46.13095238,543,53.86904762,1008,24,1032,0,1291,79.93803253
新竹市,北區,福林里,179,592,43.6256448,765,56.3743552,1357,24,1381,0,1663,83.04269393
新竹市,北區,古賢里,186,433,63.95864106,244,36.04135894,677,21,698,0,882,79.138322
新竹市,北區,湳雅里,165,381,43.79310345,489,56.20689655,870,16,886,0,1118,79.24865832
新竹市,北區,湳雅里,166,443,38.82559159,698,61.17440841,1141,24,1165,0,1413,82.44869073
新竹市,北區,舊社里,171,541,42.46467818,733,57.53532182,1274,27,1301,0,1582,82.23767383
新竹市,北區,舊社里,172,497,42.1901528,681,57.8098472,1178,23,1201,0,1495,80.33444816
新竹市,北區,舊社里,173,734,54.73527218,607,45.26472782,1341,35,1376,0,1625,84.67692308
新竹市,北區,武陵里,177,145,11.06870229,1165,88.93129771,1310,25,1335,0,1585,84.22712934
新竹市,北區,南寮里,187,422,51.7791411,393,48.2208589,815,15,830,0,1060,78.30188679
新竹市,北區,南寮里,188,347,44.03553299,441,55.96446701,788,32,820,0,1075,76.27906977
新竹市,北區,南寮里,189,680,55.23964257,551,44.76035743,1231,35,1266,0,1674,75.62724014
新竹市,北區,舊港里,194,213,50.71428571,207,49.28571429,420,3,423,0,555,76.21621622
新竹市,北區,康樂里,190,734,53.69422092,633,46.30577908,1367,44,1411,0,1765,79.94334278
新竹市,北區,港北里,193,584,61.9300106,359,38.0699894,943,27,970,0,1195,81.17154812
新竹市,北區,中寮里,191,652,57.19298246,488,42.80701754,1140,24,1164,0,1477,78.8083954
新竹市,北區,海濱里,192,699,53.89360062,598,46.10639938,1297,33,1330,0,1682,79.0725327
新竹市,北區,客雅里,131,235,45.27938343,284,54.72061657,519,14,533,0,683,78.03806735
新竹市,北區,客雅里,132,176,23.28042328,580,76.71957672,756,17,773,0,961,80.43704475
新竹市,北區,客雅里,133,580,57.59682224,427,42.40317776,1007,32,1039,0,1295,80.23166023
新竹市,北區,育英里,120,385,42.26125137,526,57.73874863,911,9,920,0,1133,81.20035305
新竹市,北區,育英里,121,388,47.72447724,425,52.27552276,813,25,838,0,1046,80.11472275
新竹市,北區,育英里,122,499,50.55724417,488,49.44275583,987,16,1003,0,1210,82.89256198
新竹市,北區,曲溪里,124,161,26.83333333,439,73.16666667,600,34,634,0,850,74.58823529
新竹市,北區,曲溪里,125,360,48.71447903,379,51.28552097,739,14,753,0,900,83.66666667
新竹市,北區,曲溪里,126,292,39.19463087,453,60.80536913,745,33,778,0,982,79.22606925
新竹市,北區,曲溪里,127,6,1.526717557,387,98.47328244,393,58,451,0,602,74.91694352
新竹市,北區,曲溪里,128,573,51.25223614,545,48.74776386,1118,31,1149,0,1396,82.30659026
新竹市,北區,西雅里,129,595,58.91089109,415,41.08910891,1010,35,1045,0,1345,77.69516729
新竹市,北區,西雅里,130,519,53.78238342,446,46.21761658,965,14,979,0,1189,82.33809924
新竹市,北區,南勢里,134,483,63.80449141,274,36.19550859,757,24,781,0,961,81.26951093
新竹市,北區,南勢里,135,723,64.61126005,396,35.38873995,1119,17,1136,0,1377,82.49818446
新竹市,北區,南勢里,136,521,60.16166282,345,39.83833718,866,20,886,0,1066,83.11444653
新竹市,北區,大鵬里,137,26,3.708987161,675,96.29101284,701,15,716,0,845,84.73372781
新竹市,北區,大鵬里,138,16,2.862254025,543,97.13774597,559,21,580,0,676,85.79881657
新竹市,北區,境福里,180,381,45.03546099,465,54.96453901,846,6,852,0,1057,80.60548723
新竹市,北區,境福里,181,448,51.43513203,423,48.56486797,871,13,884,0,1099,80.43676069
新竹市,北區,境福里,182,588,47.68856448,645,52.31143552,1233,31,1264,0,1527,82.77668631
新竹市,北區,磐石里,148,554,51.96998124,512,48.03001876,1066,20,1086,0,1323,82.0861678
新竹市,北區,磐石里,149,647,53.78221114,556,46.21778886,1203,24,1227,0,1522,80.61760841
新竹市,北區,磐石里,150,484,50.15544041,481,49.84455959,965,21,986,0,1201,82.09825146
新竹市,北區,新雅里,151,503,50.50200803,493,49.49799197,996,21,1017,0,1274,79.82731554
新竹市,北區,新雅里,152,629,63.15261044,367,36.84738956,996,35,1031,0,1251,82.41406875
新竹市,北區,新雅里,153,488,53.15904139,430,46.84095861,918,9,927,0,1133,81.81818182
新竹市,北區,光華里,160,476,46.03481625,558,53.96518375,1034,24,1058,0,1512,69.97354497
新竹市,北區,光華里,161,474,38.44282238,759,61.55717762,1233,26,1259,0,1512,83.26719577
新竹市,北區,金華里,162,420,46.05263158,492,53.94736842,912,20,932,0,1126,82.77087034
新竹市,北區,金華里,163,300,36.40776699,524,63.59223301,824,6,830,0,1009,82.25966303
新竹市,北區,金華里,164,603,48.74696847,634,51.25303153,1237,17,1254,0,1529,82.01438849
新竹市,北區,金竹里,174,426,35.6187291,770,64.3812709,1196,12,1208,0,1479,81.67680865
新竹市,北區,金竹里,175,464,39.7260274,704,60.2739726,1168,28,1196,0,1477,80.97494922
新竹市,北區,金竹里,176,440,40.77849861,639,59.22150139,1079,19,1098,0,1324,82.9305136
新竹市,北區,湳中里,168,563,45.8096013,666,54.1903987,1229,18,1247,0,1524,81.82414698
新竹市,北區,湳中里,169,383,35.07326007,709,64.92673993,1092,11,1103,0,1295,85.17374517
新竹市,北區,湳中里,170,387,30.06993007,900,69.93006993,1287,16,1303,0,1555,83.79421222
新竹市,北區,金雅里,167,566,50.40071238,557,49.59928762,1123,26,1149,0,1352,84.9852071
新竹市,北區,台溪里,123,409,41.60732452,574,58.39267548,983,28,1011,0,1304,77.53067485
新竹市,香山區,港南里,213,507,64.75095785,276,35.24904215,783,18,801,0,985,81.31979695
新竹市,香山區,港南里,214,365,54.07407407,310,45.92592593,675,27,702,0,890,78.87640449
新竹市,香山區,虎山里,210,604,56.50140318,465,43.49859682,1069,25,1094,0,1330,82.2556391
新竹市,香山區,虎山里,211,583,53.33943275,510,46.66056725,1093,24,1117,0,1465,76.24573379
新竹市,香山區,虎山里,212,873,57.69993391,640,42.30006609,1513,44,1557,0,1969,79.07567293
新竹市,香山區,虎林里,208,470,47.18875502,526,52.81124498,996,30,1026,0,1225,83.75510204
新竹市,香山區,虎林里,209,358,54.40729483,300,45.59270517,658,11,669,0,810,82.59259259
新竹市,香山區,浸水里,207,820,65.3907496,434,34.6092504,1254,49,1303,0,1603,81.28509046
新竹市,香山區,樹下里,205,519,66.2835249,264,33.7164751,783,31,814,0,1007,80.83416087
新竹市,香山區,樹下里,206,491,74.62006079,167,25.37993921,658,15,673,0,835,80.5988024
新竹市,香山區,埔前里,203,564,56.11940299,441,43.88059701,1005,33,1038,0,1301,79.78478094
新竹市,香山區,埔前里,204,581,63.15217391,339,36.84782609,920,27,947,0,1141,82.99737073
新竹市,香山區,中埔里,199,528,52.07100592,486,47.92899408,1014,20,1034,0,1270,81.41732283
新竹市,香山區,中埔里,200,468,50.59459459,457,49.40540541,925,15,940,0,1123,83.70436331
新竹市,香山區,牛埔里,201,555,59.48553055,378,40.51446945,933,26,959,0,1126,85.1687389
新竹市,香山區,牛埔里,202,411,40.05847953,615,59.94152047,1026,22,1048,0,1309,80.06111536
新竹市,香山區,頂埔里,195,707,52.9588015,628,47.0411985,1335,34,1369,0,1697,80.67177372
新竹市,香山區,頂埔里,196,383,36.09802074,678,63.90197926,1061,21,1082,0,1328,81.47590361
新竹市,香山區,東香里,215,228,44.35797665,286,55.64202335,514,21,535,0,688,77.76162791
新竹市,香山區,東香里,216,487,36.28912072,855,63.71087928,1342,21,1363,0,1627,83.77381684
新竹市,香山區,香村里,217,362,55.69230769,288,44.30769231,650,23,673,0,825,81.57575758
新竹市,香山區,香村里,218,419,43.60041623,542,56.39958377,961,33,994,0,1229,80.87876322
新竹市,香山區,香山里,219,618,53.73913043,532,46.26086957,1150,34,1184,0,1465,80.81911263
新竹市,香山區,香山里,220,535,53.5,465,46.5,1000,36,1036,0,1313,78.90327494
新竹市,香山區,大庄里,221,516,62.24366707,313,37.75633293,829,12,841,0,1001,84.01598402
新竹市,香山區,大庄里,222,462,55.52884615,370,44.47115385,832,25,857,0,1036,82.72200772
新竹市,香山區,美山里,223,443,55.79345088,351,44.20654912,794,46,840,0,1009,83.25074331
新竹市,香山區,朝山里,224,330,53.74592834,284,46.25407166,614,24,638,0,807,79.0582404
新竹市,香山區,朝山里,225,374,52.52808989,338,47.47191011,712,21,733,0,917,79.93456925
新竹市,香山區,海山里,226,432,54.40806045,362,45.59193955,794,37,831,0,1025,81.07317073
新竹市,香山區,海山里,227,337,49.05385735,350,50.94614265,687,23,710,0,907,78.2800441
新竹市,香山區,茄苳里,236,341,55.8101473,270,44.1898527,611,32,643,0,815,78.89570552
新竹市,香山區,大湖里,235,299,50.85034014,289,49.14965986,588,21,609,0,732,83.19672131
新竹市,香山區,南隘里,234,232,48.94514768,242,51.05485232,474,8,482,0,631,76.3866878
新竹市,香山區,中隘里,233,456,43.3460076,596,56.6539924,1052,25,1077,0,1350,79.77777778
新竹市,香山區,內湖里,229,465,49.78586724,469,50.21413276,934,24,958,0,1201,79.76686095
新竹市,香山區,內湖里,230,453,52.7972028,405,47.2027972,858,16,874,0,1105,79.09502262
新竹市,香山區,內湖里,231,437,47.34561213,486,52.65438787,923,32,955,0,1206,79.18739635
新竹市,香山區,鹽水里,228,535,57.52688172,395,42.47311828,930,20,950,0,1173,80.98891731
新竹市,香山區,南港里,232,407,66.61211129,204,33.38788871,611,30,641,0,794,80.73047859
新竹市,香山區,頂福里,197,404,50.69008783,393,49.30991217,797,12,809,0,1002,80.73852295
新竹市,香山區,頂福里,198,604,45.27736132,730,54.72263868,1334,30,1364,0,1699,80.28251913
臺中市,中區,繼光里,3,756,54.58483755,629,45.41516245,1385,29,1414,0,1779,79.48285554
臺中市,中區,大墩里,7,567,53.13964386,500,46.86035614,1067,27,1094,0,1380,79.27536232
臺中市,中區,大墩里,8,482,58.21256039,346,41.78743961,828,9,837,0,1034,80.94777563
臺中市,中區,綠川里,1,371,49.8655914,373,50.1344086,744,12,756,0,947,79.83104541
臺中市,中區,綠川里,2,479,56.7535545,365,43.2464455,844,17,861,0,1025,84
臺中市,中區,公園里,4,720,54.33962264,605,45.66037736,1325,25,1350,0,1710,78.94736842
臺中市,中區,光復里,5,551,53.33978703,482,46.66021297,1033,20,1053,0,1304,80.75153374
臺中市,中區,光復里,6,391,45.20231214,474,54.79768786,865,26,891,0,1156,77.07612457
臺中市,中區,柳川里,9,762,53.3240028,667,46.6759972,1429,40,1469,0,1875,78.34666667
臺中市,中區,大誠里,10,344,52.92307692,306,47.07692308,650,7,657,0,836,78.58851675
臺中市,中區,大誠里,11,491,52.45726496,445,47.54273504,936,16,952,0,1198,79.46577629
臺中市,中區,中華里,12,750,52.59467041,676,47.40532959,1426,39,1465,0,1868,78.4261242
臺中市,東區,新庄里,13,419,55.20421607,340,44.79578393,759,4,763,0,1077,70.84493965
臺中市,東區,新庄里,14,469,52.46085011,425,47.53914989,894,23,917,0,1146,80.01745201
臺中市,東區,新庄里,15,502,54.92341357,412,45.07658643,914,14,928,0,1161,79.93109388
臺中市,東區,振興里,16,529,57.18918919,396,42.81081081,925,13,938,0,1134,82.71604938
臺中市,東區,振興里,17,543,59.3442623,372,40.6557377,915,19,934,0,1166,80.10291595
臺中市,東區,振興里,18,561,63.31828442,325,36.68171558,886,16,902,0,1104,81.70289855
臺中市,東區,東橋里,19,568,61.20689655,360,38.79310345,928,23,951,0,1157,82.19533276
臺中市,東區,東橋里,20,526,59.8407281,353,40.1592719,879,18,897,0,1110,80.81081081
臺中市,東區,東橋里,21,588,67.89838337,278,32.10161663,866,21,887,0,1113,79.69451932
臺中市,東區,東興里,22,590,58.01376598,427,41.98623402,1017,37,1054,0,1311,80.39664378
臺中市,東區,東興里,23,771,57.49440716,570,42.50559284,1341,19,1360,0,1628,83.53808354
臺中市,東區,干城里,26,733,67.00182815,361,32.99817185,1094,21,1115,0,1375,81.09090909
臺中市,東區,干城里,27,391,48.875,409,51.125,800,20,820,0,1082,75.78558226
臺中市,東區,泉源里,24,328,46.59090909,376,53.40909091,704,19,723,0,907,79.71334068
臺中市,東區,泉源里,25,488,60.4708798,319,39.5291202,807,23,830,0,1004,82.66932271
臺中市,東區,旱溪里,28,647,58.60507246,457,41.39492754,1104,30,1134,0,1454,77.99174691
臺中市,東區,旱溪里,29,386,53.09491059,341,46.90508941,727,14,741,0,900,82.33333333
臺中市,東區,樂成里,30,446,62.90550071,263,37.09449929,709,22,731,0,915,79.89071038
臺中市,東區,樂成里,31,463,59.89650712,310,40.10349288,773,16,789,0,979,80.59244127
臺中市,東區,東門里,32,621,64.21923475,346,35.78076525,967,15,982,0,1150,85.39130435
臺中市,東區,東門里,33,674,62.17712177,410,37.82287823,1084,14,1098,0,1335,82.24719101
臺中市,東區,東門里,34,590,68.92523364,266,31.07476636,856,20,876,0,1037,84.47444552
臺中市,東區,東門里,35,606,61.58536585,378,38.41463415,984,18,1002,0,1206,83.08457711
臺中市,東區,十甲里,36,591,55.02793296,483,44.97206704,1074,30,1104,0,1387,79.5962509
臺中市,東區,十甲里,37,682,60.67615658,442,39.32384342,1124,26,1150,0,1357,84.74576271
臺中市,東區,東南里,41,553,46.39261745,639,53.60738255,1192,17,1209,0,1441,83.9000694
臺中市,東區,東南里,42,251,43.65217391,324,56.34782609,575,13,588,0,726,80.99173554
臺中市,東區,東南里,43,486,52.2019334,445,47.7980666,931,11,942,0,1171,80.4440649
臺中市,東區,東勢里,44,609,50.41390728,599,49.58609272,1208,14,1222,0,1529,79.92151733
臺中市,東區,東勢里,45,452,43.00666032,599,56.99333968,1051,26,1077,0,1339,80.43315907
臺中市,東區,合作里,46,465,46.03960396,545,53.96039604,1010,22,1032,0,1268,81.38801262
臺中市,東區,合作里,47,368,35.52123552,668,64.47876448,1036,22,1058,0,1309,80.8250573
臺中市,東區,富臺里,51,236,30.17902813,546,69.82097187,782,19,801,0,987,81.1550152
臺中市,東區,富臺里,52,109,20.03676471,435,79.96323529,544,8,552,0,698,79.08309456
臺中市,東區,富仁里,48,51,5.225409836,925,94.77459016,976,34,1010,0,1198,84.30717863
臺中市,東區,富仁里,49,262,34.70198675,493,65.29801325,755,21,776,0,1015,76.45320197
臺中市,東區,富仁里,50,319,41.80865007,444,58.19134993,763,14,777,0,994,78.16901408
臺中市,東區,東信里,53,600,66.15214994,307,33.84785006,907,22,929,0,1093,84.99542543
臺中市,東區,東信里,54,577,63.40659341,333,36.59340659,910,6,916,0,1104,82.97101449
臺中市,東區,東信里,55,567,55.37109375,457,44.62890625,1024,17,1041,0,1246,83.54735152
臺中市,東區,東信里,56,482,58.07228916,348,41.92771084,830,15,845,0,1015,83.25123153
臺中市,東區,東信里,57,466,63.48773842,268,36.51226158,734,18,752,0,878,85.64920273
臺中市,東區,東英里,38,568,54.82625483,468,45.17374517,1036,23,1059,0,1287,82.28438228
臺中市,東區,東英里,39,501,50.1,499,49.9,1000,17,1017,0,1215,83.7037037
臺中市,東區,東英里,40,698,61.7152962,433,38.2847038,1131,27,1158,0,1426,81.20617111
臺中市,西區,民生里,67,348,37.21925134,587,62.78074866,935,8,943,0,1157,81.50388937
臺中市,西區,民生里,68,376,48.51612903,399,51.48387097,775,13,788,0,947,83.21013728
臺中市,西區,利民里,60,519,34.6,981,65.4,1500,22,1522,1,1952,77.97131148
臺中市,西區,三民里,58,546,36.59517426,946,63.40482574,1492,28,1520,1,2087,72.831816
臺中市,西區,東昇里,65,434,46.91891892,491,53.08108108,925,13,938,0,1128,83.15602837
臺中市,西區,東昇里,66,380,40.86021505,550,59.13978495,930,15,945,0,1146,82.46073298
臺中市,西區,廣民里,64,647,45.91909155,762,54.08090845,1409,26,1435,0,1782,80.52749719
臺中市,西區,平和里,59,603,45.68181818,717,54.31818182,1320,26,1346,0,1766,76.21744054
臺中市,西區,公民里,61,460,44.14587332,582,55.85412668,1042,10,1052,0,1342,78.390462
臺中市,西區,公民里,62,501,48.92578125,523,51.07421875,1024,17,1041,0,1289,80.76027929
臺中市,西區,公民里,63,701,54.8084441,578,45.1915559,1279,23,1302,0,1578,82.5095057
臺中市,西區,藍興里,72,777,53.40206186,678,46.59793814,1455,26,1481,0,1827,81.06185003
臺中市,西區,藍興里,73,527,50,527,50,1054,21,1075,1,1297,82.88357749
臺中市,西區,公館里,74,584,49.91452991,586,50.08547009,1170,23,1193,0,1491,80.01341382
臺中市,西區,公館里,75,735,57.28760717,548,42.71239283,1283,24,1307,0,1552,84.21391753
臺中市,西區,公館里,76,647,50.03866976,646,49.96133024,1293,25,1318,0,1678,78.54588796
臺中市,西區,和龍里,77,427,58.65384615,301,41.34615385,728,21,749,0,943,79.42735949
臺中市,西區,和龍里,78,531,55.95363541,418,44.04636459,949,14,963,0,1227,78.48410758
臺中市,西區,民龍里,79,558,47.85591767,608,52.14408233,1166,31,1197,0,1492,80.22788204
臺中市,西區,民龍里,80,378,48.39948784,403,51.60051216,781,9,790,0,968,81.61157025
臺中市,西區,後龍里,87,592,51.61290323,555,48.38709677,1147,28,1175,0,1480,79.39189189
臺中市,西區,後龍里,88,669,56.31313131,519,43.68686869,1188,13,1201,0,1552,77.38402062
臺中市,西區,安龍里,81,561,52.08913649,516,47.91086351,1077,15,1092,0,1376,79.36046512
臺中市,西區,安龍里,82,492,57.07656613,370,42.92343387,862,19,881,0,1126,78.24156306
臺中市,西區,吉龍里,83,532,50.66666667,518,49.33333333,1050,14,1064,0,1299,81.90916089
臺中市,西區,吉龍里,84,544,46.14079729,635,53.85920271,1179,18,1197,0,1481,80.82376772
臺中市,西區,吉龍里,85,494,43.48591549,642,56.51408451,1136,10,1146,0,1410,81.27659574
臺中市,西區,吉龍里,86,409,43.74331551,526,56.25668449,935,39,974,0,1233,78.99432279
臺中市,西區,昇平里,69,561,50.44964029,551,49.55035971,1112,13,1125,0,1367,82.29700073
臺中市,西區,昇平里,70,749,50.47169811,735,49.52830189,1484,21,1505,0,1817,82.82883875
臺中市,西區,昇平里,71,644,50.03885004,643,49.96114996,1287,24,1311,0,1707,76.80140598
臺中市,西區,忠明里,91,600,48.8997555,627,51.1002445,1227,20,1247,0,1554,80.24453024
臺中市,西區,忠明里,92,603,53.22153575,530,46.77846425,1133,17,1150,0,1410,81.56028369
臺中市,西區,忠明里,93,723,56.44028103,558,43.55971897,1281,8,1289,0,1603,80.41172801
臺中市,西區,公正里,94,666,50.11286682,663,49.88713318,1329,8,1337,0,1645,81.27659574
臺中市,西區,公正里,95,629,45.64586357,749,54.35413643,1378,19,1397,0,1687,82.8097214
臺中市,西區,公正里,96,477,45.90952839,562,54.09047161,1039,14,1053,0,1281,82.20140515
臺中市,西區,土庫里,103,602,53.84615385,516,46.15384615,1118,22,1140,0,1408,80.96590909
臺中市,西區,土庫里,104,632,50.64102564,616,49.35897436,1248,27,1275,0,1597,79.83719474
臺中市,西區,土庫里,105,562,44.63860207,697,55.36139793,1259,22,1281,0,1554,82.43243243
臺中市,西區,忠誠里,106,728,48.63059452,769,51.36940548,1497,24,1521,0,1920,79.21875
臺中市,西區,忠誠里,107,642,49.1954023,663,50.8045977,1305,21,1326,1,1620,81.85185185
臺中市,西區,忠誠里,108,673,52.21101629,616,47.78898371,1289,12,1301,0,1582,82.23767383
臺中市,西區,公益里,101,619,58.45136922,440,41.54863078,1059,21,1080,0,1324,81.57099698
臺中市,西區,公益里,102,573,50.44014085,563,49.55985915,1136,26,1162,0,1407,82.58706468
臺中市,西區,中興里,89,640,52.63157895,576,47.36842105,1216,22,1238,0,1506,82.20451527
臺中市,西區,中興里,90,754,55.11695906,614,44.88304094,1368,30,1398,0,1718,81.37369034
臺中市,西區,公平里,97,728,48.95763282,759,51.04236718,1487,19,1506,0,1849,81.44943213
臺中市,西區,公平里,98,644,45.16129032,782,54.83870968,1426,28,1454,1,1875,77.54666667
臺中市,西區,公德里,99,551,47.21508141,616,52.78491859,1167,23,1190,0,1495,79.59866221
臺中市,西區,公德里,100,652,46.33972992,755,53.66027008,1407,20,1427,0,1765,80.84985836
臺中市,西區,吉龍里,111,588,45.86583463,694,54.13416537,1282,23,1305,0,1627,80.20897357
臺中市,西區,吉龍里,112,434,46.71689989,495,53.28310011,929,17,946,0,1189,79.5626577
臺中市,西區,大忠里,109,351,41.53846154,494,58.46153846,845,9,854,0,1036,82.43243243
臺中市,西區,大忠里,110,778,53.21477428,684,46.78522572,1462,27,1489,0,1810,82.26519337
臺中市,南區,城隍里,117,712,53.37331334,622,46.62668666,1334,23,1357,0,1693,80.15357354
臺中市,南區,城隍里,118,755,54.6705286,626,45.3294714,1381,34,1415,0,1686,83.92645314
臺中市,南區,國光里,119,829,55.48862115,665,44.51137885,1494,32,1526,0,1906,80.06295908
臺中市,南區,國光里,120,750,54.74452555,620,45.25547445,1370,25,1395,0,1669,83.58298382
臺中市,南區,南門里,121,640,52.11726384,588,47.88273616,1228,18,1246,0,1561,79.8206278
臺中市,南區,南門里,122,678,50.37147103,668,49.62852897,1346,19,1365,0,1663,82.08057727
臺中市,南區,德義里,123,467,50.92693566,450,49.07306434,917,16,933,0,1129,82.63950399
臺中市,南區,德義里,124,501,46.34597595,580,53.65402405,1081,20,1101,0,1379,79.8404641
臺中市,南區,積善里,125,461,51.16537181,440,48.83462819,901,21,922,0,1170,78.8034188
臺中市,南區,積善里,126,688,55.39452496,554,44.60547504,1242,24,1266,0,1528,82.85340314
臺中市,南區,江川里,127,610,53.46187555,531,46.53812445,1141,24,1165,0,1407,82.80028429
臺中市,南區,江川里,128,303,48.79227053,318,51.20772947,621,12,633,0,777,81.46718147
臺中市,南區,新榮里,129,597,50.4222973,587,49.5777027,1184,19,1203,0,1675,71.82089552
臺中市,南區,新榮里,130,478,41.74672489,667,58.25327511,1145,11,1156,0,1561,74.05509289
臺中市,南區,福興里,131,777,55.02832861,635,44.97167139,1412,30,1442,0,1769,81.51498021
臺中市,南區,福興里,132,644,47.11046086,723,52.88953914,1367,29,1396,0,1656,84.29951691
臺中市,南區,福平里,133,540,45.45454545,648,54.54545455,1188,28,1216,0,1532,79.37336815
臺中市,南區,福平里,134,640,54.14551607,542,45.85448393,1182,30,1212,0,1482,81.78137652
臺中市,南區,福平里,135,621,57.5,459,42.5,1080,22,1102,0,1353,81.44863267
臺中市,南區,和平里,138,509,57.90671217,370,42.09328783,879,17,896,0,1126,79.57371226
臺中市,南區,和平里,139,427,45.6684492,508,54.3315508,935,14,949,0,1193,79.5473596
臺中市,南區,永興里,145,547,47.35930736,608,52.64069264,1155,25,1180,0,1391,84.83105679
臺中市,南區,永興里,146,547,47.40034662,607,52.59965338,1154,31,1185,0,1491,79.47686117
臺中市,南區,永興里,147,500,42.30118443,682,57.69881557,1182,12,1194,0,1481,80.62120189
臺中市,南區,樹義里,150,654,47.05035971,736,52.94964029,1390,20,1410,0,1768,79.75113122
臺中市,南區,樹義里,151,768,56.3876652,594,43.6123348,1362,20,1382,0,1639,84.31970714
臺中市,南區,樹義里,152,553,42.31063504,754,57.68936496,1307,26,1333,0,1594,83.62609787
臺中市,南區,樹義里,153,638,46.6374269,730,53.3625731,1368,20,1388,1,1741,79.72429638
臺中市,南區,樹德里,156,575,47.95663053,624,52.04336947,1199,26,1225,0,1526,80.27522936
臺中市,南區,樹德里,157,531,39.42093541,816,60.57906459,1347,14,1361,0,1709,79.63721475
臺中市,南區,樹德里,158,606,48.51881505,643,51.48118495,1249,21,1270,0,1607,79.02924704
臺中市,南區,西川里,159,614,49.2776886,632,50.7223114,1246,28,1274,0,1539,82.78102664
臺中市,南區,西川里,160,539,47.07423581,606,52.92576419,1145,16,1161,1,1452,79.95867769
臺中市,南區,長春里,113,400,47.22550177,447,52.77449823,847,19,866,0,1068,81.08614232
臺中市,南區,長春里,114,472,52.50278087,427,47.49721913,899,19,918,0,1170,78.46153846
臺中市,南區,長榮里,115,560,50.67873303,545,49.32126697,1105,16,1121,0,1366,82.06442167
臺中市,南區,長榮里,116,528,53.38725986,461,46.61274014,989,15,1004,0,1180,85.08474576
臺中市,南區,福順里,136,589,42.25251076,805,57.74748924,1394,23,1417,0,1816,78.02863436
臺中市,南區,福順里,137,550,49.86400725,553,50.13599275,1103,32,1135,0,1416,80.15536723
臺中市,南區,平和里,140,719,57.89049919,523,42.10950081,1242,20,1262,0,1526,82.69986894
臺中市,南區,平和里,141,648,54.31684828,545,45.68315172,1193,28,1221,0,1471,83.00475867
臺中市,南區,南和里,142,502,38.88458559,789,61.11541441,1291,21,1312,0,1699,77.22189523
臺中市,南區,南和里,143,448,44.57711443,557,55.42288557,1005,13,1018,0,1223,83.23793949
臺中市,南區,南和里,144,366,43.10954064,483,56.89045936,849,11,860,0,1057,81.36234626
臺中市,南區,永和里,148,667,54.44897959,558,45.55102041,1225,30,1255,0,1589,78.98049087
臺中市,南區,永和里,149,570,48.59335038,603,51.40664962,1173,27,1200,0,1497,80.16032064
臺中市,南區,工學里,154,686,45.70286476,815,54.29713524,1501,16,1517,0,1813,83.67346939
臺中市,南區,工學里,155,729,47.52281617,805,52.47718383,1534,35,1569,0,1930,81.29533679
臺中市,南區,崇倫里,161,703,48.58327574,744,51.41672426,1447,30,1477,1,1825,80.93150685
臺中市,南區,崇倫里,162,699,57.81637717,510,42.18362283,1209,22,1231,0,1475,83.45762712
臺中市,北區,光大里,165,806,56.2849162,626,43.7150838,1432,30,1462,0,1903,76.82606411
臺中市,北區,文莊里,166,352,29.09090909,858,70.90909091,1210,28,1238,0,1531,80.86218158
臺中市,北區,文莊里,167,414,46.36058231,479,53.63941769,893,25,918,0,1167,78.66323907
臺中市,北區,五常里,170,556,55.93561368,438,44.06438632,994,21,1015,0,1311,77.42181541
臺中市,北區,新興里,173,321,35.15881709,592,64.84118291,913,21,934,0,1193,78.29002515
臺中市,北區,新興里,174,270,45.68527919,321,54.31472081,591,12,603,0,807,74.72118959
臺中市,北區,新北里,175,476,48.08080808,514,51.91919192,990,8,998,0,1253,79.64884278
臺中市,北區,新北里,176,358,49.17582418,370,50.82417582,728,13,741,0,1006,73.65805169
臺中市,北區,樂英里,177,120,13.71428571,755,86.28571429,875,11,886,0,1086,81.58379374
臺中市,北區,樂英里,178,110,12.27678571,786,87.72321429,896,21,917,0,1140,80.43859649
臺中市,北區,樂英里,179,172,31.44424132,375,68.55575868,547,21,568,0,744,76.34408602
臺中市,北區,錦村里,180,689,46.8707483,781,53.1292517,1470,28,1498,0,1842,81.32464712
臺中市,北區,錦村里,181,419,45.99341383,492,54.00658617,911,14,925,0,1145,80.7860262
臺中市,北區,建成里,182,674,57.02199662,508,42.97800338,1182,26,1208,0,1463,82.57006152
臺中市,北區,建成里,183,420,41.13614104,601,58.86385896,1021,18,1039,0,1338,77.65321375
臺中市,北區,建成里,184,356,38.94967177,558,61.05032823,914,19,933,0,1218,76.60098522
臺中市,北區,錦洲里,187,456,45.46360917,547,54.53639083,1003,27,1030,0,1310,78.6259542
臺中市,北區,錦洲里,188,447,40.12567325,667,59.87432675,1114,18,1132,0,1382,81.91027496
臺中市,北區,金華里,191,607,44.30656934,763,55.69343066,1370,28,1398,0,1775,78.76056338
臺中市,北區,金龍里,192,388,38.07654563,631,61.92345437,1019,23,1042,0,1358,76.73048601
臺中市,北區,金龍里,193,491,45.21178637,595,54.78821363,1086,21,1107,0,1429,77.46675997
臺中市,北區,金龍里,194,505,46.75925926,575,53.24074074,1080,17,1097,0,1424,77.03651685
臺中市,北區,邱厝里,195,594,46.26168224,690,53.73831776,1284,27,1311,0,1736,75.51843318
臺中市,北區,建興里,196,510,46.66056725,583,53.33943275,1093,23,1116,1,1422,78.48101266
臺中市,北區,建興里,197,466,45.02415459,569,54.97584541,1035,15,1050,0,1320,79.54545455
臺中市,北區,建興里,198,481,49.48559671,491,50.51440329,972,18,990,0,1217,81.34757601
臺中市,北區,建興里,199,424,44.1207076,537,55.8792924,961,15,976,0,1253,77.89305666
臺中市,北區,頂厝里,200,600,45.14672686,729,54.85327314,1329,23,1352,0,1688,80.09478673
臺中市,北區,頂厝里,201,552,43.125,728,56.875,1280,22,1302,0,1635,79.63302752
臺中市,北區,賴厝里,204,573,39.11262799,892,60.88737201,1465,29,1494,0,2271,65.78599736
臺中市,北區,賴厝里,205,395,38.99308983,618,61.00691017,1013,19,1032,0,1347,76.61469933
臺中市,北區,賴村里,216,550,56.00814664,432,43.99185336,982,27,1009,0,1274,79.19937206
臺中市,北區,賴村里,217,475,46.61432777,544,53.38567223,1019,25,1044,0,1355,77.04797048
臺中市,北區,賴村里,218,481,49.69008264,487,50.30991736,968,18,986,0,1218,80.95238095
臺中市,北區,育德里,219,534,45.36958369,643,54.63041631,1177,30,1207,0,1500,80.46666667
臺中市,北區,育德里,220,536,39.61566888,817,60.38433112,1353,34,1387,0,1774,78.1848929
臺中市,北區,淡溝里,221,500,46.25346901,581,53.74653099,1081,23,1104,0,1345,82.08178439
臺中市,北區,淡溝里,222,566,51.9266055,524,48.0733945,1090,26,1116,0,1350,82.66666667
臺中市,北區,淡溝里,223,380,42.64870932,511,57.35129068,891,12,903,0,1115,80.98654709
臺中市,北區,中達里,238,496,52.21052632,454,47.78947368,950,28,978,0,1206,81.09452736
臺中市,北區,中達里,239,503,49.02534113,523,50.97465887,1026,21,1047,0,1263,82.89786223
臺中市,北區,錦祥里,189,451,35.90764331,805,64.09235669,1256,18,1274,1,1666,76.47058824
臺中市,北區,錦祥里,190,413,41.38276553,585,58.61723447,998,22,1020,0,1310,77.86259542
臺中市,北區,健行里,224,770,59.27636644,529,40.72363356,1299,29,1328,1,1600,83
臺中市,北區,健行里,225,443,46.9279661,501,53.0720339,944,26,970,0,1164,83.33333333
臺中市,北區,健行里,226,569,49.05172414,591,50.94827586,1160,28,1188,0,1479,80.32454361
臺中市,北區,健行里,227,510,47.70813845,559,52.29186155,1069,24,1093,0,1422,76.86357243
臺中市,北區,明德里,228,497,53.55603448,431,46.44396552,928,16,944,0,1126,83.8365897
臺中市,北區,明德里,229,566,46.93200663,640,53.06799337,1206,22,1228,0,1487,82.58238063
臺中市,北區,明德里,230,588,43.45898004,765,56.54101996,1353,15,1368,0,1659,82.45931284
臺中市,北區,長青里,233,802,45.33634822,967,54.66365178,1769,26,1795,0,2342,76.64389411
臺中市,北區,長青里,234,533,45.82975064,630,54.17024936,1163,9,1172,0,1458,80.38408779
臺中市,北區,長青里,235,391,42.59259259,527,57.40740741,918,14,932,0,1166,79.93138937
臺中市,北區,賴明里,212,570,40.25423729,846,59.74576271,1416,22,1438,0,1803,79.75596229
臺中市,北區,賴明里,213,522,44.31239389,656,55.68760611,1178,9,1187,0,1454,81.63686382
臺中市,北區,賴興里,208,498,38.45559846,797,61.54440154,1295,30,1325,0,1656,80.01207729
臺中市,北區,賴興里,209,484,43.52517986,628,56.47482014,1112,20,1132,0,1372,82.50728863
臺中市,北區,中正里,163,739,57.10973725,555,42.89026275,1294,23,1317,0,1647,79.96357013
臺中市,北區,六合里,164,787,62.21343874,478,37.78656126,1265,35,1300,0,1687,77.05986959
臺中市,北區,大湖里,168,522,52.35707121,475,47.64292879,997,35,1032,0,1334,77.36131934
臺中市,北區,大湖里,169,434,60.19417476,287,39.80582524,721,22,743,0,922,80.5856833
臺中市,北區,錦平里,171,322,43.22147651,423,56.77852349,745,16,761,0,942,80.78556263
臺中市,北區,錦平里,172,411,60.61946903,267,39.38053097,678,8,686,0,923,74.32286024
臺中市,北區,建德里,185,624,44.38122333,782,55.61877667,1406,23,1429,0,1798,79.47719689
臺中市,北區,建德里,186,547,45.85079631,646,54.14920369,1193,26,1219,1,1519,80.25016458
臺中市,北區,崇德里,202,535,45.60954817,638,54.39045183,1173,37,1210,0,1492,81.09919571
臺中市,北區,崇德里,203,462,45.24975514,559,54.75024486,1021,25,1046,0,1352,77.36686391
臺中市,北區,賴旺里,210,564,43.82284382,723,56.17715618,1287,33,1320,0,1713,77.05779335
臺中市,北區,賴旺里,211,633,43.44543583,824,56.55456417,1457,25,1482,0,1843,80.41237113
臺中市,北區,明新里,231,545,50.65055762,531,49.34944238,1076,20,1096,0,1347,81.36599852
臺中市,北區,明新里,232,403,40.83080041,584,59.16919959,987,16,1003,0,1294,77.51159196
臺中市,北區,立人里,236,454,36.79092382,780,63.20907618,1234,13,1247,0,1555,80.19292605
臺中市,北區,立人里,237,380,35.64727955,686,64.35272045,1066,14,1080,0,1368,78.94736842
臺中市,北區,梅川里,214,377,43.43317972,491,56.56682028,868,20,888,0,1087,81.69273229
臺中市,北區,梅川里,215,379,40.19088017,564,59.80911983,943,16,959,1,1199,79.98331943
臺中市,北區,賴福里,206,295,40.802213,428,59.197787,723,8,731,0,909,80.4180418
臺中市,北區,賴福里,207,572,50.1754386,568,49.8245614,1140,30,1170,0,1482,78.94736842
臺中市,西屯區,西安里,240,611,56.31336406,474,43.68663594,1085,12,1097,0,1298,84.5146379
臺中市,西屯區,西安里,241,494,51.35135135,468,48.64864865,962,18,980,0,1217,80.52588332
臺中市,西屯區,西安里,242,418,43.18181818,550,56.81818182,968,15,983,0,1194,82.32830821
臺中市,西屯區,西墩里,248,891,57.52098128,658,42.47901872,1549,45,1594,0,1877,84.92274907
臺中市,西屯區,西墩里,249,674,49.2330168,695,50.7669832,1369,21,1390,0,1739,79.93099482
臺中市,西屯區,潮洋里,250,516,54.31578947,434,45.68421053,950,19,969,0,1161,83.4625323
臺中市,西屯區,潮洋里,251,478,52.06971678,440,47.93028322,918,10,928,1,1119,82.93118856
臺中市,西屯區,龍潭里,252,557,71.1366539,226,28.8633461,783,6,789,0,944,83.58050847
臺中市,西屯區,惠來里,253,579,40.97664544,834,59.02335456,1413,22,1435,0,1730,82.94797688
臺中市,西屯區,惠來里,254,647,44.40631434,810,55.59368566,1457,17,1474,0,1724,85.49883991
臺中市,西屯區,惠來里,255,468,35.53530752,849,64.46469248,1317,21,1338,0,1653,80.94373866
臺中市,西屯區,上石里,256,537,41.1809816,767,58.8190184,1304,27,1331,1,1643,81.01034693
臺中市,西屯區,上石里,257,442,36.14063778,781,63.85936222,1223,27,1250,0,1605,77.88161994
臺中市,西屯區,逢甲里,262,436,42.2071636,597,57.7928364,1033,19,1052,0,1340,78.50746269
臺中市,西屯區,逢甲里,263,479,45.57564225,572,54.42435775,1051,13,1064,0,1313,81.03579589
臺中市,西屯區,逢甲里,264,433,45.82010582,512,54.17989418,945,22,967,0,1202,80.44925125
臺中市,西屯區,何安里,277,566,53.39622642,494,46.60377358,1060,19,1079,0,1672,64.53349282
臺中市,西屯區,何安里,278,526,51.66994106,492,48.33005894,1018,19,1037,0,1272,81.52515723
臺中市,西屯區,何安里,279,508,49.90176817,510,50.09823183,1018,19,1037,0,1284,80.76323988
臺中市,西屯區,何厝里,268,490,43.59430605,634,56.40569395,1124,10,1134,0,1454,77.99174691
臺中市,西屯區,何厝里,269,499,54.53551913,416,45.46448087,915,26,941,0,1140,82.54385965
臺中市,西屯區,大河里,291,795,59.41704036,543,40.58295964,1338,30,1368,0,1685,81.18694362
臺中市,西屯區,大河里,292,664,49.44154877,679,50.55845123,1343,28,1371,0,1655,82.83987915
臺中市,西屯區,大石里,293,112,14.08805031,683,85.91194969,795,30,825,0,986,83.67139959
臺中市,西屯區,大福里,294,512,47.58364312,564,52.41635688,1076,22,1098,0,1343,81.75725987
臺中市,西屯區,大福里,295,468,44.1509434,592,55.8490566,1060,24,1084,0,1367,79.29773226
臺中市,西屯區,大鵬里,296,489,47.01923077,551,52.98076923,1040,21,1061,0,1261,84.13957177
臺中市,西屯區,大鵬里,297,421,39.90521327,634,60.09478673,1055,9,1064,0,1321,80.54504164
臺中市,西屯區,大鵬里,298,380,34.63992707,717,65.36007293,1097,21,1118,0,1390,80.43165468
臺中市,西屯區,港尾里,299,640,71.26948775,258,28.73051225,898,29,927,0,1122,82.62032086
臺中市,西屯區,港尾里,300,533,47.12643678,598,52.87356322,1131,28,1159,0,1357,85.40899042
臺中市,西屯區,港尾里,301,531,43.59605911,687,56.40394089,1218,23,1241,2,1511,82.13103905
臺中市,西屯區,港尾里,302,22,3.514376997,604,96.485623,626,15,641,0,763,84.01048493
臺中市,西屯區,廣福里,303,505,57.71428571,370,42.28571429,875,8,883,0,1062,83.14500942
臺中市,西屯區,廣福里,304,588,65.99326599,303,34.00673401,891,28,919,0,1085,84.70046083
臺中市,西屯區,林厝里,305,507,60.21377672,335,39.78622328,842,37,879,0,1124,78.20284698
臺中市,西屯區,林厝里,306,561,48.6135182,593,51.3864818,1154,43,1197,0,1475,81.15254237
臺中市,西屯區,永安里,307,645,63.79821958,366,36.20178042,1011,45,1056,0,1314,80.3652968
臺中市,西屯區,永安里,308,572,49.3955095,586,50.6044905,1158,31,1189,0,1449,82.05659075
臺中市,西屯區,永安里,309,436,39.06810036,680,60.93189964,1116,21,1137,0,1463,77.71701982
臺中市,西屯區,永安里,310,404,41.86528497,561,58.13471503,965,11,976,0,1223,79.80376124
臺中市,西屯區,福安里,311,746,49.07894737,774,50.92105263,1520,18,1538,0,1916,80.27139875
臺中市,西屯區,協和里,326,527,59.8183882,354,40.1816118,881,30,911,0,1124,81.04982206
臺中市,西屯區,協和里,327,434,67.49611198,209,32.50388802,643,15,658,0,808,81.43564356
臺中市,西屯區,協和里,328,462,47.2392638,516,52.7607362,978,11,989,0,1222,80.93289689
臺中市,西屯區,何仁里,280,634,47.8490566,691,52.1509434,1325,16,1341,0,1663,80.63740229
臺中市,西屯區,何仁里,281,616,50.82508251,596,49.17491749,1212,12,1224,0,1529,80.05232178
臺中市,西屯區,何仁里,282,626,48.5647789,663,51.4352211,1289,26,1315,0,1676,78.46062053
臺中市,西屯區,何德里,283,572,46.42857143,660,53.57142857,1232,15,1247,0,1513,82.41903503
臺中市,西屯區,何德里,284,491,42.69565217,659,57.30434783,1150,17,1167,1,1414,82.53182461
臺中市,西屯區,何源里,288,589,48.51729819,625,51.48270181,1214,17,1231,0,1520,80.98684211
臺中市,西屯區,何源里,289,594,45.27439024,718,54.72560976,1312,12,1324,0,1630,81.22699387
臺中市,西屯區,何源里,290,509,37.01818182,866,62.98181818,1375,21,1396,0,1733,80.55395268
臺中市,西屯區,西平里,245,456,34.38914027,870,65.61085973,1326,22,1348,1,1642,82.09500609
臺中市,西屯區,西平里,246,531,45.22998296,643,54.77001704,1174,17,1191,0,1525,78.09836066
臺中市,西屯區,西平里,247,275,21.17013087,1024,78.82986913,1299,18,1317,0,1555,84.69453376
臺中市,西屯區,何南里,272,566,42.42878561,768,57.57121439,1334,21,1355,0,1644,82.42092457
臺中市,西屯區,何南里,273,582,42.88872513,775,57.11127487,1357,24,1381,0,1693,81.57117543
臺中市,西屯區,至善里,243,494,41.89991518,685,58.10008482,1179,9,1188,1,1484,80.05390836
臺中市,西屯區,至善里,244,489,43.35106383,639,56.64893617,1128,12,1140,0,1427,79.88787666
臺中市,西屯區,上安里,258,467,45.87426326,551,54.12573674,1018,9,1027,1,1289,79.67416602
臺中市,西屯區,上安里,259,507,42.2852377,692,57.7147623,1199,13,1212,0,1471,82.39292998
臺中市,西屯區,上德里,260,612,44.90095378,751,55.09904622,1363,25,1388,0,1682,82.52080856
臺中市,西屯區,上德里,261,622,40.60052219,910,59.39947781,1532,20,1552,0,1880,82.55319149
臺中市,西屯區,逢福里,265,471,49.16492693,487,50.83507307,958,23,981,0,1209,81.14143921
臺中市,西屯區,逢福里,266,406,33.94648829,790,66.05351171,1196,18,1214,0,1466,82.81036835
臺中市,西屯區,逢福里,267,477,41.37033825,676,58.62966175,1153,37,1190,0,1445,82.35294118
臺中市,西屯區,何明里,270,648,50.54602184,634,49.45397816,1282,17,1299,0,1622,80.08631319
臺中市,西屯區,何明里,271,581,47.19740049,650,52.80259951,1231,20,1251,0,1539,81.28654971
臺中市,西屯區,何成里,274,611,50.24671053,605,49.75328947,1216,21,1237,0,1532,80.74412533
臺中市,西屯區,何成里,275,656,43.82097528,841,56.17902472,1497,25,1522,0,1925,79.06493506
臺中市,西屯區,何成里,276,655,42.09511568,901,57.90488432,1556,29,1585,0,1925,82.33766234
臺中市,西屯區,何福里,285,413,44.40860215,517,55.59139785,930,9,939,0,1163,80.7394669
臺中市,西屯區,何福里,286,506,50.24826216,501,49.75173784,1007,17,1024,0,1231,83.18440292
臺中市,西屯區,何福里,287,458,48.93162393,478,51.06837607,936,17,953,0,1167,81.66238218
臺中市,西屯區,福和里,320,657,56.15384615,513,43.84615385,1170,39,1209,0,1484,81.4690027
臺中市,西屯區,福和里,321,759,58.11638591,547,41.88361409,1306,25,1331,0,1576,84.45431472
臺中市,西屯區,福中里,322,401,42.97963558,532,57.02036442,933,12,945,0,1119,84.45040214
臺中市,西屯區,福中里,323,429,47.14285714,481,52.85714286,910,7,917,0,1156,79.32525952
臺中市,西屯區,福恩里,324,508,40.90177134,734,59.09822866,1242,17,1259,0,1563,80.55022393
臺中市,西屯區,福恩里,325,531,43.92059553,678,56.07940447,1209,8,1217,0,1575,77.26984127
臺中市,西屯區,福聯里,319,553,42.34303216,753,57.65696784,1306,22,1328,0,1765,75.2407932
臺中市,西屯區,福瑞里,317,281,34.95024876,523,65.04975124,804,15,819,0,1052,77.85171103
臺中市,西屯區,福瑞里,318,260,31.36308806,569,68.63691194,829,17,846,0,1056,80.11363636
臺中市,西屯區,福林里,314,411,39.74854932,623,60.25145068,1034,21,1055,0,1290,81.78294574
臺中市,西屯區,福林里,315,378,37.57455268,628,62.42544732,1006,10,1016,0,1244,81.67202572
臺中市,西屯區,福林里,316,406,39.41747573,624,60.58252427,1030,21,1051,0,1289,81.53607448
臺中市,西屯區,福雅里,312,650,43.6827957,838,56.3172043,1488,24,1512,0,1816,83.25991189
臺中市,西屯區,福雅里,313,554,40.3202329,820,59.6797671,1374,19,1393,0,1750,79.6
臺中市,南屯區,南屯里,329,584,60.39296794,383,39.60703206,967,18,985,0,1163,84.69475494
臺中市,南屯區,南屯里,330,606,60.35856574,398,39.64143426,1004,13,1017,0,1214,83.77265239
臺中市,南屯區,南屯里,331,507,50.04935834,506,49.95064166,1013,22,1035,0,1252,82.66773163
臺中市,南屯區,南屯里,332,441,41.1380597,631,58.8619403,1072,23,1095,0,1315,83.26996198
臺中市,南屯區,豐樂里,333,633,46.47577093,729,53.52422907,1362,26,1388,0,1625,85.41538462
臺中市,南屯區,豐樂里,334,736,55.37998495,593,44.62001505,1329,33,1362,0,1577,86.36651871
臺中市,南屯區,豐樂里,335,676,54.29718876,569,45.70281124,1245,24,1269,0,1513,83.8730998
臺中市,南屯區,豐樂里,336,682,59.45945946,465,40.54054054,1147,23,1170,0,1630,71.7791411
臺中市,南屯區,楓樹里,337,626,57.80240074,457,42.19759926,1083,24,1107,0,1313,84.31073877
臺中市,南屯區,楓樹里,338,658,58.02469136,476,41.97530864,1134,39,1173,0,1396,84.02578797
臺中市,南屯區,楓樹里,339,567,51.87557182,526,48.12442818,1093,28,1121,0,1322,84.79576399
臺中市,南屯區,中和里,340,609,57.77988615,445,42.22011385,1054,28,1082,0,1336,80.98802395
臺中市,南屯區,中和里,341,598,52.22707424,547,47.77292576,1145,20,1165,0,1366,85.28550512
臺中市,南屯區,中和里,342,550,57.8338591,401,42.1661409,951,31,982,0,1141,86.06485539
臺中市,南屯區,春社里,347,548,48.40989399,584,51.59010601,1132,29,1161,0,1397,83.10665712
臺中市,南屯區,春社里,348,430,48.20627803,462,51.79372197,892,22,914,0,1123,81.38913624
臺中市,南屯區,春社里,349,400,37.38317757,670,62.61682243,1070,45,1115,0,1325,84.1509434
臺中市,南屯區,春社里,350,171,29.28082192,413,70.71917808,584,12,596,0,763,78.11271298
臺中市,南屯區,春安里,351,26,2.751322751,919,97.24867725,945,32,977,1,1179,82.8668363
臺中市,南屯區,春安里,352,175,17.07317073,850,82.92682927,1025,37,1062,0,1298,81.81818182
臺中市,南屯區,文山里,353,660,49.77375566,666,50.22624434,1326,24,1350,0,1628,82.92383292
臺中市,南屯區,文山里,354,533,43.58135732,690,56.41864268,1223,18,1241,0,1568,79.14540816
臺中市,南屯區,文山里,355,659,52.59377494,594,47.40622506,1253,28,1281,1,1579,81.12729576
臺中市,南屯區,新生里,358,717,69.14175506,320,30.85824494,1037,30,1067,0,1279,83.42455043
臺中市,南屯區,永定里,345,683,54.99194847,559,45.00805153,1242,33,1275,0,1583,80.54327227
臺中市,南屯區,永定里,346,772,60.73957514,499,39.26042486,1271,35,1306,0,1594,81.93224592
臺中市,南屯區,三厝里,365,617,48.27856025,661,51.72143975,1278,19,1297,0,1553,83.51577592
臺中市,南屯區,三厝里,366,553,48.50877193,587,51.49122807,1140,19,1159,0,1374,84.35225619
臺中市,南屯區,三厝里,367,491,43.45132743,639,56.54867257,1130,19,1149,0,1385,82.96028881
臺中市,南屯區,溝墘里,391,579,44.57274827,720,55.42725173,1299,29,1328,0,1626,81.67281673
臺中市,南屯區,溝墘里,392,733,48.19197896,788,51.80802104,1521,21,1542,0,1821,84.67874794
臺中市,南屯區,田心里,373,613,49.11858974,635,50.88141026,1248,14,1262,0,1484,85.04043127
臺中市,南屯區,田心里,374,528,54.376931,443,45.623069,971,19,990,0,1208,81.95364238
臺中市,南屯區,田心里,375,545,50.69767442,530,49.30232558,1075,21,1096,0,1355,80.88560886
臺中市,南屯區,黎明里,368,382,33.68606702,752,66.31393298,1134,7,1141,0,1359,83.95879323
臺中市,南屯區,黎明里,369,397,37.99043062,648,62.00956938,1045,12,1057,0,1281,82.5136612
臺中市,南屯區,黎明里,370,429,39.94413408,645,60.05586592,1074,20,1094,0,1339,81.70276326
臺中市,南屯區,鎮平里,343,327,65.26946108,174,34.73053892,501,6,507,0,599,84.64106845
臺中市,南屯區,鎮平里,344,501,66.35761589,254,33.64238411,755,25,780,0,933,83.60128617
臺中市,南屯區,大同里,383,451,46.11451943,527,53.88548057,978,3,981,0,1194,82.16080402
臺中市,南屯區,大同里,384,476,49.37759336,488,50.62240664,964,8,972,1,1161,83.72093023
臺中市,南屯區,大同里,385,552,53.43659245,481,46.56340755,1033,23,1056,0,1268,83.2807571
臺中市,南屯區,文心里,371,455,43.29210276,596,56.70789724,1051,12,1063,0,1309,81.20702827
臺中市,南屯區,文心里,372,509,48.89529299,532,51.10470701,1041,19,1060,0,1320,80.3030303
臺中市,南屯區,同心里,378,398,36.92022263,680,63.07977737,1078,17,1095,0,1396,78.43839542
臺中市,南屯區,同心里,379,457,45.65434565,544,54.34565435,1001,11,1012,0,1211,83.56729975
臺中市,南屯區,同心里,380,484,49.69199179,490,50.30800821,974,17,991,0,1209,81.96856907
臺中市,南屯區,向心里,376,570,50.13192612,567,49.86807388,1137,23,1160,0,1420,81.69014085
臺中市,南屯區,向心里,377,446,44.95967742,546,55.04032258,992,11,1003,0,1213,82.68755153
臺中市,南屯區,大誠里,386,361,42.32121923,492,57.67878077,853,12,865,0,1060,81.60377358
臺中市,南屯區,大誠里,387,464,45.26829268,561,54.73170732,1025,20,1045,0,1305,80.07662835
臺中市,南屯區,大興里,381,632,47.87878788,688,52.12121212,1320,23,1343,0,1627,82.54456054
臺中市,南屯區,大興里,382,609,49.67373573,617,50.32626427,1226,21,1247,0,1530,81.50326797
臺中市,南屯區,大業里,388,543,40.95022624,783,59.04977376,1326,16,1342,0,1612,83.25062035
臺中市,南屯區,大業里,389,526,42.69480519,706,57.30519481,1232,18,1250,0,1513,82.61731659
臺中市,南屯區,大業里,390,589,46.30503145,683,53.69496855,1272,26,1298,0,1626,79.82779828
臺中市,南屯區,惠中里,393,522,45.35186794,629,54.64813206,1151,11,1162,0,1363,85.25311812
臺中市,南屯區,惠中里,394,474,41.0745234,680,58.9254766,1154,15,1169,0,1433,81.57711096
臺中市,南屯區,惠中里,395,505,41.73553719,705,58.26446281,1210,13,1223,0,1487,82.24613315
臺中市,南屯區,寶山里,356,737,57.94025157,535,42.05974843,1272,14,1286,0,1565,82.17252396
臺中市,南屯區,寶山里,357,503,42.99145299,667,57.00854701,1170,21,1191,0,1475,80.74576271
臺中市,南屯區,三和里,362,436,36.88663283,746,63.11336717,1182,17,1199,0,1478,81.12313938
臺中市,南屯區,三和里,363,532,42.42424242,722,57.57575758,1254,11,1265,0,1491,84.84238766
臺中市,南屯區,三和里,364,419,35.96566524,746,64.03433476,1165,19,1184,0,1403,84.39059159
臺中市,南屯區,三義里,359,451,43.87159533,577,56.12840467,1028,18,1046,1,1256,83.28025478
臺中市,南屯區,三義里,360,416,34.69557965,783,65.30442035,1199,13,1212,0,1492,81.23324397
臺中市,南屯區,三義里,361,422,37.88150808,692,62.11849192,1114,15,1129,0,1330,84.88721805
臺中市,北屯區,北興里,400,621,49.75961538,627,50.24038462,1248,28,1276,0,1548,82.42894057
臺中市,北屯區,北興里,401,504,40.063593,754,59.936407,1258,29,1287,0,1589,80.99433606
臺中市,北屯區,北屯里,396,399,35.8490566,714,64.1509434,1113,13,1126,0,1398,80.54363376
臺中市,北屯區,北屯里,397,584,45.58938329,697,54.41061671,1281,16,1297,1,1629,79.6193984
臺中市,北屯區,三光里,402,596,46.81853888,677,53.18146112,1273,18,1291,0,1614,79.98760843
臺中市,北屯區,三光里,403,528,50.7204611,513,49.2795389,1041,19,1060,0,1297,81.72706245
臺中市,北屯區,三光里,404,391,42.68558952,525,57.31441048,916,12,928,0,1158,80.13816926
臺中市,北屯區,三光里,405,473,40.01692047,709,59.98307953,1182,25,1207,0,1477,81.7197021
臺中市,北屯區,平田里,412,631,46.5339233,725,53.4660767,1356,24,1380,0,1694,81.46399055
臺中市,北屯區,平田里,413,468,40.7310705,681,59.2689295,1149,18,1167,0,1447,80.6496199
臺中市,北屯區,平田里,414,408,43.54322305,529,56.45677695,937,14,951,0,1174,81.00511073
臺中市,北屯區,平和里,422,554,39.57142857,846,60.42857143,1400,21,1421,0,1799,78.98832685
臺中市,北屯區,平和里,423,526,40.5238829,772,59.4761171,1298,22,1320,0,1657,79.66203983
臺中市,北屯區,東光里,435,436,54.77386935,360,45.22613065,796,24,820,0,1010,81.18811881
臺中市,北屯區,東光里,436,558,49.91055456,560,50.08944544,1118,21,1139,1,1504,75.73138298
臺中市,北屯區,東光里,437,476,49.6868476,482,50.3131524,958,24,982,0,1226,80.09787928
臺中市,北屯區,舊社里,438,875,72.07578254,339,27.92421746,1214,41,1255,0,1464,85.72404372
臺中市,北屯區,舊社里,439,481,46.38379942,556,53.61620058,1037,19,1056,0,1285,82.17898833
臺中市,北屯區,舊社里,440,553,55.07968127,451,44.92031873,1004,20,1024,0,1237,82.78092158
臺中市,北屯區,舊社里,441,409,44.21621622,516,55.78378378,925,21,946,0,1120,84.46428571
臺中市,北屯區,水景里,442,801,61.94895592,492,38.05104408,1293,27,1320,0,1589,83.07111391
臺中市,北屯區,水景里,443,526,48.61367837,556,51.38632163,1082,24,1106,0,1345,82.23048327
臺中市,北屯區,水景里,444,668,53.6977492,576,46.3022508,1244,19,1263,0,1519,83.14680711
臺中市,北屯區,水景里,445,522,49.33837429,536,50.66162571,1058,28,1086,0,1356,80.08849558
臺中市,北屯區,軍功里,446,775,57.36491488,576,42.63508512,1351,27,1378,0,1610,85.59006211
臺中市,北屯區,軍功里,447,633,68.65509761,289,31.34490239,922,53,975,0,1197,81.45363409
臺中市,北屯區,軍功里,448,475,59.375,325,40.625,800,26,826,0,1002,82.43512974
臺中市,北屯區,軍功里,449,359,40.79545455,521,59.20454545,880,21,901,0,1108,81.31768953
臺中市,北屯區,軍功里,450,525,49.76303318,530,50.23696682,1055,29,1084,0,1323,81.93499622
臺中市,北屯區,和平里,451,785,60.99456099,502,39.00543901,1287,29,1316,0,1574,83.60864041
臺中市,北屯區,和平里,452,730,56.63304888,559,43.36695112,1289,27,1316,0,1581,83.23845667
臺中市,北屯區,和平里,453,664,54.83071841,547,45.16928159,1211,25,1236,0,1517,81.47659855
臺中市,北屯區,東山里,454,870,67.23338485,424,32.76661515,1294,33,1327,0,1563,84.90083173
臺中市,北屯區,民政里,457,403,57.489301,298,42.510699,701,22,723,0,903,80.06644518
臺中市,北屯區,部子里,455,325,55.55555556,260,44.44444444,585,19,604,0,757,79.78863937
臺中市,北屯區,部子里,456,453,63.17991632,264,36.82008368,717,14,731,0,888,82.31981982
臺中市,北屯區,大坑里,459,766,57.24962631,572,42.75037369,1338,38,1376,0,1696,81.13207547
臺中市,北屯區,民德里,458,411,62.8440367,243,37.1559633,654,4,658,0,799,82.35294118
臺中市,北屯區,松竹里,460,512,36.91420332,875,63.08579668,1387,22,1409,2,1692,83.27423168
臺中市,北屯區,松竹里,461,584,44.58015267,726,55.41984733,1310,22,1332,0,1653,80.58076225
臺中市,北屯區,松竹里,462,622,44.0509915,790,55.9490085,1412,14,1426,0,1746,81.67239404
臺中市,北屯區,仁和里,477,707,57.6202119,520,42.3797881,1227,14,1241,0,1465,84.70989761
臺中市,北屯區,仁和里,478,597,43.19826339,785,56.80173661,1382,28,1410,0,2076,67.91907514
臺中市,北屯區,仁和里,479,437,47.19222462,489,52.80777538,926,17,943,0,1142,82.57443082
臺中市,北屯區,仁美里,480,405,60.71964018,262,39.28035982,667,5,672,0,802,83.79052369
臺中市,北屯區,仁美里,481,589,48.55729596,624,51.44270404,1213,23,1236,0,1474,83.85345997
臺中市,北屯區,仁美里,482,742,59.64630225,502,40.35369775,1244,23,1267,1,1499,84.52301534
臺中市,北屯區,仁美里,483,44,6.606606607,622,93.39339339,666,13,679,0,812,83.62068966
臺中市,北屯區,仁美里,484,75,12.75510204,513,87.24489796,588,20,608,0,723,84.09405256
臺中市,北屯區,四民里,485,641,54.27603726,540,45.72396274,1181,28,1209,0,1460,82.80821918
臺中市,北屯區,四民里,486,25,5.66893424,416,94.33106576,441,16,457,0,545,83.85321101
臺中市,北屯區,后庄里,490,513,40.87649402,742,59.12350598,1255,26,1281,0,1557,82.27360308
臺中市,北屯區,后庄里,491,620,42.09097081,853,57.90902919,1473,30,1503,0,1768,85.01131222
臺中市,北屯區,后庄里,492,564,39.46815955,865,60.53184045,1429,22,1451,0,1759,82.49005117
臺中市,北屯區,后庄里,493,358,33.2096475,720,66.7903525,1078,14,1092,0,1365,80
臺中市,北屯區,同榮里,487,887,59.73063973,598,40.26936027,1485,45,1530,0,1834,83.42420938
臺中市,北屯區,同榮里,488,404,27.65229295,1057,72.34770705,1461,32,1493,0,1797,83.08291597
臺中市,北屯區,同榮里,489,565,36.85583823,968,63.14416177,1533,17,1550,1,1880,82.44680851
臺中市,北屯區,仁愛里,502,75,11.0619469,603,88.9380531,678,14,692,0,842,82.18527316
臺中市,北屯區,仁愛里,503,352,46.13368283,411,53.86631717,763,18,781,0,971,80.43254377
臺中市,北屯區,水湳里,504,608,50.54031588,595,49.45968412,1203,34,1237,0,1554,79.6010296
臺中市,北屯區,水湳里,505,420,44.7284345,519,55.2715655,939,21,960,0,1169,82.12147134
臺中市,北屯區,水湳里,506,572,44.30673896,719,55.69326104,1291,20,1311,0,1622,80.82614057
臺中市,北屯區,水湳里,507,573,44.07692308,727,55.92307692,1300,34,1334,0,1615,82.6006192
臺中市,北屯區,陳平里,424,532,45.74376612,631,54.25623388,1163,24,1187,0,1450,81.86206897
臺中市,北屯區,陳平里,425,571,40.35335689,844,59.64664311,1415,25,1440,0,1792,80.35714286
臺中市,北屯區,新平里,499,545,39.29343908,842,60.70656092,1387,32,1419,0,1786,79.45128779
臺中市,北屯區,新平里,500,376,35.30516432,689,64.69483568,1065,35,1100,0,1319,83.39651251
臺中市,北屯區,新平里,501,391,37.52399232,651,62.47600768,1042,26,1068,0,1346,79.346211
臺中市,北屯區,平安里,419,497,46.3619403,575,53.6380597,1072,24,1096,1,1320,83.03030303
臺中市,北屯區,平安里,420,554,52.51184834,501,47.48815166,1055,21,1076,0,1369,78.59751644
臺中市,北屯區,平安里,421,603,47.66798419,662,52.33201581,1265,21,1286,0,1639,78.46247712
臺中市,北屯區,平順里,426,299,37.18905473,505,62.81094527,804,7,811,0,1014,79.98027613
臺中市,北屯區,平順里,427,513,48.03370787,555,51.96629213,1068,15,1083,0,1287,84.14918415
臺中市,北屯區,平德里,432,497,47.28829686,554,52.71170314,1051,15,1066,0,1351,78.90451517
臺中市,北屯區,平德里,433,526,42.5222312,711,57.4777688,1237,23,1260,0,1579,79.79734009
臺中市,北屯區,平德里,434,610,48.37430611,651,51.62569389,1261,10,1271,0,1550,82
臺中市,北屯區,松安里,467,573,52.8597786,511,47.1402214,1084,10,1094,0,1310,83.51145038
臺中市,北屯區,松安里,468,439,42.78752437,587,57.21247563,1026,21,1047,0,1318,79.43854325
臺中市,北屯區,松安里,469,416,45.61403509,496,54.38596491,912,9,921,0,1128,81.64893617
臺中市,北屯區,松茂里,474,366,35.43078412,667,64.56921588,1033,7,1040,0,1294,80.37094281
臺中市,北屯區,松茂里,475,430,38.53046595,686,61.46953405,1116,13,1129,0,1360,83.01470588
臺中市,北屯區,松茂里,476,443,42.76061776,593,57.23938224,1036,23,1059,0,1325,79.9245283
臺中市,北屯區,大德里,496,374,37.89260385,613,62.10739615,987,10,997,0,1200,83.08333333
臺中市,北屯區,大德里,497,506,37.67684289,837,62.32315711,1343,24,1367,0,1649,82.8987265
臺中市,北屯區,大德里,498,436,40.7857811,633,59.2142189,1069,17,1086,0,1323,82.0861678
臺中市,北屯區,松強里,470,594,45.83333333,702,54.16666667,1296,29,1325,0,1713,77.34967893
臺中市,北屯區,松強里,471,705,45.10556622,858,54.89443378,1563,15,1578,0,1920,82.1875
臺中市,北屯區,松勇里,472,653,45.31575295,788,54.68424705,1441,46,1487,2,1784,83.35201794
臺中市,北屯區,松勇里,473,671,44,854,56,1525,36,1561,1,1908,81.81341719
臺中市,北屯區,北京里,398,656,48.05860806,709,51.94139194,1365,24,1389,0,1692,82.09219858
臺中市,北屯區,北京里,399,575,48.19782062,618,51.80217938,1193,6,1199,0,1512,79.2989418
臺中市,北屯區,平心里,428,585,44.01805869,744,55.98194131,1329,21,1350,1,1694,79.69303424
臺中市,北屯區,平心里,429,546,45.01236603,667,54.98763397,1213,16,1229,0,1570,78.28025478
臺中市,北屯區,平福里,430,545,44.38110749,683,55.61889251,1228,20,1248,0,1499,83.25550367
臺中市,北屯區,平福里,431,276,34.67336683,520,65.32663317,796,8,804,0,1005,80
臺中市,北屯區,松和里,463,444,46.73684211,506,53.26315789,950,25,975,0,1191,81.86397985
臺中市,北屯區,松和里,464,469,46.20689655,546,53.79310345,1015,15,1030,0,1316,78.2674772
臺中市,北屯區,松和里,465,357,42.34875445,486,57.65124555,843,7,850,0,1041,81.65225744
臺中市,北屯區,松和里,466,531,46.53812445,610,53.46187555,1141,17,1158,1,1484,78.03234501
臺中市,北屯區,平陽里,417,500,40.22526146,743,59.77473854,1243,22,1265,0,1584,79.86111111
臺中市,北屯區,平陽里,418,669,44.68937876,828,55.31062124,1497,24,1521,0,1895,80.26385224
臺中市,北屯區,平興里,409,532,57.08154506,400,42.91845494,932,14,946,0,1149,82.33246301
臺中市,北屯區,平興里,410,335,38.41743119,537,61.58256881,872,13,885,0,1146,77.22513089
臺中市,北屯區,平興里,411,552,38.70967742,874,61.29032258,1426,26,1452,0,1849,78.52893456
臺中市,北屯區,平昌里,415,622,46.2797619,722,53.7202381,1344,18,1362,0,1720,79.18604651
臺中市,北屯區,平昌里,416,623,41.75603217,869,58.24396783,1492,34,1526,0,1902,80.23133544
臺中市,北屯區,三和里,406,665,46.05263158,779,53.94736842,1444,18,1462,0,1800,81.22222222
臺中市,北屯區,三和里,407,489,42.97012302,649,57.02987698,1138,17,1155,0,1451,79.60027567
臺中市,北屯區,三和里,408,508,43.71772806,654,56.28227194,1162,20,1182,0,1484,79.64959569
臺中市,北屯區,忠平里,494,471,38.48039216,753,61.51960784,1224,27,1251,0,1533,81.60469667
臺中市,北屯區,忠平里,495,475,37.37214792,796,62.62785208,1271,14,1285,0,1579,81.38062065
嘉義市,東區,荖藤里,88,508,69.02173913,228,30.97826087,736,18,754,0,910,82.85714286
嘉義市,東區,荖藤里,89,399,71.37745975,160,28.62254025,559,24,583,0,709,82.22849083
嘉義市,東區,荖藤里,90,377,47.72151899,413,52.27848101,790,8,798,0,1029,77.55102041
嘉義市,東區,後湖里,86,679,52.88161994,605,47.11838006,1284,21,1305,0,1647,79.23497268
嘉義市,東區,後湖里,87,664,59.98193315,443,40.01806685,1107,15,1122,0,1411,79.51807229
嘉義市,東區,仁義里,84,485,49.84583762,488,50.15416238,973,17,990,0,1190,83.19327731
嘉義市,東區,仁義里,85,421,54.53367876,351,45.46632124,772,19,791,0,993,79.65760322
嘉義市,東區,中庄里,82,566,51.54826958,532,48.45173042,1098,20,1118,0,1452,76.99724518
嘉義市,東區,中庄里,83,506,49.90138067,508,50.09861933,1014,20,1034,0,1282,80.65522621
嘉義市,東區,頂庄里,91,525,54.34782609,441,45.65217391,966,22,988,0,1251,78.97681855
嘉義市,東區,頂庄里,92,558,49.82142857,562,50.17857143,1120,16,1136,0,1418,80.11283498
嘉義市,東區,頂庄里,93,449,57.86082474,327,42.13917526,776,8,784,0,970,80.82474227
嘉義市,東區,頂庄里,94,491,50.10204082,489,49.89795918,980,16,996,0,1197,83.20802005
嘉義市,東區,仁和里,81,260,67.35751295,126,32.64248705,386,7,393,0,488,80.53278689
嘉義市,東區,社口里,80,464,67.44186047,224,32.55813953,688,8,696,0,861,80.83623693
嘉義市,東區,檜村里,78,308,46.80851064,350,53.19148936,658,6,664,0,828,80.19323671
嘉義市,東區,檜村里,79,246,47.39884393,273,52.60115607,519,9,528,0,649,81.3559322
嘉義市,東區,泰安里,77,436,52.27817746,398,47.72182254,834,19,853,0,1069,79.79420019
嘉義市,東區,仁武里,76,278,56.27530364,216,43.72469636,494,11,505,0,636,79.40251572
嘉義市,東區,北城里,75,444,64.06926407,249,35.93073593,693,8,701,0,877,79.93158495
嘉義市,東區,建國里,38,324,67.21991701,158,32.78008299,482,6,488,0,613,79.60848287
嘉義市,東區,初陽里,49,625,60.03842459,416,39.96157541,1041,12,1053,0,1295,81.31274131
嘉義市,東區,震安里,50,304,49.67320261,308,50.32679739,612,13,625,0,784,79.71938776
嘉義市,東區,府路里,39,506,60.96385542,324,39.03614458,830,17,847,0,1036,81.75675676
嘉義市,東區,雲霄里,36,286,56.07843137,224,43.92156863,510,6,516,0,637,81.00470958
嘉義市,東區,雲霄里,37,282,53.40909091,246,46.59090909,528,7,535,0,663,80.69381599
嘉義市,東區,內安里,35,182,51.26760563,173,48.73239437,355,3,358,0,443,80.81264108
嘉義市,東區,東仁里,34,242,61.89258312,149,38.10741688,391,13,404,0,500,80.8
嘉義市,東區,祐民里,33,323,69.76241901,140,30.23758099,463,12,475,0,642,73.98753894
嘉義市,東區,大街里,32,265,64.00966184,149,35.99033816,414,4,418,0,511,81.80039139
嘉義市,東區,東安里,31,281,65.19721578,150,34.80278422,431,3,434,0,536,80.97014925
嘉義市,東區,東山里,30,204,54.98652291,167,45.01347709,371,2,373,0,452,82.52212389
嘉義市,東區,希康里,29,13,4.980842912,248,95.01915709,261,3,264,0,318,83.01886792
嘉義市,東區,東噴里,28,418,47.99081515,453,52.00918485,871,23,894,0,1137,78.62796834
嘉義市,東區,光復里,48,561,66.07773852,288,33.92226148,849,27,876,0,1086,80.66298343
嘉義市,東區,蘭井里,47,290,57.65407555,213,42.34592445,503,7,510,0,618,82.52427184
嘉義市,東區,志航里,46,94,9.863588667,859,90.13641133,953,17,970,0,1194,81.23953099
嘉義市,東區,文昌里,45,324,59.44954128,221,40.55045872,545,12,557,0,673,82.76374443
嘉義市,東區,安平里,44,317,53.91156463,271,46.08843537,588,12,600,0,729,82.30452675
嘉義市,東區,龍山里,43,319,55.28596187,258,44.71403813,577,5,582,0,730,79.7260274
嘉義市,東區,崇文里,42,281,53.6259542,243,46.3740458,524,9,533,0,655,81.3740458
嘉義市,東區,神農里,41,479,60.32745592,315,39.67254408,794,12,806,0,1017,79.25270403
嘉義市,東區,鎮南里,40,172,57.71812081,126,42.28187919,298,4,302,0,379,79.68337731
嘉義市,東區,圳頭里,25,335,35.67625133,604,64.32374867,939,18,957,0,1178,81.23938879
嘉義市,東區,圳頭里,26,248,31.75416133,533,68.24583867,781,22,803,2,983,81.68870804
嘉義市,東區,圳頭里,27,669,50.83586626,647,49.16413374,1316,16,1332,0,1668,79.85611511
嘉義市,東區,新店里,22,533,49.12442396,552,50.87557604,1085,11,1096,0,1322,82.90468986
嘉義市,東區,新店里,23,347,45.83883752,410,54.16116248,757,10,767,0,937,81.85699039
嘉義市,東區,新店里,24,360,48.12834225,388,51.87165775,748,18,766,0,967,79.21406412
嘉義市,東區,後庄里,19,580,55.028463,474,44.971537,1054,36,1090,0,1358,80.26509573
嘉義市,東區,後庄里,20,446,50,446,50,892,15,907,0,1079,84.05931418
嘉義市,東區,後庄里,21,405,44.55445545,504,55.44554455,909,10,919,0,1103,83.31822303
嘉義市,東區,王田里,15,399,40.9650924,575,59.0349076,974,11,985,0,1216,81.00328947
嘉義市,東區,王田里,16,377,43.48327566,490,56.51672434,867,11,878,0,1107,79.3134598
嘉義市,東區,東川里,4,331,47.76334776,362,52.23665224,693,8,701,0,834,84.05275779
嘉義市,東區,東川里,5,256,34.22459893,492,65.77540107,748,11,759,0,922,82.32104121
嘉義市,東區,太平里,11,531,46.45669291,612,53.54330709,1143,18,1161,0,1427,81.35949544
嘉義市,東區,太平里,12,338,48.9146165,353,51.0853835,691,10,701,0,870,80.57471264
嘉義市,東區,太平里,13,211,40.57692308,309,59.42307692,520,13,533,0,647,82.38021638
嘉義市,東區,太平里,14,316,45.86357039,373,54.13642961,689,9,698,0,853,81.82883939
嘉義市,東區,東平里,10,326,46.24113475,379,53.75886525,705,16,721,0,897,80.37904125
嘉義市,東區,盧厝里,7,516,55.66343042,411,44.33656958,927,28,955,0,1160,82.32758621
嘉義市,東區,盧厝里,8,515,48.08590103,556,51.91409897,1071,10,1081,0,1300,83.15384615
嘉義市,東區,盧厝里,9,402,49.50738916,410,50.49261084,812,9,821,1,990,82.92929293
嘉義市,東區,鹿寮里,6,333,67.82077393,158,32.17922607,491,20,511,0,648,78.85802469
嘉義市,東區,長竹里,17,473,56.17577197,369,43.82422803,842,19,861,0,1012,85.07905138
嘉義市,東區,長竹里,18,558,41.211226,796,58.788774,1354,20,1374,0,1644,83.57664234
嘉義市,東區,短竹里,1,514,47.54856614,567,52.45143386,1081,27,1108,0,1366,81.11273792
嘉義市,東區,短竹里,2,572,52.8650647,510,47.1349353,1082,13,1095,0,1372,79.81049563
嘉義市,東區,短竹里,3,531,46.21409922,618,53.78590078,1149,20,1169,1,1463,79.90430622
嘉義市,東區,新開里,51,262,49.71537002,265,50.28462998,527,13,540,0,643,83.98133748
嘉義市,東區,新開里,52,298,52.18914186,273,47.81085814,571,7,578,0,717,80.61366806
嘉義市,東區,宣信里,53,417,60.26011561,275,39.73988439,692,22,714,0,930,76.77419355
嘉義市,東區,宣信里,54,437,61.37640449,275,38.62359551,712,17,729,0,913,79.84665936
嘉義市,東區,興南里,55,639,61.67953668,397,38.32046332,1036,25,1061,0,1305,81.30268199
嘉義市,東區,豐年里,56,255,44.58041958,317,55.41958042,572,6,578,0,737,78.42605156
嘉義市,東區,豐年里,57,391,61.67192429,243,38.32807571,634,9,643,0,818,78.60635697
嘉義市,東區,芳草里,58,575,56.04288499,451,43.95711501,1026,24,1050,0,1310,80.15267176
嘉義市,東區,芳草里,59,381,53.06406685,337,46.93593315,718,16,734,0,906,81.01545254
嘉義市,東區,芳草里,60,553,53.42995169,482,46.57004831,1035,12,1047,0,1311,79.86270023
嘉義市,東區,芳安里,61,627,56.13249776,490,43.86750224,1117,25,1142,0,1394,81.92252511
嘉義市,東區,芳安里,62,316,58.4103512,225,41.5896488,541,10,551,0,675,81.62962963
嘉義市,東區,頂寮里,63,522,62.81588448,309,37.18411552,831,13,844,0,1049,80.45757865
嘉義市,東區,頂寮里,64,475,59.89911728,318,40.10088272,793,15,808,0,992,81.4516129
嘉義市,東區,安寮里,65,392,55.52407932,314,44.47592068,706,15,721,0,899,80.20022247
嘉義市,東區,安寮里,66,454,55.29841657,367,44.70158343,821,13,834,0,1062,78.53107345
嘉義市,東區,安寮里,67,540,55.10204082,440,44.89795918,980,21,1001,1,1243,80.53097345
嘉義市,東區,安寮里,68,640,53.736356,551,46.263644,1191,24,1215,0,1537,79.05009759
嘉義市,東區,興安里,71,517,61.11111111,329,38.88888889,846,14,860,0,1108,77.61732852
嘉義市,東區,興安里,72,383,46.42424242,442,53.57575758,825,18,843,0,1053,80.05698006
嘉義市,東區,興村里,69,680,60.76854334,439,39.23145666,1119,15,1134,0,1392,81.46551724
嘉義市,東區,興村里,70,682,48.81889764,715,51.18110236,1397,18,1415,0,1820,77.74725275
嘉義市,東區,興仁里,73,625,50.48465267,613,49.51534733,1238,19,1257,0,1537,81.78269356
嘉義市,東區,興仁里,74,718,53.9039039,614,46.0960961,1332,23,1355,0,1672,81.04066986
嘉義市,西區,香湖里,169,644,62.76803119,382,37.23196881,1026,22,1048,0,1363,76.88921497
嘉義市,西區,湖邊里,170,485,68.30985915,225,31.69014085,710,18,728,0,922,78.95878525
嘉義市,西區,湖邊里,171,417,58.07799443,301,41.92200557,718,18,736,0,927,79.39590076
嘉義市,西區,北榮里,161,477,63.01188904,280,36.98811096,757,10,767,0,946,81.0782241
嘉義市,西區,北榮里,162,522,63.34951456,302,36.65048544,824,13,837,0,1026,81.57894737
嘉義市,西區,長安里,160,622,62.95546559,366,37.04453441,988,26,1014,0,1255,80.79681275
嘉義市,西區,重興里,163,540,60.06674082,359,39.93325918,899,26,925,0,1169,79.12745937
嘉義市,西區,重興里,164,462,65.34653465,245,34.65346535,707,17,724,0,900,80.44444444
嘉義市,西區,竹文里,167,400,67.22689076,195,32.77310924,595,19,614,0,758,81.00263852
嘉義市,西區,竹文里,168,322,59.08256881,223,40.91743119,545,17,562,0,683,82.284041
嘉義市,西區,慶昌里,165,238,58.19070905,171,41.80929095,409,2,411,0,508,80.90551181
嘉義市,西區,小湖里,166,353,73.69519833,126,26.30480167,479,18,497,0,643,77.29393468
嘉義市,西區,竹圍里,172,464,58,336,42,800,22,822,0,1034,79.49709865
嘉義市,西區,竹圍里,173,498,55.6424581,397,44.3575419,895,8,903,0,1130,79.91150442
嘉義市,西區,竹圍里,174,475,71.32132132,191,28.67867868,666,23,689,0,858,80.3030303
嘉義市,西區,竹圍里,175,481,61.74582798,298,38.25417202,779,9,788,0,984,80.08130081
嘉義市,西區,新厝里,182,542,60.8988764,348,39.1011236,890,18,908,0,1113,81.58131177
嘉義市,西區,新厝里,183,590,65.04961411,317,34.95038589,907,16,923,0,1138,81.10720562
嘉義市,西區,新厝里,184,625,67.49460043,301,32.50539957,926,24,950,0,1133,83.84819064
嘉義市,西區,保安里,176,749,69.15974146,334,30.84025854,1083,29,1112,0,1388,80.11527378
嘉義市,西區,保安里,177,763,63.53039134,438,36.46960866,1201,25,1226,0,1455,84.26116838
嘉義市,西區,保安里,178,607,56.2557924,472,43.7442076,1079,23,1102,0,1385,79.566787
嘉義市,西區,保安里,179,671,52.25856698,613,47.74143302,1284,27,1311,0,1594,82.24592221
嘉義市,西區,保安里,180,712,54.55938697,593,45.44061303,1305,19,1324,0,1649,80.29108551
嘉義市,西區,保安里,181,669,54.21393841,565,45.78606159,1234,16,1250,0,1565,79.87220447
嘉義市,西區,北湖里,185,518,59.0649943,359,40.9350057,877,31,908,0,1134,80.07054674
嘉義市,西區,北湖里,186,555,60.39173014,364,39.60826986,919,17,936,0,1188,78.78787879
嘉義市,西區,下埤里,187,556,61.84649611,343,38.15350389,899,25,924,0,1202,76.8718802
嘉義市,西區,竹村里,188,369,50.82644628,357,49.17355372,726,21,747,0,910,82.08791209
嘉義市,西區,大溪里,127,487,70.88791849,200,29.11208151,687,32,719,0,925,77.72972973
嘉義市,西區,大溪里,128,466,67.73255814,222,32.26744186,688,26,714,0,890,80.2247191
嘉義市,西區,福全里,114,519,65.20100503,277,34.79899497,796,16,812,0,1023,79.37438905
嘉義市,西區,福全里,115,566,62.88888889,334,37.11111111,900,18,918,0,1156,79.41176471
嘉義市,西區,福全里,116,544,56.02471679,427,43.97528321,971,19,990,0,1228,80.61889251
嘉義市,西區,福全里,117,606,60.53946054,395,39.46053946,1001,16,1017,0,1260,80.71428571
嘉義市,西區,福全里,118,589,53.8883806,504,46.1116194,1093,15,1108,0,1391,79.65492451
嘉義市,西區,西平里,126,718,66.17511521,367,33.82488479,1085,13,1098,0,1309,83.88082506
嘉義市,西區,磚窯里,129,647,62.93774319,381,37.06225681,1028,15,1043,0,1328,78.53915663
嘉義市,西區,磚窯里,130,372,46.3840399,430,53.6159601,802,11,813,0,987,82.37082067
嘉義市,西區,磚窯里,131,463,59.89650712,310,40.10349288,773,10,783,0,956,81.90376569
嘉義市,西區,港坪里,123,463,58.68187579,326,41.31812421,789,15,804,0,999,80.48048048
嘉義市,西區,港坪里,124,428,53.5669587,371,46.4330413,799,11,810,0,1017,79.6460177
嘉義市,西區,頭港里,125,609,60.3567889,400,39.6432111,1009,31,1040,0,1285,80.93385214
嘉義市,西區,劉厝里,120,517,59.76878613,348,40.23121387,865,12,877,0,1109,79.08025248
嘉義市,西區,劉厝里,121,734,56.15914308,573,43.84085692,1307,38,1345,0,1697,79.25751326
嘉義市,西區,劉厝里,122,353,61.92982456,217,38.07017544,570,10,580,0,710,81.69014085
嘉義市,西區,新西里,132,426,58.43621399,303,41.56378601,729,16,745,0,926,80.45356371
嘉義市,西區,新西里,133,508,57.14285714,381,42.85714286,889,13,902,0,1155,78.0952381
嘉義市,西區,力行里,119,449,59.94659546,300,40.05340454,749,11,760,1,945,80.42328042
嘉義市,西區,菜園里,98,277,55.28942116,224,44.71057884,501,12,513,0,640,80.15625
嘉義市,西區,集英里,99,291,69.61722488,127,30.38277512,418,11,429,0,532,80.63909774
嘉義市,西區,驛站里,96,232,48.33333333,248,51.66666667,480,12,492,0,622,79.09967846
嘉義市,西區,義昌里,101,287,63.07692308,168,36.92307692,455,8,463,0,593,78.07757167
嘉義市,西區,自治里,102,515,59.95343423,344,40.04656577,859,18,877,0,1103,79.51042611
嘉義市,西區,福松里,100,416,66.66666667,208,33.33333333,624,17,641,0,800,80.125
嘉義市,西區,民安里,97,253,66.23036649,129,33.76963351,382,6,388,0,481,80.66528067
嘉義市,西區,書院里,95,469,60.12820513,311,39.87179487,780,12,792,0,1014,78.10650888
嘉義市,西區,學圃里,105,272,64.91646778,147,35.08353222,419,11,430,0,531,80.97928437
嘉義市,西區,大業里,103,465,68.88888889,210,31.11111111,675,11,686,0,843,81.37603796
嘉義市,西區,中庸里,104,367,56.46153846,283,43.53846154,650,7,657,0,813,80.81180812
嘉義市,西區,康莊里,113,327,65.26946108,174,34.73053892,501,13,514,0,629,81.71701113
嘉義市,西區,功科里,112,351,64.52205882,193,35.47794118,544,10,554,0,724,76.51933702
嘉義市,西區,榮檜里,111,294,59.75609756,198,40.24390244,492,7,499,0,625,79.84
嘉義市,西區,通運里,110,198,68.04123711,93,31.95876289,291,0,291,0,385,75.58441558
嘉義市,西區,慶昇里,109,212,64.24242424,118,35.75757576,330,6,336,0,423,79.43262411
嘉義市,西區,民生里,108,261,57.23684211,195,42.76315789,456,8,464,0,560,82.85714286
嘉義市,西區,社內里,107,265,63.24582339,154,36.75417661,419,7,426,0,531,80.2259887
嘉義市,西區,北杏里,106,361,54.28571429,304,45.71428571,665,6,671,0,818,82.02933985
嘉義市,西區,華明里,134,295,49.16666667,305,50.83333333,600,8,608,0,779,78.04878049
嘉義市,西區,導民里,135,271,59.82339956,182,40.17660044,453,9,462,0,592,78.04054054
嘉義市,西區,導民里,136,324,61.01694915,207,38.98305085,531,15,546,0,674,81.00890208
嘉義市,西區,培元里,137,494,62.06030151,302,37.93969849,796,22,818,0,1009,81.0703667
嘉義市,西區,垂楊里,138,389,54.94350282,319,45.05649718,708,6,714,0,888,80.40540541
嘉義市,西區,垂楊里,139,528,62.19081272,321,37.80918728,849,20,869,0,1104,78.71376812
嘉義市,西區,車店里,140,670,56.11390285,524,43.88609715,1194,29,1223,1,1543,79.26117952
嘉義市,西區,車店里,141,587,56.87984496,445,43.12015504,1032,16,1048,0,1312,79.87804878
嘉義市,西區,車店里,142,707,56.56,543,43.44,1250,23,1273,0,1558,81.70731707
嘉義市,西區,福民里,143,645,55.17536356,524,44.82463644,1169,14,1183,1,1399,84.56040029
嘉義市,西區,福民里,144,588,53.40599455,513,46.59400545,1101,14,1115,0,1383,80.62183659
嘉義市,西區,福民里,145,607,54.9321267,498,45.0678733,1105,16,1121,0,1448,77.41712707
嘉義市,西區,湖內里,146,628,62.36345581,379,37.63654419,1007,22,1029,0,1270,81.02362205
嘉義市,西區,湖內里,147,704,70.89627392,289,29.10372608,993,41,1034,0,1270,81.41732283
嘉義市,西區,湖內里,148,787,54.12654746,667,45.87345254,1454,15,1469,0,1808,81.25
嘉義市,西區,湖內里,149,620,57.8898226,451,42.1101774,1071,18,1089,0,1369,79.54711468
嘉義市,西區,湖內里,150,630,61.58357771,393,38.41642229,1023,16,1039,0,1269,81.87549251
嘉義市,西區,美源里,151,578,69.7225573,251,30.2774427,829,20,849,0,1039,81.71318576
嘉義市,西區,美源里,152,579,52.11521152,532,47.88478848,1111,16,1127,0,1388,81.19596542
嘉義市,西區,美源里,153,381,53.36134454,333,46.63865546,714,9,723,0,910,79.45054945
嘉義市,西區,育英里,157,510,58.02047782,369,41.97952218,879,14,893,0,1130,79.02654867
嘉義市,西區,育英里,158,526,57.36095965,391,42.63904035,917,12,929,0,1153,80.57241977
嘉義市,西區,光路里,154,557,54.02521823,474,45.97478177,1031,13,1044,0,1311,79.63386728
嘉義市,西區,光路里,155,664,56.22353937,517,43.77646063,1181,27,1208,0,1472,82.06521739
嘉義市,西區,光路里,156,608,55.42388332,489,44.57611668,1097,29,1126,0,1384,81.3583815
嘉義市,西區,自強里,159,565,58.42812823,402,41.57187177,967,28,995,0,1212,82.09570957
臺南市,東區,富裕里,71,996,60.62081558,647,39.37918442,1643,20,1663,0,2101,79.15278439
臺南市,東區,裕農里,67,676,54.12329864,573,45.87670136,1249,14,1263,0,1534,82.33376793
臺南市,東區,裕農里,68,635,55.75065847,504,44.24934153,1139,18,1157,0,1389,83.29733621
臺南市,東區,大智里,16,663,50.30349014,655,49.69650986,1318,18,1336,0,1644,81.26520681
臺南市,東區,大智里,17,486,48.94259819,507,51.05740181,993,31,1024,0,1247,82.11708099
臺南市,東區,大智里,18,626,46.16519174,730,53.83480826,1356,23,1379,0,1671,82.52543387
臺南市,東區,崇學里,3,558,54.38596491,468,45.61403509,1026,16,1042,0,1261,82.63283109
臺南市,東區,崇學里,4,606,56.05920444,475,43.94079556,1081,13,1094,0,1363,80.26412326
臺南市,東區,泉南里,82,952,56.09899823,745,43.90100177,1697,15,1712,0,2114,80.98391675
臺南市,東區,泉南里,83,970,57.56676558,715,42.43323442,1685,29,1714,0,2161,79.31513188
臺南市,東區,仁和里,21,868,58.76777251,609,41.23222749,1477,27,1504,0,1853,81.16567728
臺南市,東區,仁和里,22,755,48.36643177,806,51.63356823,1561,19,1580,0,2019,78.25656265
臺南市,東區,後甲里,39,554,57.17234262,415,42.82765738,969,25,994,0,1222,81.34206219
臺南市,東區,後甲里,40,687,58.02364865,497,41.97635135,1184,20,1204,0,1438,83.72739917
臺南市,東區,復國里,41,63,8.035714286,721,91.96428571,784,11,795,0,948,83.86075949
臺南市,東區,復國里,42,63,8.139534884,711,91.86046512,774,30,804,0,970,82.88659794
臺南市,東區,東光里,45,453,47.93650794,492,52.06349206,945,13,958,0,1180,81.18644068
臺南市,東區,東光里,46,555,37.42414026,928,62.57585974,1483,30,1513,0,1821,83.08621636
臺南市,東區,東光里,47,490,49.19678715,506,50.80321285,996,20,1016,0,1234,82.33387358
臺南市,東區,新東里,62,522,50.67961165,508,49.32038835,1030,10,1040,0,1271,81.82533438
臺南市,東區,新東里,63,503,51.8556701,467,48.1443299,970,17,987,0,1226,80.50570962
臺南市,東區,中西里,59,646,53.52112676,561,46.47887324,1207,13,1220,0,1509,80.84824387
臺南市,東區,中西里,60,624,49.28909953,642,50.71090047,1266,16,1282,0,1546,82.923674
臺南市,東區,東安里,61,738,59.42028986,504,40.57971014,1242,24,1266,0,1619,78.19641754
臺南市,東區,崇明里,75,624,51.40032949,590,48.59967051,1214,17,1231,0,1533,80.30006523
臺南市,東區,崇明里,76,528,46.97508897,596,53.02491103,1124,9,1133,0,1340,84.55223881
臺南市,東區,自強里,31,523,47.37318841,581,52.62681159,1104,16,1120,0,1377,81.3362382
臺南市,東區,自強里,32,553,49.95483288,554,50.04516712,1107,16,1123,0,1358,82.69513991
臺南市,東區,自強里,33,658,55.01672241,538,44.98327759,1196,15,1211,0,1482,81.71390013
臺南市,東區,和平里,23,633,60.056926,421,39.943074,1054,19,1073,0,1348,79.59940653
臺南市,東區,和平里,24,683,58.67697595,481,41.32302405,1164,16,1180,0,1412,83.5694051
臺南市,東區,路東里,79,444,46.15384615,518,53.84615385,962,12,974,0,1252,77.79552716
臺南市,東區,大德里,78,659,51.8081761,613,48.1918239,1272,22,1294,0,1621,79.82726712
臺南市,東區,關聖里,36,884,55.25,716,44.75,1600,13,1613,0,2015,80.04962779
臺南市,東區,關聖里,37,804,46.9352014,909,53.0647986,1713,18,1731,0,2025,85.48148148
臺南市,東區,關聖里,38,776,48.10911345,837,51.89088655,1613,16,1629,0,1909,85.33263489
臺南市,東區,中興里,43,40,6.51465798,574,93.48534202,614,27,641,0,771,83.1387808
臺南市,東區,中興里,44,44,6.586826347,624,93.41317365,668,32,700,0,867,80.73817762
臺南市,東區,衛國里,66,622,52.18120805,570,47.81879195,1192,26,1218,0,1575,77.33333333
臺南市,東區,崇善里,8,877,59.65986395,593,40.34013605,1470,17,1487,0,1797,82.74902615
臺南市,東區,崇善里,9,688,53.66614665,594,46.33385335,1282,21,1303,0,1630,79.93865031
臺南市,東區,富強里,69,1012,59.18128655,698,40.81871345,1710,25,1735,0,2107,82.34456573
臺南市,東區,富強里,70,852,58.07770961,615,41.92229039,1467,29,1496,0,1798,83.20355951
臺南市,東區,圍下里,58,901,50,901,50,1802,30,1832,0,2248,81.49466192
臺南市,東區,小東里,52,607,52.417962,551,47.582038,1158,17,1175,0,1462,80.36935705
臺南市,東區,小東里,53,508,44.44444444,635,55.55555556,1143,16,1159,0,1422,81.50492264
臺南市,東區,小東里,54,469,45.75609756,556,54.24390244,1025,28,1053,0,1272,82.78301887
臺南市,東區,大學里,55,546,44.60784314,678,55.39215686,1224,28,1252,0,1492,83.91420912
臺南市,東區,龍山里,84,543,49.67978042,550,50.32021958,1093,14,1107,0,1331,83.17054846
臺南市,東區,龍山里,85,659,55.14644351,536,44.85355649,1195,26,1221,0,1494,81.72690763
臺南市,東區,虎尾里,25,572,48.14814815,616,51.85185185,1188,28,1216,0,1466,82.946794
臺南市,東區,虎尾里,26,688,60.51011434,449,39.48988566,1137,23,1160,0,1394,83.21377331
臺南市,東區,虎尾里,27,635,47.81626506,693,52.18373494,1328,19,1347,0,1700,79.23529412
臺南市,東區,德高里,19,603,57.59312321,444,42.40687679,1047,19,1066,0,1284,83.02180685
臺南市,東區,德高里,20,628,63.56275304,360,36.43724696,988,39,1027,0,1297,79.18272938
臺南市,東區,莊敬里,50,515,43.60711262,666,56.39288738,1181,8,1189,0,1455,81.71821306
臺南市,東區,莊敬里,51,763,51.9400953,706,48.0599047,1469,11,1480,0,1764,83.90022676
臺南市,東區,大福里,77,933,55.23978686,756,44.76021314,1689,57,1746,0,2171,80.42376785
臺南市,東區,忠孝里,72,637,45.82733813,753,54.17266187,1390,28,1418,0,1810,78.34254144
臺南市,東區,忠孝里,73,667,45.49795362,799,54.50204638,1466,19,1485,1,1814,81.86328556
臺南市,東區,忠孝里,74,9,2.556818182,343,97.44318182,352,55,407,0,598,68.06020067
臺南市,東區,崇誨里,64,325,27.99310939,836,72.00689061,1161,26,1187,0,1462,81.19015048
臺南市,東區,崇誨里,65,540,51.87319885,501,48.12680115,1041,24,1065,0,1271,83.79228954
臺南市,東區,東明里,48,607,47.34789392,675,52.65210608,1282,29,1311,0,1609,81.47917961
臺南市,東區,東明里,49,677,50.74962519,657,49.25037481,1334,19,1353,0,1669,81.06650689
臺南市,東區,崇德里,5,645,53.08641975,570,46.91358025,1215,15,1230,0,1467,83.84458078
臺南市,東區,崇德里,6,462,45.51724138,553,54.48275862,1015,13,1028,0,1245,82.57028112
臺南市,東區,崇德里,7,486,45.71966134,577,54.28033866,1063,11,1074,0,1277,84.10336727
臺南市,東區,東智里,15,846,50.71942446,822,49.28057554,1668,29,1697,0,2061,82.33867055
臺南市,東區,東聖里,34,520,54.79452055,429,45.20547945,949,19,968,0,1162,83.30464716
臺南市,東區,東聖里,35,385,50.32679739,380,49.67320261,765,16,781,0,973,80.2672148
臺南市,東區,崇成里,10,459,50.05452563,458,49.94547437,917,8,925,0,1136,81.42605634
臺南市,東區,崇成里,11,481,47.43589744,533,52.56410256,1014,17,1031,0,1224,84.23202614
臺南市,東區,東門里,57,952,58.08419768,687,41.91580232,1639,21,1660,0,2153,77.10171853
臺南市,東區,成大里,56,815,48.94894895,850,51.05105105,1665,42,1707,0,2170,78.66359447
臺南市,東區,大同里,80,848,57.1043771,637,42.8956229,1485,36,1521,0,1930,78.80829016
臺南市,東區,大同里,81,462,56.68711656,353,43.31288344,815,14,829,0,1045,79.33014354
臺南市,東區,德光里,86,788,48.28431373,844,51.71568627,1632,29,1661,0,1977,84.01618614
臺南市,東區,德光里,87,574,52.51601098,519,47.48398902,1093,27,1120,0,1326,84.46455505
臺南市,東區,崇信里,1,756,55.02183406,618,44.97816594,1374,7,1381,0,1744,79.18577982
臺南市,東區,崇信里,2,771,57.4087863,572,42.5912137,1343,18,1361,0,2010,67.71144279
臺南市,東區,崇文里,12,482,48.34503511,515,51.65496489,997,14,1011,0,1253,80.68635275
臺南市,東區,崇文里,13,538,45.90443686,634,54.09556314,1172,13,1185,0,1419,83.50951374
臺南市,東區,崇文里,14,681,47.89029536,741,52.10970464,1422,22,1444,0,1744,82.79816514
臺南市,東區,復興里,29,730,55.3030303,590,44.6969697,1320,14,1334,0,1664,80.16826923
臺南市,東區,復興里,30,710,57.25806452,530,42.74193548,1240,25,1265,0,1535,82.41042345
臺南市,東區,裕聖里,28,707,46.48257725,814,53.51742275,1521,18,1539,0,1792,85.88169643
臺南市,南區,竹溪里,96,558,48.22817632,599,51.77182368,1157,21,1178,0,1451,81.18538939
臺南市,南區,興中里,98,90,9.922822492,817,90.07717751,907,23,930,0,1166,79.75986278
臺南市,南區,荔宅里,99,130,13.40206186,840,86.59793814,970,32,1002,0,1279,78.34245504
臺南市,南區,明德里,97,138,17.87564767,634,82.12435233,772,34,806,0,1006,80.11928429
臺南市,南區,大成里,100,427,57.46971736,316,42.53028264,743,22,765,0,951,80.44164038
臺南市,南區,廣州里,108,677,67.16269841,331,32.83730159,1008,19,1027,0,1242,82.68921095
臺南市,南區,廣州里,109,700,67.24303554,341,32.75696446,1041,20,1061,0,1281,82.82591725
臺南市,南區,新昌里,110,594,62.13389121,362,37.86610879,956,9,965,0,1176,82.05782313
臺南市,南區,新昌里,111,540,57.44680851,400,42.55319149,940,22,962,0,1195,80.50209205
臺南市,南區,新興里,104,538,58.47826087,382,41.52173913,920,19,939,0,1135,82.73127753
臺南市,南區,新興里,105,680,59.23344948,468,40.76655052,1148,19,1167,0,1462,79.82216142
臺南市,南區,田寮里,101,327,55.23648649,265,44.76351351,592,9,601,0,734,81.88010899
臺南市,南區,田寮里,102,491,57.22610723,367,42.77389277,858,27,885,1,1081,81.86864015
臺南市,南區,田寮里,103,694,55.92264303,547,44.07735697,1241,18,1259,0,1517,82.99274885
臺南市,南區,國宅里,119,794,62.42138365,478,37.57861635,1272,20,1292,0,1558,82.92682927
臺南市,南區,國宅里,120,686,60.97777778,439,39.02222222,1125,18,1143,0,1407,81.23667377
臺南市,南區,日新里,121,525,67.04980843,258,32.95019157,783,13,796,0,965,82.48704663
臺南市,南區,日新里,122,496,57.6744186,364,42.3255814,860,11,871,0,1078,80.79777365
臺南市,南區,光明里,123,838,65.77708006,436,34.22291994,1274,24,1298,0,1593,81.48148148
臺南市,南區,光明里,124,689,64.39252336,381,35.60747664,1070,16,1086,0,1336,81.28742515
臺南市,南區,光明里,125,691,73.12169312,254,26.87830688,945,11,956,0,1180,81.01694915
臺南市,南區,白雪里,126,485,62.2593068,294,37.7406932,779,19,798,0,958,83.29853862
臺南市,南區,白雪里,127,470,60.80206986,303,39.19793014,773,20,793,0,959,82.6903024
臺南市,南區,明亮里,128,809,63.7007874,461,36.2992126,1270,26,1296,0,1628,79.60687961
臺南市,南區,明亮里,129,969,61.91693291,596,38.08306709,1565,34,1599,0,1999,79.989995
臺南市,南區,喜東里,154,940,75.68438003,302,24.31561997,1242,21,1263,0,1521,83.03747535
臺南市,南區,喜北里,151,645,71.98660714,251,28.01339286,896,6,902,0,1118,80.67978533
臺南市,南區,喜北里,152,732,81.24306326,169,18.75693674,901,19,920,0,1090,84.40366972
臺南市,南區,喜南里,153,965,82.47863248,205,17.52136752,1170,11,1181,0,1453,81.28011012
臺南市,南區,省躬里,155,836,74.84333035,281,25.15666965,1117,18,1135,0,1379,82.30601885
臺南市,南區,省躬里,156,766,73.02192564,283,26.97807436,1049,24,1073,0,1293,82.98530549
臺南市,南區,興農里,162,577,76.83089214,174,23.16910786,751,21,772,0,946,81.60676533
臺南市,南區,興農里,163,487,68.88260255,220,31.11739745,707,10,717,0,875,81.94285714
臺南市,南區,同安里,161,1120,70.79646018,462,29.20353982,1582,44,1626,0,2049,79.35578331
臺南市,南區,佛壇里,160,1050,72.91666667,390,27.08333333,1440,31,1471,0,1806,81.45071982
臺南市,南區,大林里,90,380,47.85894207,414,52.14105793,794,21,815,0,1038,78.51637765
臺南市,南區,大林里,91,330,45.83333333,390,54.16666667,720,8,728,0,923,78.87323944
臺南市,南區,大忠里,92,578,62.08378088,353,37.91621912,931,20,951,0,1156,82.26643599
臺南市,南區,大忠里,93,614,52.43381725,557,47.56618275,1171,9,1180,0,1480,79.72972973
臺南市,南區,大忠里,94,696,53.00837776,617,46.99162224,1313,22,1335,0,1645,81.1550152
臺南市,南區,大恩里,88,613,48.88357257,641,51.11642743,1254,18,1272,0,1538,82.70481144
臺南市,南區,大恩里,89,701,51.54411765,659,48.45588235,1360,23,1383,0,1687,81.97984588
臺南市,南區,新生里,95,83,8.609958506,881,91.39004149,964,36,1000,0,1218,82.10180624
臺南市,南區,再興里,106,560,62.4303233,337,37.5696767,897,20,917,0,1106,82.91139241
臺南市,南區,再興里,107,552,60.99447514,353,39.00552486,905,16,921,0,1101,83.65122616
臺南市,南區,明興里,133,846,66.24902114,431,33.75097886,1277,28,1305,0,1550,84.19354839
臺南市,南區,明興里,134,916,67.40250184,443,32.59749816,1359,14,1373,0,1696,80.95518868
臺南市,南區,文華里,112,829,65.12175962,444,34.87824038,1273,27,1300,1,1555,83.60128617
臺南市,南區,文華里,113,689,56.42915643,532,43.57084357,1221,28,1249,0,1527,81.79436804
臺南市,南區,金華里,116,674,56.87763713,511,43.12236287,1185,18,1203,0,1472,81.72554348
臺南市,南區,金華里,117,769,59.19938414,530,40.80061586,1299,22,1321,0,1651,80.01211387
臺南市,南區,金華里,118,848,64.48669202,467,35.51330798,1315,15,1330,0,1613,82.4550527
臺南市,南區,南都里,140,549,60.59602649,357,39.40397351,906,21,927,0,1406,65.93172119
臺南市,南區,南都里,141,425,59.69101124,287,40.30898876,712,16,728,1,934,77.94432548
臺南市,南區,開南里,144,600,60,400,40,1000,14,1014,0,1282,79.09516381
臺南市,南區,開南里,145,565,58.67082035,398,41.32917965,963,17,980,0,1243,78.84151247
臺南市,南區,開南里,146,685,61.21537087,434,38.78462913,1119,11,1130,0,1448,78.03867403
臺南市,南區,彰南里,147,448,61.03542234,286,38.96457766,734,16,750,0,928,80.81896552
臺南市,南區,彰南里,148,496,64.83660131,269,35.16339869,765,13,778,0,955,81.46596859
臺南市,南區,建南里,137,712,64.49275362,392,35.50724638,1104,20,1124,0,1330,84.5112782
臺南市,南區,建南里,138,762,62.61298274,455,37.38701726,1217,22,1239,0,1473,84.11405295
臺南市,南區,建南里,139,634,61.97458456,389,38.02541544,1023,20,1043,0,1241,84.0451249
臺南市,南區,郡南里,135,751,53.87374462,643,46.12625538,1394,33,1427,0,1723,82.82066164
臺南市,南區,郡南里,136,837,63.02710843,491,36.97289157,1328,10,1338,0,1673,79.97609085
臺南市,南區,府南里,130,659,56.95764909,498,43.04235091,1157,29,1186,0,1479,80.18931711
臺南市,南區,府南里,131,606,61.15035318,385,38.84964682,991,18,1009,0,1236,81.63430421
臺南市,南區,府南里,132,595,52.42290749,540,47.57709251,1135,17,1152,0,1416,81.3559322
臺南市,南區,文南里,114,1069,62.99351797,628,37.00648203,1697,24,1721,0,2164,79.52865065
臺南市,南區,文南里,115,790,56.79367362,601,43.20632638,1391,22,1413,0,1764,80.10204082
臺南市,南區,鯤鯓里,149,516,66.15384615,264,33.84615385,780,28,808,0,1006,80.31809145
臺南市,南區,鯤鯓里,150,466,68.93491124,210,31.06508876,676,18,694,0,871,79.67853042
臺南市,南區,松安里,159,1041,73.93465909,367,26.06534091,1408,39,1447,0,1775,81.52112676
臺南市,南區,永寧里,157,511,71.07093185,208,28.92906815,719,17,736,0,882,83.44671202
臺南市,南區,永寧里,158,619,71.06773823,252,28.93226177,871,18,889,0,1109,80.16230839
臺南市,南區,南華里,142,537,58.30618893,384,41.69381107,921,9,930,0,1145,81.22270742
臺南市,南區,南華里,143,597,59.16749257,412,40.83250743,1009,18,1027,0,1309,78.45683728
臺南市,中西區,公正里,182,718,61.84323859,443,38.15676141,1161,14,1175,0,1463,80.31442242
臺南市,中西區,銀同里,166,560,56.96846389,423,43.03153611,983,22,1005,0,1272,79.00943396
臺南市,中西區,小西里,164,410,51.83312263,381,48.16687737,791,11,802,0,1003,79.96011964
臺南市,中西區,仙草里,169,537,54.74006116,444,45.25993884,981,20,1001,0,1227,81.58109209
臺南市,中西區,仙草里,170,517,56.01300108,406,43.98699892,923,18,941,0,1149,81.897302
臺南市,中西區,赤嵌里,181,709,60.75407027,458,39.24592973,1167,35,1202,0,1549,77.59845061
臺南市,中西區,五妃里,167,602,47.70206022,660,52.29793978,1262,25,1287,0,1579,81.50728309
臺南市,中西區,郡王里,168,599,49.54507858,610,50.45492142,1209,19,1228,0,1503,81.70326015
臺南市,中西區,福安里,173,647,59.14076782,447,40.85923218,1094,16,1110,0,1359,81.67770419
臺南市,中西區,法華里,171,555,50.91743119,535,49.08256881,1090,12,1102,0,1320,83.48484848
臺南市,中西區,法華里,172,429,43.15895372,565,56.84104628,994,11,1005,1,1242,80.9178744
臺南市,中西區,大南里,165,394,38.58961802,627,61.41038198,1021,21,1042,0,1275,81.7254902
臺南市,中西區,開山里,184,1001,60.15625,663,39.84375,1664,27,1691,0,2146,78.79776328
臺南市,中西區,進學里,174,571,52.82146161,510,47.17853839,1081,9,1090,0,1351,80.68097705
臺南市,中西區,建國里,175,650,60.01846722,433,39.98153278,1083,26,1109,0,1409,78.70830376
臺南市,中西區,青年里,176,621,57.82122905,453,42.17877095,1074,21,1095,0,1364,80.27859238
臺南市,中西區,永福里,177,733,64.69549868,400,35.30450132,1133,19,1152,0,1450,79.44827586
臺南市,中西區,永華里,178,684,59.73799127,461,40.26200873,1145,33,1178,1,1469,80.19060585
臺南市,中西區,天后里,179,797,61.16653876,506,38.83346124,1303,13,1316,0,1645,80
臺南市,中西區,三民里,180,751,62.27197347,455,37.72802653,1206,22,1228,0,1518,80.89591568
臺南市,中西區,萬昌里,183,1058,66.16635397,541,33.83364603,1599,28,1627,0,2065,78.78934625
臺南市,中西區,普濟里,194,533,57.25026853,398,42.74973147,931,20,951,1,1195,79.58158996
臺南市,中西區,水仙里,195,729,66.88073394,361,33.11926606,1090,12,1102,0,1380,79.85507246
臺南市,中西區,藥王里,197,473,63.66083445,270,36.33916555,743,14,757,0,948,79.85232068
臺南市,中西區,藥王里,198,880,56.33802817,682,43.66197183,1562,32,1594,0,1972,80.831643
臺南市,中西區,協和里,192,1009,64.06349206,566,35.93650794,1575,38,1613,0,2111,76.4092847
臺南市,中西區,文賢里,191,696,68.43657817,321,31.56342183,1017,27,1044,0,1265,82.52964427
臺南市,中西區,光賢里,189,806,65.90351594,417,34.09648406,1223,10,1233,0,1497,82.36472946
臺南市,中西區,光賢里,190,657,67.17791411,321,32.82208589,978,22,1000,0,1208,82.78145695
臺南市,中西區,元安里,208,643,63.28740157,373,36.71259843,1016,13,1029,0,1284,80.14018692
臺南市,中西區,協進里,199,546,61.55580609,341,38.44419391,887,19,906,0,1107,81.84281843
臺南市,中西區,安海里,201,566,57.63747454,416,42.36252546,982,17,999,0,1285,77.74319066
臺南市,中西區,民生里,207,965,66.87456687,478,33.12543313,1443,27,1470,0,1809,81.26036484
臺南市,中西區,中正里,200,644,60.24321796,425,39.75678204,1069,25,1094,0,1340,81.64179104
臺南市,中西區,大涼里,202,363,53.07017544,321,46.92982456,684,14,698,0,912,76.53508772
臺南市,中西區,大涼里,203,695,58.15899582,500,41.84100418,1195,18,1213,0,1485,81.68350168
臺南市,中西區,民主里,204,479,64.20911528,267,35.79088472,746,15,761,0,973,78.21171634
臺南市,中西區,西湖里,187,486,53.17286652,428,46.82713348,914,14,928,0,1159,80.06902502
臺南市,中西區,西湖里,188,761,51.69836957,711,48.30163043,1472,26,1498,0,1884,79.51167728
臺南市,中西區,西賢里,185,860,55.91677503,678,44.08322497,1538,20,1558,0,1892,82.34672304
臺南市,中西區,西賢里,186,747,57.90697674,543,42.09302326,1290,21,1311,0,1588,82.55667506
臺南市,中西區,三合里,193,869,61.24031008,550,38.75968992,1419,27,1446,0,1863,77.61674718
臺南市,中西區,民權里,196,884,67.68759571,422,32.31240429,1306,26,1332,0,1635,81.46788991
臺南市,中西區,保安里,205,642,61.79018287,397,38.20981713,1039,23,1062,0,1331,79.78963186
臺南市,中西區,郡西里,206,623,64.49275362,343,35.50724638,966,33,999,0,1229,81.28559805
臺南市,北區,開元里,209,576,61.08165429,367,38.91834571,943,36,979,0,1219,80.31173093
臺南市,北區,開元里,210,480,57.07491082,361,42.92508918,841,17,858,0,1080,79.44444444
臺南市,北區,新勝里,222,433,59.97229917,289,40.02770083,722,24,746,0,913,81.70865279
臺南市,北區,新勝里,223,319,45.63662375,380,54.36337625,699,9,708,0,888,79.72972973
臺南市,北區,勝安里,229,497,51.82481752,462,48.17518248,959,24,983,0,1208,81.37417219
臺南市,北區,東興里,220,364,44.44444444,455,55.55555556,819,10,829,0,1006,82.4055666
臺南市,北區,東興里,221,402,46.85314685,456,53.14685315,858,8,866,0,1025,84.48780488
臺南市,北區,力行里,216,465,50.76419214,451,49.23580786,916,17,933,0,1142,81.69877408
臺南市,北區,力行里,217,491,53.2537961,431,46.7462039,922,9,931,0,1082,86.04436229
臺南市,北區,華興里,214,487,58.74547648,342,41.25452352,829,6,835,0,1034,80.75435203
臺南市,北區,華興里,215,465,55.22565321,377,44.77434679,842,19,861,0,1040,82.78846154
臺南市,北區,振興里,225,407,52.11267606,374,47.88732394,781,14,795,0,986,80.62880325
臺南市,北區,振興里,226,396,54.32098765,333,45.67901235,729,5,734,0,910,80.65934066
臺南市,北區,仁愛里,227,415,59.20114123,286,40.79885877,701,22,723,0,908,79.62555066
臺南市,北區,仁愛里,228,365,52.06847361,336,47.93152639,701,2,703,0,856,82.12616822
臺南市,北區,大仁里,240,300,41.95804196,415,58.04195804,715,22,737,0,929,79.33261572
臺南市,北區,大山里,239,276,28.81002088,682,71.18997912,958,30,988,0,1247,79.23015237
臺南市,北區,大道里,238,35,6.704980843,487,93.29501916,522,13,535,0,660,81.06060606
臺南市,北區,光武里,237,194,36.95238095,331,63.04761905,525,16,541,0,685,78.97810219
臺南市,北區,實踐里,236,424,37.03056769,721,62.96943231,1145,32,1177,0,1438,81.84979138
臺南市,北區,小康里,234,570,62.36323851,344,37.63676149,914,22,936,0,1116,83.87096774
臺南市,北區,小康里,235,411,55.31628533,332,44.68371467,743,28,771,0,932,82.72532189
臺南市,北區,正風里,244,798,67.34177215,387,32.65822785,1185,26,1211,0,1488,81.3844086
臺南市,北區,延平里,245,451,67.6161919,216,32.3838081,667,23,690,0,844,81.7535545
臺南市,北區,延平里,246,490,67.21536351,239,32.78463649,729,12,741,0,916,80.89519651
臺南市,北區,興北里,241,707,58.76974231,496,41.23025769,1203,30,1233,0,1539,80.11695906
臺南市,北區,大豐里,278,843,63.05160808,494,36.94839192,1337,20,1357,0,1667,81.40371926
臺南市,北區,大豐里,279,624,58.97920605,434,41.02079395,1058,18,1076,0,1347,79.88121752
臺南市,北區,大豐里,280,457,60.93333333,293,39.06666667,750,17,767,0,931,82.38453276
臺南市,北區,重興里,218,663,56.56996587,509,43.43003413,1172,23,1195,0,1475,81.01694915
臺南市,北區,重興里,219,142,12.93260474,956,87.06739526,1098,16,1114,0,1358,82.03240059
臺南市,北區,和順里,263,954,60.15132409,632,39.84867591,1586,35,1621,0,2020,80.24752475
臺南市,北區,和順里,264,822,58.50533808,583,41.49466192,1405,24,1429,0,1718,83.17811409
臺南市,北區,和順里,265,616,50.53322395,603,49.46677605,1219,19,1238,0,1562,79.25736236
臺南市,北區,國姓里,254,762,61.75040519,472,38.24959481,1234,36,1270,0,1572,80.78880407
臺南市,北區,六甲里,252,466,55.21327014,378,44.78672986,844,20,864,0,1107,78.04878049
臺南市,北區,六甲里,253,548,60.15367728,363,39.84632272,911,15,926,0,1160,79.82758621
臺南市,北區,正覺里,249,583,67.01149425,287,32.98850575,870,19,889,0,1111,80.0180018
臺南市,北區,正覺里,250,590,65.92178771,305,34.07821229,895,15,910,0,1102,82.57713249
臺南市,北區,正覺里,251,560,68.71165644,255,31.28834356,815,18,833,0,1006,82.80318091
臺南市,北區,成功里,258,859,63.67679763,490,36.32320237,1349,11,1360,0,1673,81.29109384
臺南市,北區,成功里,259,851,58.2477755,610,41.7522245,1461,18,1479,0,1813,81.57749586
臺南市,北區,文元里,267,652,61.1059044,415,38.8940956,1067,15,1082,1,1319,82.0318423
臺南市,北區,文元里,268,692,63.83763838,392,36.16236162,1084,19,1103,0,1357,81.28224024
臺南市,北區,文元里,269,640,59.42432683,437,40.57567317,1077,20,1097,0,1293,84.84145398
臺南市,北區,大港里,275,725,67.50465549,349,32.49534451,1074,14,1088,0,1278,85.13302034
臺南市,北區,大港里,276,794,66.33249791,403,33.66750209,1197,26,1223,0,1508,81.10079576
臺南市,北區,大港里,277,780,53.13351499,688,46.86648501,1468,20,1488,0,1773,83.92554992
臺南市,北區,國興里,213,617,54.45719329,516,45.54280671,1133,33,1166,0,1411,82.63642807
臺南市,北區,裕民里,272,716,63.98570152,403,36.01429848,1119,27,1146,0,1422,80.5907173
臺南市,北區,安民里,266,694,64.43825441,383,35.56174559,1077,11,1088,0,1350,80.59259259
臺南市,北區,興南里,247,575,56.93069307,435,43.06930693,1010,22,1032,0,1312,78.65853659
臺南市,北區,長榮里,224,121,14.61352657,707,85.38647343,828,30,858,0,1039,82.57940327
臺南市,北區,中樓里,230,242,31.84210526,518,68.15789474,760,11,771,0,909,84.81848185
臺南市,北區,中樓里,231,502,56.72316384,383,43.27683616,885,11,896,0,1109,80.79350766
臺南市,北區,公園里,242,361,45.18147685,438,54.81852315,799,17,816,0,1035,78.84057971
臺南市,北區,公園里,243,369,53.55587808,320,46.44412192,689,17,706,0,899,78.53170189
臺南市,北區,玉皇里,248,825,63.70656371,470,36.29343629,1295,31,1326,0,1656,80.07246377
臺南市,北區,長德里,255,706,63.66095582,403,36.33904418,1109,29,1138,0,1484,76.68463612
臺南市,北區,三德里,256,644,61.10056926,410,38.89943074,1054,26,1080,0,1352,79.8816568
臺南市,北區,五福里,257,636,62.53687316,381,37.46312684,1017,17,1034,0,1533,67.44944553
臺南市,北區,元寶里,211,228,44.9704142,279,55.0295858,507,11,518,0,720,71.94444444
臺南市,北區,元寶里,212,431,49.8265896,434,50.1734104,865,16,881,0,1089,80.89990817
臺南市,北區,永祥里,232,691,55.86095392,546,44.13904608,1237,27,1264,0,1532,82.50652742
臺南市,北區,永祥里,233,488,45.52238806,584,54.47761194,1072,29,1101,0,1360,80.95588235
臺南市,北區,成德里,260,854,62.84032377,505,37.15967623,1359,17,1376,0,1699,80.98881695
臺南市,北區,成德里,261,890,59.01856764,618,40.98143236,1508,14,1522,0,1817,83.76444689
臺南市,北區,成德里,262,708,56.01265823,556,43.98734177,1264,16,1280,0,1481,86.42808913
臺南市,北區,文成里,270,716,62.58741259,428,37.41258741,1144,26,1170,0,1414,82.74398868
臺南市,北區,文成里,271,673,61.29326047,425,38.70673953,1098,7,1105,0,1321,83.64875095
臺南市,北區,大和里,273,823,66.96501221,406,33.03498779,1229,22,1251,0,1491,83.90342052
臺南市,北區,大和里,274,774,64.60767947,424,35.39232053,1198,24,1222,0,1462,83.58413133
臺南市,北區,賢北里,281,539,57.58547009,397,42.41452991,936,9,945,0,1147,82.38884045
臺南市,北區,賢北里,282,596,59.30348259,409,40.69651741,1005,11,1016,0,1203,84.45552785
臺南市,安南區,東和里,283,301,64.87068966,163,35.12931034,464,13,477,0,567,84.12698413
臺南市,安南區,安順里,289,620,60.13579049,411,39.86420951,1031,24,1055,0,1309,80.59587471
臺南市,安南區,安順里,290,723,63.6443662,413,36.3556338,1136,18,1154,0,1397,82.60558339
臺南市,安南區,塭南里,284,1104,66.02870813,568,33.97129187,1672,16,1688,0,2053,82.2211398
臺南市,安南區,塭南里,285,826,67.2091131,403,32.7908869,1229,27,1256,0,1615,77.77089783
臺南市,安南區,州南里,286,888,70.14218009,378,29.85781991,1266,20,1286,0,1621,79.3337446
臺南市,安南區,州南里,287,702,63.58695652,402,36.41304348,1104,33,1137,0,1428,79.62184874
臺南市,安南區,州南里,288,629,64.64542652,344,35.35457348,973,39,1012,0,1258,80.44515103
臺南市,安南區,州北里,291,866,66.92426584,428,33.07573416,1294,24,1318,0,1595,82.63322884
臺南市,安南區,州北里,292,827,61.21391562,524,38.78608438,1351,24,1375,0,1699,80.9299588
臺南市,安南區,安東里,305,721,66.57433056,362,33.42566944,1083,26,1109,0,1342,82.63785395
臺南市,安南區,安東里,306,742,74.7983871,250,25.2016129,992,37,1029,0,1238,83.11793215
臺南市,安南區,安西里,302,1234,71.32947977,496,28.67052023,1730,38,1768,0,2190,80.73059361
臺南市,安南區,頂安里,295,768,78.9311408,205,21.0688592,973,24,997,0,1180,84.49152542
臺南市,安南區,頂安里,296,846,66.7192429,422,33.2807571,1268,17,1285,0,1585,81.07255521
臺南市,安南區,安慶里,297,1391,68.79327399,631,31.20672601,2022,36,2058,0,2657,77.45577719
臺南市,安南區,安慶里,298,773,65.34234996,410,34.65765004,1183,23,1206,0,1454,82.94360385
臺南市,安南區,新順里,293,852,60.85714286,548,39.14285714,1400,28,1428,0,1706,83.7045721
臺南市,安南區,新順里,294,917,62.72229822,545,37.27770178,1462,28,1490,0,1789,83.28675238
臺南市,安南區,原佃里,315,836,69.20529801,372,30.79470199,1208,37,1245,0,1484,83.89487871
臺南市,安南區,總頭里,320,887,67.24791509,432,32.75208491,1319,50,1369,0,1683,81.34284017
臺南市,安南區,長安里,316,851,71.09440267,346,28.90559733,1197,37,1234,0,1562,79.00128041
臺南市,安南區,長安里,317,939,68.49015317,432,31.50984683,1371,30,1401,0,1734,80.79584775
臺南市,安南區,公親里,318,596,70.86801427,245,29.13198573,841,4,845,0,1038,81.40655106
臺南市,安南區,海東里,331,958,68.57551897,439,31.42448103,1397,37,1434,0,1817,78.92129884
臺南市,安南區,海東里,332,841,66.79904686,418,33.20095314,1259,18,1277,0,1605,79.56386293
臺南市,安南區,海西里,329,600,63.35797254,347,36.64202746,947,22,969,0,1183,81.9103973
臺南市,安南區,海西里,330,562,64.52353617,309,35.47646383,871,19,890,0,1127,78.97071872
臺南市,安南區,海南里,350,551,69.3081761,244,30.6918239,795,20,815,0,1007,80.93346574
臺南市,安南區,海南里,351,503,61.64215686,313,38.35784314,816,8,824,0,965,85.38860104
臺南市,安南區,溪心里,333,1274,65.56870818,669,34.43129182,1943,24,1967,0,2712,72.52949853
臺南市,安南區,溪心里,334,642,68.08059385,301,31.91940615,943,22,965,0,1174,82.19761499
臺南市,安南區,鹽田里,364,296,64.9122807,160,35.0877193,456,10,466,0,555,83.96396396
臺南市,安南區,淵東里,335,654,63.12741313,382,36.87258687,1036,22,1058,0,1311,80.70175439
臺南市,安南區,淵東里,336,862,66.76994578,429,33.23005422,1291,38,1329,0,1652,80.44794189
臺南市,安南區,淵西里,327,530,64.00966184,298,35.99033816,828,9,837,0,1036,80.79150579
臺南市,安南區,淵西里,328,715,64.35643564,396,35.64356436,1111,33,1144,0,1397,81.88976378
臺南市,安南區,佃東里,324,535,63.69047619,305,36.30952381,840,26,866,1,1071,80.85901027
臺南市,安南區,佃東里,325,551,58.18373812,396,41.81626188,947,11,958,0,1166,82.16123499
臺南市,安南區,佃西里,326,742,63.63636364,424,36.36363636,1166,28,1194,0,1498,79.70627503
臺南市,安南區,公塭里,323,470,69.01615272,211,30.98384728,681,24,705,0,825,85.45454545
臺南市,安南區,南興里,321,775,72.83834586,289,27.16165414,1064,27,1091,0,1352,80.69526627
臺南市,安南區,學東里,322,887,64.60305899,486,35.39694101,1373,48,1421,0,1795,79.1643454
臺南市,安南區,城東里,352,668,63.37760911,386,36.62239089,1054,33,1087,0,1405,77.36654804
臺南市,安南區,城北里,357,623,66.55982906,313,33.44017094,936,34,970,0,1209,80.23159636
臺南市,安南區,城中里,358,425,56.14266843,332,43.85733157,757,13,770,0,893,86.22620381
臺南市,安南區,城南里,353,802,67.11297071,393,32.88702929,1195,47,1242,1,1621,76.61937076
臺南市,安南區,城南里,354,349,58.65546218,246,41.34453782,595,16,611,0,756,80.82010582
臺南市,安南區,城西里,356,590,72.57072571,223,27.42927429,813,32,845,0,1016,83.16929134
臺南市,安南區,青草里,355,639,64.28571429,355,35.71428571,994,29,1023,0,1284,79.6728972
臺南市,安南區,砂崙里,359,288,74.61139896,98,25.38860104,386,8,394,0,468,84.18803419
臺南市,安南區,砂崙里,360,284,66.82352941,141,33.17647059,425,13,438,0,558,78.49462366
臺南市,安南區,顯宮里,361,440,54.18719212,372,45.81280788,812,32,844,0,1071,78.80485528
臺南市,安南區,鹿耳里,362,231,47.14285714,259,52.85714286,490,12,502,0,633,79.30489731
臺南市,安南區,四草里,363,681,59.9471831,455,40.0528169,1136,36,1172,0,1432,81.84357542
臺南市,安南區,安和里,301,984,63.97919376,554,36.02080624,1538,32,1570,0,1924,81.6008316
臺南市,安南區,溪北里,299,675,67.77108434,321,32.22891566,996,24,1020,0,1227,83.12958435
臺南市,安南區,溪北里,300,607,56.88847235,460,43.11152765,1067,21,1088,0,1306,83.30781011
臺南市,安南區,溪頂里,303,1099,63.19723979,640,36.80276021,1739,47,1786,0,2172,82.22836096
臺南市,安南區,溪頂里,304,754,59.936407,504,40.063593,1258,22,1280,0,1592,80.40201005
臺南市,安南區,溪墘里,339,756,66.02620087,389,33.97379913,1145,20,1165,0,1401,83.15488936
臺南市,安南區,溪墘里,340,795,69.85940246,343,30.14059754,1138,25,1163,0,1409,82.54080908
臺南市,安南區,海佃里,341,1091,70.66062176,453,29.33937824,1544,26,1570,0,1953,80.38914491
臺南市,安南區,海佃里,342,1031,64.96534342,556,35.03465658,1587,29,1616,0,1966,82.19735504
臺南市,安南區,幸福里,348,811,69.49443016,356,30.50556984,1167,23,1190,0,1473,80.78750849
臺南市,安南區,幸福里,349,1069,69.37053861,472,30.62946139,1541,29,1570,0,1911,82.1559393
臺南市,安南區,鳳凰里,307,822,58.88252149,574,41.11747851,1396,16,1412,0,1807,78.14056447
臺南市,安南區,鳳凰里,308,851,61.31123919,537,38.68876081,1388,24,1412,0,1811,77.9679735
臺南市,安南區,梅花里,309,763,63.68948247,435,36.31051753,1198,21,1219,0,1544,78.9507772
臺南市,安南區,梅花里,310,802,62.17054264,488,37.82945736,1290,25,1315,0,1667,78.88422316
臺南市,安南區,理想里,311,870,65.0710546,467,34.9289454,1337,23,1360,0,1691,80.42578356
臺南市,安南區,理想里,312,939,66.08022519,482,33.91977481,1421,26,1447,1,1769,81.79762578
臺南市,安南區,溪東里,344,425,60.97560976,272,39.02439024,697,3,700,0,827,84.643289
臺南市,安南區,溪東里,345,947,59.89879823,634,40.10120177,1581,14,1595,0,1935,82.42894057
臺南市,安南區,淵中里,337,750,62.81407035,444,37.18592965,1194,24,1218,0,1520,80.13157895
臺南市,安南區,淵中里,338,655,69.38559322,289,30.61440678,944,16,960,0,1204,79.73421927
臺南市,安南區,布袋里,319,609,59.29892892,418,40.70107108,1027,23,1050,0,1304,80.52147239
臺南市,安南區,國安里,343,918,67.1543526,449,32.8456474,1367,23,1390,0,1661,83.68452739
臺南市,安南區,安富里,346,1003,65.4272668,530,34.5727332,1533,39,1572,1,2005,78.40399002
臺南市,安南區,安富里,347,1128,67.34328358,547,32.65671642,1675,42,1717,0,2140,80.23364486
臺南市,安南區,大安里,313,740,62.34203875,447,37.65796125,1187,19,1206,0,1509,79.92047714
臺南市,安南區,大安里,314,746,63.16680779,435,36.83319221,1181,25,1206,0,1485,81.21212121
臺南市,安平區,西門里,370,715,45.51241248,856,54.48758752,1571,38,1609,0,1962,82.00815494
臺南市,安平區,金城里,371,616,51.89553496,571,48.10446504,1187,17,1204,0,1505,80
臺南市,安平區,石門里,367,1046,67.13735558,512,32.86264442,1558,39,1597,0,2166,73.73037858
臺南市,安平區,漁光里,372,263,64.14634146,147,35.85365854,410,7,417,0,520,80.19230769
臺南市,安平區,建平里,385,640,55.65217391,510,44.34782609,1150,21,1171,0,1449,80.81435473
臺南市,安平區,建平里,386,621,53.673293,536,46.326707,1157,12,1169,0,1453,80.45423262
臺南市,安平區,怡平里,381,519,54.45960126,434,45.54039874,953,21,974,0,1245,78.23293173
臺南市,安平區,怡平里,382,592,56.32730733,459,43.67269267,1051,22,1073,0,1315,81.59695817
臺南市,安平區,華平里,379,771,51.91919192,714,48.08080808,1485,20,1505,0,1835,82.01634877
臺南市,安平區,華平里,380,805,55.1369863,655,44.8630137,1460,20,1480,0,1828,80.96280088
臺南市,安平區,平通里,374,781,53.27421555,685,46.72578445,1466,30,1496,0,1970,75.93908629
臺南市,安平區,平通里,375,833,58.45614035,592,41.54385965,1425,22,1447,0,1849,78.25851812
臺南市,安平區,文平里,387,673,55.29991783,544,44.70008217,1217,4,1221,0,1502,81.29161119
臺南市,安平區,文平里,388,721,58.09830782,520,41.90169218,1241,15,1256,0,1536,81.77083333
臺南市,安平區,國平里,383,745,54.90051584,612,45.09948416,1357,10,1367,0,1673,81.70950389
臺南市,安平區,國平里,384,598,47.04956727,673,52.95043273,1271,24,1295,0,1694,76.44628099
臺南市,安平區,育平里,376,603,52.11754538,554,47.88245462,1157,20,1177,0,1471,80.01359619
臺南市,安平區,育平里,377,652,50.97732604,627,49.02267396,1279,14,1293,0,1690,76.50887574
臺南市,安平區,育平里,378,622,47.4446987,689,52.5553013,1311,22,1333,0,1719,77.54508435
臺南市,安平區,億載里,373,670,59.60854093,454,40.39145907,1124,17,1141,0,1412,80.80736544
臺南市,安平區,海頭里,369,788,63.90916464,445,36.09083536,1233,26,1259,0,1526,82.50327654
臺南市,安平區,港仔里,368,789,66.75126904,393,33.24873096,1182,18,1200,0,1441,83.27550312
臺南市,安平區,平安里,365,694,61.14537445,441,38.85462555,1135,16,1151,0,1449,79.43409248
臺南市,安平區,平安里,366,809,64.41082803,447,35.58917197,1256,12,1268,0,1539,82.39116309
金門縣,金城鎮,東門里,1,65,10.0619195,581,89.9380805,646,12,658,0,1023,64.32062561
金門縣,金城鎮,東門里,2,51,6.845637584,694,93.15436242,745,19,764,0,1129,67.67050487
金門縣,金城鎮,西門里,5,53,7.443820225,659,92.55617978,712,30,742,0,1145,64.80349345
金門縣,金城鎮,西門里,6,46,5.997392438,721,94.00260756,767,23,790,0,1246,63.40288925
金門縣,金城鎮,西門里,7,63,5.77451879,1028,94.22548121,1091,30,1121,0,1672,67.04545455
金門縣,金城鎮,南門里,3,33,5.213270142,600,94.78672986,633,29,662,0,1004,65.93625498
金門縣,金城鎮,南門里,4,79,8.729281768,826,91.27071823,905,23,928,0,1448,64.08839779
金門縣,金城鎮,北門里,8,65,6.086142322,1003,93.91385768,1068,28,1096,0,1733,63.24293133
金門縣,金城鎮,古城里,11,30,3.416856492,848,96.58314351,878,48,926,0,1438,64.39499305
金門縣,金城鎮,金水里,10,20,3.992015968,481,96.00798403,501,23,524,0,788,66.49746193
金門縣,金城鎮,珠沙里,12,40,7.207207207,515,92.79279279,555,19,574,0,926,61.98704104
金門縣,金城鎮,賢庵里,9,57,6.658878505,799,93.3411215,856,53,909,0,1419,64.05919662
金門縣,金寧鄉,古寧村,13,60,8.174386921,674,91.82561308,734,57,791,0,1312,60.28963415
金門縣,金寧鄉,安美村,14,59,5.705996132,975,94.29400387,1034,71,1105,0,1645,67.17325228
金門縣,金寧鄉,后盤村,18,16,4.507042254,339,95.49295775,355,16,371,0,572,64.86013986
金門縣,金寧鄉,湖埔村,15,68,6.75944334,938,93.24055666,1006,47,1053,0,1614,65.24163569
金門縣,金寧鄉,榜林村,16,59,5.6621881,983,94.3378119,1042,47,1089,0,1675,65.01492537
金門縣,金寧鄉,盤山村,17,57,6.643356643,801,93.35664336,858,10,868,0,1348,64.39169139
金門縣,金湖鎮,新市里,19,44,6.636500754,619,93.36349925,663,21,684,0,987,69.30091185
金門縣,金湖鎮,新市里,20,55,7.372654155,691,92.62734584,746,7,753,0,1134,66.4021164
金門縣,金湖鎮,山外里,21,78,8,897,92,975,6,981,0,1531,64.07576747
金門縣,金湖鎮,正義里,27,40,6.41025641,584,93.58974359,624,33,657,0,942,69.74522293
金門縣,金湖鎮,料羅里,24,20,4.474272931,427,95.52572707,447,16,463,0,696,66.52298851
金門縣,金湖鎮,瓊林里,28,33,3.990326481,794,96.00967352,827,16,843,0,1323,63.71882086
金門縣,金湖鎮,新湖里,25,61,10.21775544,536,89.78224456,597,18,615,0,899,68.40934372
金門縣,金湖鎮,新湖里,26,66,9.593023256,622,90.40697674,688,18,706,0,1077,65.55246054
金門縣,金湖鎮,溪湖里,22,34,7.88863109,397,92.11136891,431,4,435,0,664,65.51204819
金門縣,金湖鎮,蓮庵里,23,14,3.562340967,379,96.43765903,393,25,418,0,642,65.10903427
金門縣,金沙鎮,汶沙里,29,35,5.766062603,572,94.2339374,607,21,628,0,1029,61.03012634
金門縣,金沙鎮,汶沙里,30,43,5.733333333,707,94.26666667,750,20,770,0,1166,66.03773585
金門縣,金沙鎮,三山里,35,16,3.245436105,477,96.75456389,493,28,521,0,816,63.84803922
金門縣,金沙鎮,大洋里,36,12,3.715170279,311,96.28482972,323,15,338,0,498,67.87148594
金門縣,金沙鎮,光前里,37,28,5.035971223,528,94.96402878,556,11,567,0,882,64.28571429
金門縣,金沙鎮,何斗里,31,29,5.37037037,511,94.62962963,540,21,561,0,866,64.78060046
金門縣,金沙鎮,西園里,33,19,5.09383378,354,94.90616622,373,29,402,0,650,61.84615385
金門縣,金沙鎮,官嶼里,34,18,3.887688985,445,96.11231102,463,31,494,0,809,61.06304079
金門縣,金沙鎮,浦山里,32,28,4.794520548,556,95.20547945,584,45,629,0,942,66.77282378
金門縣,烈嶼鄉,上岐村,42,34,5.222734255,617,94.77726575,651,43,694,0,1104,62.86231884
金門縣,烈嶼鄉,上林村,41,4,1.298701299,304,98.7012987,308,21,329,0,579,56.82210708
金門縣,烈嶼鄉,西口村,40,16,3.48583878,443,96.51416122,459,2,461,0,826,55.81113801
金門縣,烈嶼鄉,林湖村,38,33,4.125,767,95.875,800,29,829,0,1314,63.08980213
金門縣,烈嶼鄉,黃埔村,39,10,3.039513678,319,96.96048632,329,4,333,0,574,58.01393728
金門縣,烏坵鄉,大坵村,43,6,10,54,90,60,0,60,0,106,56.60377358
金門縣,烏坵鄉,小坵村,44,4,6.557377049,57,93.44262295,61,0,61,0,160,38.125
連江縣,南竿鄉,介壽村,1,47,5.465116279,813,94.53488372,860,25,885,0,1294,68.39258114
連江縣,南竿鄉,復興村,2,56,7.272727273,714,92.72727273,770,33,803,0,1164,68.9862543
連江縣,南竿鄉,福沃村,2,56,7.272727273,714,92.72727273,770,33,803,0,1164,68.9862543
連江縣,南竿鄉,清水村,3,67,7.494407159,827,92.50559284,894,27,921,0,1414,65.13437058
連江縣,南竿鄉,仁愛村,3,67,7.494407159,827,92.50559284,894,27,921,0,1414,65.13437058
連江縣,南竿鄉,津沙村,3,67,7.494407159,827,92.50559284,894,27,921,0,1414,65.13437058
連江縣,南竿鄉,馬祖村,3,67,7.494407159,827,92.50559284,894,27,921,0,1414,65.13437058
連江縣,南竿鄉,珠螺村,3,67,7.494407159,827,92.50559284,894,27,921,0,1414,65.13437058
連江縣,南竿鄉,四維村,3,67,7.494407159,827,92.50559284,894,27,921,0,1414,65.13437058
連江縣,北竿鄉,塘岐村,4,34,6.23853211,511,93.76146789,545,9,554,1,932,59.44206009
連江縣,北竿鄉,后沃村,4,34,6.23853211,511,93.76146789,545,9,554,1,932,59.44206009
連江縣,北竿鄉,橋仔村,4,34,6.23853211,511,93.76146789,545,9,554,1,932,59.44206009
連江縣,北竿鄉,芹壁村,5,9,3.529411765,246,96.47058824,255,6,261,0,449,58.12917595
連江縣,北竿鄉,板里村,5,9,3.529411765,246,96.47058824,255,6,261,0,449,58.12917595
連江縣,北竿鄉,白沙村,5,9,3.529411765,246,96.47058824,255,6,261,0,449,58.12917595
連江縣,莒光鄉,青帆村,6,12,4.444444444,258,95.55555556,270,3,273,0,460,59.34782609
連江縣,莒光鄉,田沃村,6,12,4.444444444,258,95.55555556,270,3,273,0,460,59.34782609
連江縣,莒光鄉,西坵村,6,12,4.444444444,258,95.55555556,270,3,273,0,460,59.34782609
連江縣,莒光鄉,福正村,7,6,2.542372881,230,97.45762712,236,6,242,0,379,63.85224274
連江縣,莒光鄉,大坪村,7,6,2.542372881,230,97.45762712,236,6,242,0,379,63.85224274
連江縣,東引鄉,中柳村,8,17,3.556485356,461,96.44351464,478,8,486,0,647,75.11591963
連江縣,東引鄉,樂華村,8,17,3.556485356,461,96.44351464,478,8,486,0,647,75.11591963
臺北市,北投區,建民里,1,717,46.52822842,824,53.47177158,1541,27,1568,1,1870,83.85026738
臺北市,北投區,建民里,2,888,56.16698292,693,43.83301708,1581,32,1613,0,1963,82.17014773
臺北市,北投區,文林里,3,857,56.94352159,648,43.05647841,1505,33,1538,0,1822,84.41273326
臺北市,北投區,文林里,4,784,52.05843293,722,47.94156707,1506,26,1532,0,1818,84.26842684
臺北市,北投區,石牌里,5,625,53.51027397,543,46.48972603,1168,21,1189,0,1427,83.32165382
臺北市,北投區,石牌里,6,628,53.67521368,542,46.32478632,1170,28,1198,0,1407,85.14570007
臺北市,北投區,石牌里,7,624,53.1516184,550,46.8483816,1174,19,1193,0,1451,82.2191592
臺北市,北投區,福興里,8,769,50.22860875,762,49.77139125,1531,35,1566,0,1845,84.87804878
臺北市,北投區,福興里,9,848,54.01273885,722,45.98726115,1570,37,1607,0,1916,83.87265136
臺北市,北投區,福興里,10,606,44.78935698,747,55.21064302,1353,17,1370,0,1592,86.05527638
臺北市,北投區,榮光里,11,786,53.03643725,696,46.96356275,1482,27,1509,0,1885,80.0530504
臺北市,北投區,榮光里,12,846,51.08695652,810,48.91304348,1656,30,1686,0,1955,86.24040921
臺北市,北投區,榮光里,13,612,39.71447112,929,60.28552888,1541,23,1564,0,1863,83.95061728
臺北市,北投區,榮華里,14,482,40.60657119,705,59.39342881,1187,21,1208,0,1500,80.53333333
臺北市,北投區,榮華里,15,540,43.44328238,703,56.55671762,1243,17,1260,0,1597,78.89793363
臺北市,北投區,榮華里,16,622,48.40466926,663,51.59533074,1285,22,1307,0,1569,83.3014659
臺北市,北投區,榮華里,17,527,44.62320068,654,55.37679932,1181,14,1195,0,1417,84.33309809
臺北市,北投區,裕民里,18,672,44.53280318,837,55.46719682,1509,34,1543,0,1881,82.03083466
臺北市,北投區,裕民里,19,705,47.95918367,765,52.04081633,1470,17,1487,0,1782,83.44556678
臺北市,北投區,裕民里,20,694,47.30743013,773,52.69256987,1467,41,1508,1,1784,84.52914798
臺北市,北投區,振華里,21,585,40.68150209,853,59.31849791,1438,24,1462,0,1736,84.21658986
臺北市,北投區,振華里,22,679,45.3271028,819,54.6728972,1498,34,1532,0,1834,83.53326063
臺北市,北投區,振華里,23,512,44.52173913,638,55.47826087,1150,21,1171,0,1417,82.63937897
臺北市,北投區,振華里,24,596,50.50847458,584,49.49152542,1180,24,1204,0,1454,82.80605227
臺北市,北投區,永和里,25,689,52.47524752,624,47.52475248,1313,40,1353,0,1664,81.31009615
臺北市,北投區,永和里,26,595,46.73998429,678,53.26001571,1273,20,1293,0,1586,81.5258512
臺北市,北投區,永和里,27,726,46.89922481,822,53.10077519,1548,41,1589,0,1955,81.27877238
臺北市,北投區,永和里,28,482,43.81818182,618,56.18181818,1100,9,1109,0,1401,79.15774447
臺北市,北投區,永欣里,29,539,37.6396648,893,62.3603352,1432,24,1456,0,1777,81.93584693
臺北市,北投區,永欣里,30,463,32.33240223,969,67.66759777,1432,16,1448,0,1774,81.62344983
臺北市,北投區,永欣里,31,609,43.40698503,794,56.59301497,1403,30,1433,1,1768,81.0520362
臺北市,北投區,永明里,32,728,48.24387011,781,51.75612989,1509,29,1538,0,1847,83.27016784
臺北市,北投區,永明里,33,593,42.17638691,813,57.82361309,1406,28,1434,0,1730,82.89017341
臺北市,北投區,東華里,34,652,43.06472919,862,56.93527081,1514,27,1541,0,1814,84.95038589
臺北市,北投區,東華里,35,640,41.39715395,906,58.60284605,1546,20,1566,0,1818,86.13861386
臺北市,北投區,吉利里,36,593,43.44322344,772,56.55677656,1365,19,1384,0,1661,83.32329922
臺北市,北投區,吉利里,37,633,43.77593361,813,56.22406639,1446,28,1474,0,1794,82.16276477
臺北市,北投區,吉利里,38,553,38.7254902,875,61.2745098,1428,27,1455,0,1737,83.76511226
臺北市,北投區,吉慶里,39,873,55.0094518,714,44.9905482,1587,18,1605,0,1897,84.60727464
臺北市,北投區,吉慶里,40,893,50.39503386,879,49.60496614,1772,35,1807,0,2146,84.20316869
臺北市,北投區,尊賢里,41,801,50.72830906,778,49.27169094,1579,35,1614,1,1941,83.15301391
臺北市,北投區,尊賢里,42,887,56.96852922,670,43.03147078,1557,34,1591,0,1907,83.42947037
臺北市,北投區,立賢里,43,602,51.76268272,561,48.23731728,1163,29,1192,0,1445,82.49134948
臺北市,北投區,立賢里,44,542,50.55970149,530,49.44029851,1072,20,1092,0,1266,86.25592417
臺北市,北投區,立賢里,45,586,50.69204152,570,49.30795848,1156,24,1180,0,1455,81.09965636
臺北市,北投區,立農里,46,706,46.44736842,814,53.55263158,1520,10,1530,0,1789,85.52263835
臺北市,北投區,立農里,47,794,53.61242404,687,46.38757596,1481,18,1499,0,1768,84.78506787
臺北市,北投區,立農里,48,664,52.11930926,610,47.88069074,1274,29,1303,0,1536,84.83072917
臺北市,北投區,立農里,49,692,50,692,50,1384,22,1406,0,1653,85.05747126
臺北市,北投區,八仙里,50,835,54.18559377,706,45.81440623,1541,29,1570,0,1899,82.67509215
臺北市,北投區,八仙里,51,860,52.21615058,787,47.78384942,1647,39,1686,0,2047,82.36443576
臺北市,北投區,洲美里,52,835,70.22708158,354,29.77291842,1189,25,1214,0,1459,83.20767649
臺北市,北投區,奇岩里,53,709,52.09404849,652,47.90595151,1361,40,1401,0,1701,82.3633157
臺北市,北投區,奇岩里,54,642,43.97260274,818,56.02739726,1460,30,1490,0,1781,83.66086468
臺北市,北投區,奇岩里,55,708,47.45308311,784,52.54691689,1492,37,1529,0,1836,83.2788671
臺北市,北投區,奇岩里,56,933,50.43243243,917,49.56756757,1850,35,1885,0,2348,80.28109029
臺北市,北投區,清江里,57,887,58.31689678,634,41.68310322,1521,39,1560,0,2382,65.49118388
臺北市,北投區,清江里,58,810,54.91525424,665,45.08474576,1475,38,1513,0,1849,81.82801514
臺北市,北投區,清江里,59,896,54.46808511,749,45.53191489,1645,36,1681,2,2013,83.50720318
臺北市,北投區,清江里,60,431,40.93067426,622,59.06932574,1053,22,1075,0,1268,84.77917981
臺北市,北投區,中央里,61,691,56.13322502,540,43.86677498,1231,30,1261,0,1522,82.85151117
臺北市,北投區,中央里,62,690,57.1192053,518,42.8807947,1208,30,1238,0,1516,81.66226913
臺北市,北投區,中央里,63,680,55.46492659,546,44.53507341,1226,21,1247,0,1572,79.32569975
臺北市,北投區,中央里,64,638,53.52348993,554,46.47651007,1192,22,1214,0,1475,82.30508475
臺北市,北投區,長安里,65,680,51.98776758,628,48.01223242,1308,31,1339,0,1579,84.80050665
臺北市,北投區,長安里,66,617,51.24584718,587,48.75415282,1204,30,1234,0,1500,82.26666667
臺北市,北投區,長安里,67,607,50.49916805,595,49.50083195,1202,27,1229,0,1555,79.03536977
臺北市,北投區,大同里,68,708,57.46753247,524,42.53246753,1232,39,1271,0,1505,84.45182724
臺北市,北投區,大同里,69,724,58.05934242,523,41.94065758,1247,23,1270,0,1554,81.72458172
臺北市,北投區,大同里,70,674,46.41873278,778,53.58126722,1452,18,1470,0,1758,83.61774744
臺北市,北投區,溫泉里,71,736,53.8405267,631,46.1594733,1367,12,1379,0,1671,82.52543387
臺北市,北投區,溫泉里,72,594,44.56114029,739,55.43885971,1333,17,1350,0,1686,80.07117438
臺北市,北投區,溫泉里,73,640,44.19889503,808,55.80110497,1448,12,1460,0,1771,82.43929983
臺北市,北投區,林泉里,74,233,22.95566502,782,77.04433498,1015,21,1036,0,1321,78.42543528
臺北市,北投區,林泉里,75,491,45.00458295,600,54.99541705,1091,26,1117,0,1454,76.82255846
臺北市,北投區,中心里,76,465,43.05555556,615,56.94444444,1080,29,1109,0,1433,77.39009072
臺北市,北投區,中心里,77,592,45.64379337,705,54.35620663,1297,29,1326,0,1651,80.31496063
臺北市,北投區,中心里,78,657,49.58490566,668,50.41509434,1325,25,1350,0,1734,77.85467128
臺北市,北投區,中庸里,79,680,53.54330709,590,46.45669291,1270,28,1298,0,1553,83.58016742
臺北市,北投區,中庸里,80,777,51.08481262,744,48.91518738,1521,33,1554,0,1881,82.61562998
臺北市,北投區,開明里,81,597,43.13583815,787,56.86416185,1384,18,1402,0,1704,82.27699531
臺北市,北投區,開明里,82,586,41.50141643,826,58.49858357,1412,31,1443,0,1759,82.0352473
臺北市,北投區,開明里,83,686,50.10956903,683,49.89043097,1369,34,1403,0,1720,81.56976744
臺北市,北投區,中和里,84,592,43.30651061,775,56.69348939,1367,23,1390,1,1689,82.29721729
臺北市,北投區,中和里,85,464,48.2830385,497,51.7169615,961,31,992,1,1189,83.431455
臺北市,北投區,中和里,86,394,40.12219959,588,59.87780041,982,22,1004,0,1196,83.94648829
臺北市,北投區,智仁里,87,505,41.66666667,707,58.33333333,1212,27,1239,0,1482,83.60323887
臺北市,北投區,智仁里,88,606,43.47202296,788,56.52797704,1394,30,1424,0,1682,84.66111772
臺北市,北投區,智仁里,89,560,41.48148148,790,58.51851852,1350,22,1372,0,1645,83.40425532
臺北市,北投區,秀山里,90,515,45.1754386,625,54.8245614,1140,17,1157,0,1424,81.25
臺北市,北投區,秀山里,91,500,42.62574595,673,57.37425405,1173,32,1205,0,1473,81.80583842
臺北市,北投區,文化里,92,331,22.98611111,1109,77.01388889,1440,22,1462,0,1710,85.49707602
臺北市,北投區,文化里,93,496,35.53008596,900,64.46991404,1396,18,1414,0,1652,85.59322034
臺北市,北投區,豐年里,94,634,44.27374302,798,55.72625698,1432,25,1457,0,1751,83.20959452
臺北市,北投區,豐年里,95,628,48.94777864,655,51.05222136,1283,32,1315,0,1597,82.34189105
臺北市,北投區,稻香里,96,654,41.76245211,912,58.23754789,1566,47,1613,0,1981,81.42352347
臺北市,北投區,稻香里,97,623,42.12305612,856,57.87694388,1479,22,1501,0,1937,77.49096541
臺北市,北投區,桃源里,98,843,51.972873,779,48.027127,1622,44,1666,0,1944,85.69958848
臺北市,北投區,桃源里,99,1017,56.59432387,780,43.40567613,1797,25,1822,0,2226,81.85085355
臺北市,北投區,一德里,100,910,63.10679612,532,36.89320388,1442,35,1477,0,1787,82.65249021
臺北市,北投區,一德里,101,854,55.6714472,680,44.3285528,1534,38,1572,0,1940,81.03092784
臺北市,北投區,一德里,102,554,50.40946315,545,49.59053685,1099,39,1138,0,1370,83.06569343
臺北市,北投區,關渡里,103,715,48.54039375,758,51.45960625,1473,38,1511,0,1825,82.79452055
臺北市,北投區,關渡里,104,661,52.21169036,605,47.78830964,1266,31,1297,0,1599,81.11319575
臺北市,北投區,關渡里,105,702,47.14573539,787,52.85426461,1489,29,1518,0,1821,83.36079077
臺北市,北投區,關渡里,106,706,52.60804769,636,47.39195231,1342,24,1366,0,1654,82.58766626
臺北市,北投區,關渡里,107,370,39.27813163,572,60.72186837,942,66,1008,0,1267,79.55801105
臺北市,北投區,泉源里,108,168,50.60240964,164,49.39759036,332,9,341,0,414,82.36714976
臺北市,北投區,泉源里,109,708,57.00483092,534,42.99516908,1242,31,1273,0,1543,82.50162022
臺北市,北投區,湖山里,110,327,56.18556701,255,43.81443299,582,21,603,0,718,83.98328691
臺北市,北投區,湖山里,111,334,43.32036316,437,56.67963684,771,26,797,0,989,80.58645096
臺北市,北投區,大屯里,112,512,67.19160105,250,32.80839895,762,32,794,0,990,80.2020202
臺北市,北投區,湖田里,113,322,54.39189189,270,45.60810811,592,19,611,0,746,81.90348525
臺北市,士林區,仁勇里,114,883,58.16864295,635,41.83135705,1518,26,1544,0,1866,82.74383708
臺北市,士林區,仁勇里,115,690,50.66079295,672,49.33920705,1362,18,1380,0,1654,83.43409915
臺北市,士林區,義信里,116,456,48.10126582,492,51.89873418,948,31,979,0,1201,81.51540383
臺北市,士林區,義信里,117,601,51.54373928,565,48.45626072,1166,33,1199,0,1469,81.62014976
臺北市,士林區,福林里,118,177,19.68854283,722,80.31145717,899,17,916,0,1134,80.77601411
臺北市,士林區,福林里,119,238,41.75438596,332,58.24561404,570,1,571,0,735,77.68707483
臺北市,士林區,福林里,120,572,50.13146363,569,49.86853637,1141,22,1163,0,1397,83.24982105
臺北市,士林區,福德里,121,608,50.75125209,590,49.24874791,1198,20,1218,1,1495,81.47157191
臺北市,士林區,福德里,122,525,47.81420765,573,52.18579235,1098,27,1125,0,1400,80.35714286
臺北市,士林區,福德里,123,332,46.11111111,388,53.88888889,720,6,726,0,1515,47.92079208
臺北市,士林區,福志里,124,571,37.32026144,959,62.67973856,1530,39,1569,0,1902,82.49211356
臺北市,士林區,福志里,125,691,45.22251309,837,54.77748691,1528,31,1559,0,1869,83.41359016
臺北市,士林區,福志里,126,879,52.79279279,786,47.20720721,1665,25,1690,0,2034,83.08751229
臺北市,士林區,舊佳里,127,722,50.20862309,716,49.79137691,1438,17,1455,0,1752,83.04794521
臺北市,士林區,舊佳里,128,738,53.32369942,646,46.67630058,1384,24,1408,0,1656,85.02415459
臺北市,士林區,舊佳里,129,781,50.9458578,752,49.0541422,1533,37,1570,0,1913,82.07004705
臺北市,士林區,福佳里,130,627,52.25,573,47.75,1200,10,1210,0,1450,83.44827586
臺北市,士林區,福佳里,131,674,52.20759101,617,47.79240899,1291,32,1323,0,1595,82.94670846
臺北市,士林區,福佳里,132,636,50.3164557,628,49.6835443,1264,15,1279,0,1520,84.14473684
臺北市,士林區,福佳里,133,622,50.12087027,619,49.87912973,1241,18,1259,0,1482,84.95276653
臺北市,士林區,後港里,134,752,55.29411765,608,44.70588235,1360,26,1386,0,1699,81.57739847
臺北市,士林區,後港里,135,770,59.55143078,523,40.44856922,1293,20,1313,0,1604,81.85785536
臺北市,士林區,後港里,136,729,55.10204082,594,44.89795918,1323,25,1348,0,1636,82.39608802
臺北市,士林區,後港里,137,640,55.55555556,512,44.44444444,1152,17,1169,0,1411,82.84904323
臺北市,士林區,福中里,138,685,60.51236749,447,39.48763251,1132,23,1155,0,1391,83.03378864
臺北市,士林區,福中里,139,684,57.04753962,515,42.95246038,1199,23,1222,0,1458,83.81344307
臺北市,士林區,福中里,140,744,57.62974438,547,42.37025562,1291,31,1322,0,1589,83.19697923
臺北市,士林區,前港里,141,802,56.96022727,606,43.03977273,1408,24,1432,0,1747,81.96908987
臺北市,士林區,前港里,142,852,57.37373737,633,42.62626263,1485,19,1504,0,1782,84.39955107
臺北市,士林區,百齡里,143,834,56.54237288,641,43.45762712,1475,32,1507,0,1824,82.62061404
臺北市,士林區,百齡里,144,855,54.63258786,710,45.36741214,1565,47,1612,0,1908,84.48637317
臺北市,士林區,百齡里,145,929,54.71142521,769,45.28857479,1698,29,1727,1,2056,83.99805447
臺北市,士林區,承德里,146,574,51.85185185,533,48.14814815,1107,19,1126,0,1386,81.24098124
臺北市,士林區,承德里,147,695,53.0129672,616,46.9870328,1311,30,1341,0,1601,83.76014991
臺北市,士林區,承德里,148,540,44.22604423,681,55.77395577,1221,27,1248,0,1483,84.15374241
臺北市,士林區,福華里,149,725,50.94869993,698,49.05130007,1423,34,1457,0,1830,79.61748634
臺北市,士林區,福華里,150,676,46.84684685,767,53.15315315,1443,42,1485,0,1835,80.92643052
臺北市,士林區,福華里,151,834,53.70251127,719,46.29748873,1553,32,1585,0,1887,83.99576047
臺北市,士林區,明勝里,152,503,49.60552268,511,50.39447732,1014,27,1041,0,1261,82.55352895
臺北市,士林區,明勝里,153,596,53.69369369,514,46.30630631,1110,38,1148,0,1385,82.88808664
臺北市,士林區,明勝里,154,652,57.95555556,473,42.04444444,1125,17,1142,0,1405,81.28113879
臺北市,士林區,福順里,155,734,64.3295355,407,35.6704645,1141,26,1167,0,1446,80.70539419
臺北市,士林區,福順里,156,631,58.80708295,442,41.19291705,1073,25,1098,0,1345,81.63568773
臺北市,士林區,福順里,157,785,60.61776062,510,39.38223938,1295,34,1329,0,1594,83.37515684
臺北市,士林區,富光里,158,801,59.24556213,551,40.75443787,1352,38,1390,0,1707,81.42940832
臺北市,士林區,富光里,159,741,59.23261391,510,40.76738609,1251,34,1285,0,1560,82.37179487
臺北市,士林區,富光里,160,757,59.140625,523,40.859375,1280,16,1296,0,1605,80.74766355
臺北市,士林區,葫蘆里,161,991,60.35322777,651,39.64677223,1642,35,1677,0,1989,84.31372549
臺北市,士林區,葫蘆里,162,929,58.7602783,652,41.2397217,1581,39,1620,0,1944,83.33333333
臺北市,士林區,葫蘆里,163,533,33.92743475,1038,66.07256525,1571,29,1600,0,1877,85.2424081
臺北市,士林區,葫東里,164,812,59.35672515,556,40.64327485,1368,26,1394,0,1677,83.12462731
臺北市,士林區,葫東里,165,720,62.06896552,440,37.93103448,1160,23,1183,0,1456,81.25
臺北市,士林區,社子里,166,833,63.63636364,476,36.36363636,1309,31,1340,0,1590,84.27672956
臺北市,士林區,社子里,167,763,53.88418079,653,46.11581921,1416,29,1445,0,1772,81.5462754
臺北市,士林區,社子里,168,890,62.15083799,542,37.84916201,1432,39,1471,0,1742,84.44316877
臺北市,士林區,社新里,169,870,59.46684894,593,40.53315106,1463,41,1504,0,1762,85.35754824
臺北市,士林區,社新里,170,851,62.61957322,508,37.38042678,1359,44,1403,0,1703,82.38402819
臺北市,士林區,社新里,171,783,60.69767442,507,39.30232558,1290,25,1315,0,1605,81.93146417
臺北市,士林區,社新里,172,750,58.45674201,533,41.54325799,1283,33,1316,1,1635,80.48929664
臺北市,士林區,社園里,173,885,61.24567474,560,38.75432526,1445,22,1467,0,1734,84.60207612
臺北市,士林區,社園里,174,1028,61.74174174,637,38.25825826,1665,35,1700,0,2011,84.53505719
臺北市,士林區,社園里,175,990,62.93706294,583,37.06293706,1573,29,1602,0,1926,83.17757009
臺北市,士林區,永倫里,176,1010,64.99356499,544,35.00643501,1554,40,1594,0,1912,83.36820084
臺北市,士林區,永倫里,177,921,57.20496894,689,42.79503106,1610,36,1646,0,1982,83.04742684
臺北市,士林區,永倫里,178,1031,64.0770665,578,35.9229335,1609,45,1654,0,1992,83.03212851
臺北市,士林區,福安里,179,840,76.15593835,263,23.84406165,1103,24,1127,0,1346,83.72956909
臺北市,士林區,福安里,180,824,78.92720307,220,21.07279693,1044,18,1062,0,1284,82.71028037
臺北市,士林區,福安里,181,823,74.2110009,286,25.7889991,1109,32,1141,0,1344,84.89583333
臺北市,士林區,富洲里,182,817,71.79261863,321,28.20738137,1138,41,1179,0,1415,83.32155477
臺北市,士林區,富洲里,183,776,70.67395264,322,29.32604736,1098,41,1139,0,1357,83.93515107
臺北市,士林區,富洲里,184,955,67.97153025,450,32.02846975,1405,26,1431,0,1687,84.82513337
臺北市,士林區,岩山里,185,464,39.02439024,725,60.97560976,1189,26,1215,0,1581,76.85009488
臺北市,士林區,岩山里,186,460,36.45007924,802,63.54992076,1262,15,1277,0,1538,83.02990897
臺北市,士林區,名山里,187,631,41.02730819,907,58.97269181,1538,26,1564,0,1884,83.014862
臺北市,士林區,名山里,188,605,40.98915989,871,59.01084011,1476,38,1514,0,1851,81.79362507
臺北市,士林區,名山里,189,784,47.54396604,865,52.45603396,1649,21,1670,0,1985,84.13098237
臺北市,士林區,德行里,190,612,47.04073789,689,52.95926211,1301,16,1317,1,1609,81.85208204
臺北市,士林區,德行里,191,735,53.49344978,639,46.50655022,1374,23,1397,0,1706,81.88745604
臺北市,士林區,德華里,192,575,51.20213713,548,48.79786287,1123,10,1133,0,1378,82.22060958
臺北市,士林區,德華里,193,678,52.63975155,610,47.36024845,1288,32,1320,0,1594,82.81053952
臺北市,士林區,德華里,194,711,54.44104135,595,45.55895865,1306,23,1329,0,1616,82.24009901
臺北市,士林區,聖山里,195,484,46.05137964,567,53.94862036,1051,20,1071,0,1330,80.52631579
臺北市,士林區,聖山里,196,567,47.36842105,630,52.63157895,1197,15,1212,0,1462,82.9001368
臺北市,士林區,聖山里,197,227,18.65242399,990,81.34757601,1217,25,1242,0,1467,84.66257669
臺北市,士林區,忠誠里,198,245,18.64535769,1069,81.35464231,1314,14,1328,0,1552,85.56701031
臺北市,士林區,忠誠里,199,416,33.49436393,826,66.50563607,1242,19,1261,0,1467,85.95773688
臺北市,士林區,忠誠里,200,536,41.5503876,754,58.4496124,1290,13,1303,0,1584,82.26010101
臺北市,士林區,芝山里,201,750,48.41833441,799,51.58166559,1549,23,1572,0,1893,83.04278922
臺北市,士林區,芝山里,202,711,42.72836538,953,57.27163462,1664,23,1687,0,2000,84.35
臺北市,士林區,芝山里,203,653,43.62057448,844,56.37942552,1497,24,1521,0,1843,82.52848616
臺北市,士林區,東山里,204,341,31.75046555,733,68.24953445,1074,18,1092,0,1295,84.32432432
臺北市,士林區,東山里,205,404,34.52991453,766,65.47008547,1170,27,1197,0,1418,84.41466855
臺北市,士林區,東山里,206,435,38.97849462,681,61.02150538,1116,20,1136,0,1346,84.39821694
臺北市,士林區,三玉里,207,546,45.16129032,663,54.83870968,1209,14,1223,0,1480,82.63513514
臺北市,士林區,三玉里,208,627,48.60465116,663,51.39534884,1290,23,1313,0,1583,82.94377764
臺北市,士林區,三玉里,209,627,51.2254902,597,48.7745098,1224,11,1235,0,1513,81.62590879
臺北市,士林區,蘭雅里,210,628,46.41537324,725,53.58462676,1353,29,1382,0,1738,79.51668585
臺北市,士林區,蘭雅里,211,582,47.94069193,632,52.05930807,1214,26,1240,0,1540,80.51948052
臺北市,士林區,蘭雅里,212,632,46.64206642,723,53.35793358,1355,21,1376,0,1692,81.32387707
臺北市,士林區,蘭雅里,213,704,48.71972318,741,51.28027682,1445,22,1467,0,1806,81.22923588
臺北市,士林區,蘭興里,214,676,50.78888054,655,49.21111946,1331,27,1358,0,1660,81.80722892
臺北市,士林區,蘭興里,215,633,48.69230769,667,51.30769231,1300,20,1320,0,1574,83.86277001
臺北市,士林區,蘭興里,216,697,49.25795053,718,50.74204947,1415,23,1438,0,1731,83.073368
臺北市,士林區,天福里,217,644,45.64138909,767,54.35861091,1411,23,1434,0,1697,84.50206246
臺北市,士林區,天福里,218,668,46.58298466,766,53.41701534,1434,23,1457,0,1759,82.83115406
臺北市,士林區,天福里,219,473,38.96210873,741,61.03789127,1214,16,1230,0,1546,79.56015524
臺北市,士林區,天祿里,220,544,46.69527897,621,53.30472103,1165,23,1188,0,1458,81.48148148
臺北市,士林區,天祿里,221,570,46.64484452,652,53.35515548,1222,19,1241,0,1444,85.94182825
臺北市,士林區,天祿里,222,539,52.27934045,492,47.72065955,1031,20,1051,0,1298,80.97072419
臺北市,士林區,天壽里,223,751,48.89322917,785,51.10677083,1536,18,1554,0,1866,83.27974277
臺北市,士林區,天壽里,224,648,42.8005284,866,57.1994716,1514,26,1540,0,1917,80.33385498
臺北市,士林區,天和里,225,527,44.24853065,664,55.75146935,1191,20,1211,0,1463,82.77511962
臺北市,士林區,天和里,226,524,42.81045752,700,57.18954248,1224,22,1246,1,1504,82.84574468
臺北市,士林區,天和里,227,477,40.08403361,713,59.91596639,1190,17,1207,0,1538,78.47854356
臺北市,士林區,天和里,228,542,46.64371773,620,53.35628227,1162,21,1183,0,1446,81.81189488
臺北市,士林區,天山里,229,631,43.84989576,808,56.15010424,1439,24,1463,0,1810,80.82872928
臺北市,士林區,天山里,230,618,43.24702589,811,56.75297411,1429,24,1453,0,1797,80.85698386
臺北市,士林區,天山里,231,710,46.49639817,817,53.50360183,1527,17,1544,0,1966,78.53509664
臺北市,士林區,天玉里,232,615,44.6298984,763,55.3701016,1378,18,1396,0,1728,80.78703704
臺北市,士林區,天玉里,233,576,45.28301887,696,54.71698113,1272,23,1295,0,1575,82.22222222
臺北市,士林區,天玉里,234,601,43.29971182,787,56.70028818,1388,18,1406,0,1734,81.08419839
臺北市,士林區,天玉里,235,570,43.47826087,741,56.52173913,1311,24,1335,0,1667,80.0839832
臺北市,士林區,天母里,236,630,46.59763314,722,53.40236686,1352,21,1373,0,1676,81.92124105
臺北市,士林區,天母里,237,574,41.26527678,817,58.73472322,1391,34,1425,0,1805,78.94736842
臺北市,士林區,天母里,238,545,41.38192863,772,58.61807137,1317,22,1339,0,1640,81.64634146
臺北市,士林區,永福里,239,562,61.35371179,354,38.64628821,916,14,930,0,1144,81.29370629
臺北市,士林區,公館里,240,644,65.58044807,338,34.41955193,982,32,1014,0,1247,81.31515638
臺北市,士林區,新安里,241,803,57.56272401,592,42.43727599,1395,39,1434,0,1757,81.61639158
臺北市,士林區,陽明里,242,467,61.44736842,293,38.55263158,760,3,763,0,957,79.72831766
臺北市,士林區,陽明里,243,343,44.54545455,427,55.45454545,770,20,790,0,1041,75.88856868
臺北市,士林區,陽明里,244,230,36.50793651,400,63.49206349,630,20,650,0,826,78.69249395
臺北市,士林區,菁山里,245,641,57.90424571,466,42.09575429,1107,32,1139,0,1386,82.17893218
臺北市,士林區,平等里,246,731,73.83838384,259,26.16161616,990,27,1017,0,1197,84.96240602
臺北市,士林區,溪山里,247,611,61.71717172,379,38.28282828,990,35,1025,0,1251,81.93445244
臺北市,士林區,翠山里,248,243,22.85983067,820,77.14016933,1063,20,1083,0,1307,82.86151492
臺北市,士林區,翠山里,249,229,22.69573835,780,77.30426165,1009,18,1027,0,1255,81.83266932
臺北市,士林區,臨溪里,250,458,41.3730804,649,58.6269196,1107,31,1138,0,1405,80.99644128
臺北市,士林區,臨溪里,251,352,43.1372549,464,56.8627451,816,9,825,0,1061,77.75683318
臺北市,中山區,正守里,252,534,47.89237668,581,52.10762332,1115,25,1140,2,1458,78.18930041
臺北市,中山區,正守里,253,439,52.95536791,390,47.04463209,829,25,854,0,1022,83.56164384
臺北市,中山區,正義里,254,649,43.23784144,852,56.76215856,1501,21,1522,0,2045,74.42542787
臺北市,中山區,正義里,255,568,44.75965327,701,55.24034673,1269,36,1305,0,1663,78.47263981
臺北市,中山區,正得里,256,353,47.31903485,393,52.68096515,746,13,759,0,959,79.14494265
臺北市,中山區,正得里,257,535,42.90296712,712,57.09703288,1247,22,1269,0,1703,74.51556078
臺北市,中山區,民安里,258,738,50.82644628,714,49.17355372,1452,21,1473,0,1865,78.98123324
臺北市,中山區,民安里,259,968,54.04801787,823,45.95198213,1791,14,1805,1,2295,78.64923747
臺北市,中山區,康樂里,260,591,42.48741912,800,57.51258088,1391,37,1428,0,1904,75
臺北市,中山區,中山里,261,578,44.1221374,732,55.8778626,1310,17,1327,1,1689,78.56719953
臺北市,中山區,中山里,262,505,46.07664234,591,53.92335766,1096,20,1116,0,1498,74.49933244
臺北市,中山區,中山里,263,524,49.48064212,535,50.51935788,1059,16,1075,0,1378,78.01161103
臺北市,中山區,聚盛里,264,517,50.48828125,507,49.51171875,1024,28,1052,0,1412,74.50424929
臺北市,中山區,聚盛里,265,494,47.59152216,544,52.40847784,1038,31,1069,0,1439,74.28769979
臺北市,中山區,集英里,266,652,56.89354276,494,43.10645724,1146,42,1188,0,1426,83.30995792
臺北市,中山區,集英里,267,923,57.65146783,678,42.34853217,1601,25,1626,0,2053,79.20116902
臺北市,中山區,集英里,268,536,51.34099617,508,48.65900383,1044,17,1061,0,1344,78.94345238
臺北市,中山區,聚葉里,269,504,47.59206799,555,52.40793201,1059,24,1083,0,1412,76.69971671
臺北市,中山區,聚葉里,270,676,49.96304508,677,50.03695492,1353,22,1375,0,1723,79.80266976
臺北市,中山區,恆安里,271,553,51.87617261,513,48.12382739,1066,37,1103,1,1421,77.62139338
臺北市,中山區,恆安里,272,432,44.30769231,543,55.69230769,975,14,989,0,1304,75.84355828
臺北市,中山區,晴光里,273,543,43.44,707,56.56,1250,24,1274,0,1658,76.83956574
臺北市,中山區,晴光里,274,620,46.30321135,719,53.69678865,1339,53,1392,0,1851,75.20259319
臺北市,中山區,圓山里,275,747,52.45786517,677,47.54213483,1424,19,1443,0,1838,78.50924918
臺北市,中山區,圓山里,276,481,51.72043011,449,48.27956989,930,29,959,0,1212,79.12541254
臺北市,中山區,劍潭里,279,146,11.97703035,1073,88.02296965,1219,24,1243,0,1517,81.9380356
臺北市,中山區,劍潭里,280,219,16.1385409,1138,83.8614591,1357,30,1387,0,1660,83.55421687
臺北市,中山區,大直里,281,424,37.72241993,700,62.27758007,1124,14,1138,0,1381,82.40405503
臺北市,中山區,大直里,282,565,37.5914837,938,62.4085163,1503,23,1526,0,1796,84.96659243
臺北市,中山區,大直里,283,545,41.79447853,759,58.20552147,1304,18,1322,1,1565,84.47284345
臺北市,中山區,大直里,284,469,39.9829497,704,60.0170503,1173,23,1196,0,1446,82.71092669
臺北市,中山區,大直里,285,508,41.36807818,720,58.63192182,1228,25,1253,0,1555,80.57877814
臺北市,中山區,成功里,286,902,43.89294404,1153,56.10705596,2055,41,2096,0,2438,85.97210829
臺北市,中山區,永安里,287,615,41.95088677,851,58.04911323,1466,26,1492,0,1790,83.35195531
臺北市,中山區,永安里,288,634,48.2863671,679,51.7136329,1313,13,1326,0,1551,85.49323017
臺北市,中山區,永安里,289,509,43.99308557,648,56.00691443,1157,14,1171,0,1417,82.63937897
臺北市,中山區,永安里,290,638,41.37483787,904,58.62516213,1542,27,1569,0,1885,83.23607427
臺北市,中山區,大佳里,291,551,67.69041769,263,32.30958231,814,5,819,0,970,84.43298969
臺北市,中山區,新喜里,292,894,56.12052731,699,43.87947269,1593,34,1627,0,1943,83.73648996
臺北市,中山區,新喜里,293,828,51.14268067,791,48.85731933,1619,21,1640,0,2086,78.61936721
臺北市,中山區,新庄里,277,783,46.35879218,906,53.64120782,1689,28,1717,0,2112,81.29734848
臺北市,中山區,新庄里,278,888,56.70498084,678,43.29501916,1566,23,1589,0,1921,82.71733472
臺北市,中山區,新福里,294,1022,59.66141273,691,40.33858727,1713,38,1751,0,2202,79.51861944
臺北市,中山區,新福里,295,788,51.94462755,729,48.05537245,1517,25,1542,0,1990,77.48743719
臺北市,中山區,松江里,296,772,52.73224044,692,47.26775956,1464,24,1488,1,1792,83.03571429
臺北市,中山區,松江里,297,796,53.42281879,694,46.57718121,1490,28,1518,0,1901,79.8527091
臺北市,中山區,松江里,298,526,48.5687904,557,51.4312096,1083,29,1112,0,1379,80.63814358
臺北市,中山區,新生里,299,537,52.75049116,481,47.24950884,1018,26,1044,0,1271,82.14004721
臺北市,中山區,新生里,300,581,52.57918552,524,47.42081448,1105,16,1121,0,1366,82.06442167
臺北市,中山區,新生里,301,641,58.48540146,455,41.51459854,1096,25,1121,0,1399,80.12866333
臺北市,中山區,中庄里,302,702,54.6728972,582,45.3271028,1284,39,1323,0,1648,80.27912621
臺北市,中山區,中庄里,303,591,54.26997245,498,45.73002755,1089,36,1125,0,1422,79.11392405
臺北市,中山區,中庄里,304,655,53.90946502,560,46.09053498,1215,33,1248,0,1533,81.40900196
臺北市,中山區,行政里,305,697,51.40117994,659,48.59882006,1356,27,1383,0,1699,81.40082401
臺北市,中山區,行政里,306,607,52.59965338,547,47.40034662,1154,18,1172,0,1443,81.21968122
臺北市,中山區,行政里,307,566,47.08818636,636,52.91181364,1202,21,1223,0,2435,50.22587269
臺北市,中山區,行仁里,308,879,53.40218712,767,46.59781288,1646,25,1671,0,2024,82.55928854
臺北市,中山區,行仁里,309,665,54.10903173,564,45.89096827,1229,30,1259,0,1523,82.6657912
臺北市,中山區,行仁里,310,775,53.30123796,679,46.69876204,1454,38,1492,0,1794,83.16610925
臺北市,中山區,行仁里,311,549,50,549,50,1098,25,1123,0,1323,84.88284203
臺北市,中山區,行孝里,312,725,52.49818972,656,47.50181028,1381,23,1404,0,1675,83.82089552
臺北市,中山區,行孝里,313,742,52.32722144,676,47.67277856,1418,23,1441,0,1758,81.96814562
臺北市,中山區,下埤里,314,798,48.62888483,843,51.37111517,1641,22,1663,0,2000,83.15
臺北市,中山區,下埤里,315,792,48.05825243,856,51.94174757,1648,34,1682,0,2063,81.53174988
臺北市,中山區,下埤里,316,841,52.66123982,756,47.33876018,1597,39,1636,0,1982,82.54288597
臺北市,中山區,江寧里,317,715,46.21848739,832,53.78151261,1547,21,1568,0,1882,83.31562168
臺北市,中山區,江寧里,318,631,49.45141066,645,50.54858934,1276,27,1303,1,1564,83.31202046
臺北市,中山區,江寧里,319,733,46.04271357,859,53.95728643,1592,39,1631,0,2040,79.95098039
臺北市,中山區,江山里,320,631,51.55228758,593,48.44771242,1224,24,1248,0,1507,82.81353683
臺北市,中山區,江山里,321,755,54.1218638,640,45.8781362,1395,19,1414,0,1731,81.68688619
臺北市,中山區,江山里,322,694,51.86846039,644,48.13153961,1338,21,1359,0,1657,82.01569101
臺北市,中山區,江山里,323,564,49.1717524,583,50.8282476,1147,27,1174,0,1451,80.90971744
臺北市,中山區,中吉里,324,914,51.17581187,872,48.82418813,1786,29,1815,0,2217,81.86738836
臺北市,中山區,中吉里,325,930,59.19796308,641,40.80203692,1571,31,1602,0,1958,81.81818182
臺北市,中山區,中原里,326,814,54.63087248,676,45.36912752,1490,22,1512,0,1899,79.62085308
臺北市,中山區,中原里,327,763,49.80417755,769,50.19582245,1532,31,1563,0,1966,79.50152594
臺北市,中山區,興亞里,328,718,46.83626875,815,53.16373125,1533,25,1558,0,1973,78.96604156
臺北市,中山區,興亞里,329,875,51.92878338,810,48.07121662,1685,34,1719,0,2187,78.60082305
臺北市,中山區,中央里,330,528,45.05119454,644,54.94880546,1172,22,1194,0,1499,79.65310207
臺北市,中山區,中央里,331,533,47.00176367,601,52.99823633,1134,20,1154,0,1413,81.67020524
臺北市,中山區,朱馥里,332,635,48.84615385,665,51.15384615,1300,36,1336,0,1665,80.24024024
臺北市,中山區,朱馥里,333,579,43.86363636,741,56.13636364,1320,33,1353,0,1674,80.82437276
臺北市,中山區,朱馥里,334,614,44.36416185,770,55.63583815,1384,44,1428,0,1705,83.75366569
臺北市,中山區,龍洲里,335,414,35.14431239,764,64.85568761,1178,21,1199,0,1458,82.23593964
臺北市,中山區,龍洲里,336,217,20,868,80,1085,15,1100,1,1310,83.96946565
臺北市,中山區,龍洲里,337,256,19.55691367,1053,80.44308633,1309,15,1324,0,1575,84.06349206
臺北市,中山區,朱園里,338,816,58.70503597,574,41.29496403,1390,23,1413,0,1750,80.74285714
臺北市,中山區,朱園里,339,626,42.04163868,863,57.95836132,1489,28,1517,0,1880,80.69148936
臺北市,中山區,埤頭里,340,502,39.62115233,765,60.37884767,1267,32,1299,0,1590,81.69811321
臺北市,中山區,埤頭里,341,647,46.18129907,754,53.81870093,1401,34,1435,0,1778,80.70866142
臺北市,中山區,朱崙里,342,482,44.75394615,595,55.24605385,1077,18,1095,0,1364,80.27859238
臺北市,中山區,朱崙里,343,558,58.42931937,397,41.57068063,955,21,976,0,1201,81.26561199
臺北市,中山區,力行里,344,879,58.63909273,620,41.36090727,1499,20,1519,0,1846,82.28602384
臺北市,中山區,力行里,345,577,49.14821124,597,50.85178876,1174,32,1206,0,1555,77.5562701
臺北市,中山區,力行里,346,552,47.50430293,610,52.49569707,1162,24,1186,0,1483,79.97302765
臺北市,中山區,復華里,347,507,37.77943368,835,62.22056632,1342,33,1375,0,1702,80.78730905
臺北市,中山區,復華里,348,497,41.07438017,713,58.92561983,1210,33,1243,1,1531,81.18876551
臺北市,中山區,金泰里,351,811,42.63932702,1091,57.36067298,1902,32,1934,0,2336,82.79109589
臺北市,中山區,金泰里,352,656,44.93150685,804,55.06849315,1460,36,1496,0,1780,84.04494382
臺北市,中山區,北安里,349,343,29.44206009,822,70.55793991,1165,14,1179,0,1389,84.8812095
臺北市,中山區,北安里,350,282,34.98759305,524,65.01240695,806,19,825,0,974,84.70225873
臺北市,大同區,玉泉里,353,710,54.48963929,593,45.51036071,1303,30,1333,0,1673,79.67722654
臺北市,大同區,玉泉里,354,373,41.67597765,522,58.32402235,895,23,918,0,1250,73.44
臺北市,大同區,建明里,355,631,57.36363636,469,42.63636364,1100,21,1121,0,1409,79.55997161
臺北市,大同區,建明里,356,705,62.27915194,427,37.72084806,1132,32,1164,1,1439,80.8895066
臺北市,大同區,建功里,357,831,57.34989648,618,42.65010352,1449,45,1494,0,1878,79.55271565
臺北市,大同區,建功里,358,872,54.98108449,714,45.01891551,1586,47,1633,0,2037,80.16691213
臺北市,大同區,建泰里,359,697,57.84232365,508,42.15767635,1205,21,1226,0,1527,80.28814669
臺北市,大同區,建泰里,360,749,61.59539474,467,38.40460526,1216,24,1240,0,1514,81.90224571
臺北市,大同區,永樂里,361,694,57.54560531,512,42.45439469,1206,32,1238,0,1557,79.51188182
臺北市,大同區,永樂里,362,656,60.74074074,424,39.25925926,1080,17,1097,0,1329,82.54326561
臺北市,大同區,永樂里,363,614,57.4906367,454,42.5093633,1068,28,1096,0,1379,79.47788252
臺北市,大同區,朝陽里,364,720,54.79452055,594,45.20547945,1314,36,1350,0,1683,80.21390374
臺北市,大同區,朝陽里,365,698,57.07277187,525,42.92722813,1223,31,1254,0,1613,77.7433354
臺北市,大同區,星明里,366,593,53.71376812,511,46.28623188,1104,13,1117,0,1370,81.53284672
臺北市,大同區,星明里,367,535,53.55355355,464,46.44644645,999,13,1012,0,1254,80.70175439
臺北市,大同區,星明里,368,606,57.44075829,449,42.55924171,1055,30,1085,0,1361,79.72079353
臺北市,大同區,光能里,369,646,56.07638889,506,43.92361111,1152,17,1169,0,1399,83.55968549
臺北市,大同區,光能里,370,643,60.20599251,425,39.79400749,1068,12,1080,0,1329,81.26410835
臺北市,大同區,光能里,371,730,59.59183673,495,40.40816327,1225,34,1259,1,1514,83.15719947
臺北市,大同區,大有里,372,670,63.56736243,384,36.43263757,1054,17,1071,0,1293,82.83062645
臺北市,大同區,大有里,373,626,54.38748914,525,45.61251086,1151,30,1181,0,1448,81.56077348
臺北市,大同區,大有里,374,659,61.6463985,410,38.3536015,1069,25,1094,0,1319,82.94162244
臺北市,大同區,延平里,375,719,56.171875,561,43.828125,1280,26,1306,0,1655,78.91238671
臺北市,大同區,延平里,376,639,51.95121951,591,48.04878049,1230,24,1254,0,1602,78.27715356
臺北市,大同區,雙連里,377,860,58.86379192,601,41.13620808,1461,33,1494,0,1821,82.04283361
臺北市,大同區,雙連里,378,952,60.36778694,625,39.63221306,1577,15,1592,0,1917,83.04642671
臺北市,大同區,雙連里,379,960,61.02987921,613,38.97012079,1573,23,1596,0,1973,80.89204257
臺北市,大同區,雙連里,380,820,53.07443366,725,46.92556634,1545,37,1582,0,1971,80.26382547
臺北市,大同區,南芳里,381,714,55.34883721,576,44.65116279,1290,30,1320,0,1623,81.33086876
臺北市,大同區,南芳里,382,811,58.72556119,570,41.27443881,1381,36,1417,0,1746,81.15693013
臺北市,大同區,民權里,383,674,47.83534422,735,52.16465578,1409,27,1436,0,1760,81.59090909
臺北市,大同區,民權里,384,770,56.20437956,600,43.79562044,1370,43,1413,0,1715,82.39067055
臺北市,大同區,民權里,385,624,45.25018129,755,54.74981871,1379,27,1406,0,1734,81.08419839
臺北市,大同區,景星里,386,549,56.77352637,418,43.22647363,967,18,985,0,1204,81.81063123
臺北市,大同區,景星里,387,571,60.80937167,368,39.19062833,939,27,966,0,1195,80.83682008
臺北市,大同區,隆和里,388,717,62.23958333,435,37.76041667,1152,23,1175,0,1432,82.05307263
臺北市,大同區,隆和里,389,607,59.10418695,420,40.89581305,1027,24,1051,1,1288,81.59937888
臺北市,大同區,蓬萊里,390,543,55.07099391,443,44.92900609,986,17,1003,0,1272,78.85220126
臺北市,大同區,蓬萊里,391,568,59.10509886,393,40.89490114,961,19,980,0,1240,79.03225806
臺北市,大同區,蓬萊里,392,638,58.21167883,458,41.78832117,1096,22,1118,0,1378,81.13207547
臺北市,大同區,國順里,393,712,68.26462128,331,31.73537872,1043,15,1058,0,1293,81.82521268
臺北市,大同區,國順里,394,643,58.72146119,452,41.27853881,1095,28,1123,0,1378,81.49492017
臺北市,大同區,國慶里,395,718,60.08368201,477,39.91631799,1195,28,1223,0,1486,82.30148048
臺北市,大同區,國慶里,396,734,54.89902767,603,45.10097233,1337,23,1360,0,1677,81.09719738
臺北市,大同區,揚雅里,397,685,63.72093023,390,36.27906977,1075,34,1109,0,1316,84.27051672
臺北市,大同區,揚雅里,398,616,54.70692718,510,45.29307282,1126,33,1159,0,1733,66.87824582
臺北市,大同區,斯文里,399,713,61.04452055,455,38.95547945,1168,50,1218,1,1571,77.53023552
臺北市,大同區,斯文里,400,855,62.09150327,522,37.90849673,1377,9,1386,0,1670,82.99401198
臺北市,大同區,斯文里,401,546,52.65188042,491,47.34811958,1037,32,1069,0,1285,83.19066148
臺北市,大同區,鄰江里,402,930,62.29068989,563,37.70931011,1493,48,1541,0,1863,82.71604938
臺北市,大同區,鄰江里,403,795,60.09070295,528,39.90929705,1323,40,1363,0,1700,80.17647059
臺北市,大同區,鄰江里,404,855,59.9159075,572,40.0840925,1427,28,1455,0,1740,83.62068966
臺北市,大同區,至聖里,405,743,58.68878357,523,41.31121643,1266,23,1289,0,1576,81.7893401
臺北市,大同區,至聖里,406,751,57.41590214,557,42.58409786,1308,23,1331,0,1653,80.52026618
臺北市,大同區,至聖里,407,747,56.89261234,566,43.10738766,1313,15,1328,0,1588,83.62720403
臺北市,大同區,至聖里,408,736,59.6918086,497,40.3081914,1233,26,1259,0,1546,81.43596378
臺北市,大同區,老師里,409,810,60.90225564,520,39.09774436,1330,18,1348,0,1679,80.28588446
臺北市,大同區,老師里,410,675,55.50986842,541,44.49013158,1216,39,1255,0,1528,82.13350785
臺北市,大同區,老師里,411,804,59.91058122,538,40.08941878,1342,25,1367,0,1629,83.9165132
臺北市,大同區,重慶里,412,674,51.60796325,632,48.39203675,1306,30,1336,0,1650,80.96969697
臺北市,大同區,重慶里,413,696,56.49350649,536,43.50649351,1232,24,1256,0,1500,83.73333333
臺北市,大同區,重慶里,414,678,53.09318716,599,46.90681284,1277,28,1305,0,1553,84.03090792
臺北市,大同區,保安里,415,852,62.09912536,520,37.90087464,1372,22,1394,0,1694,82.29043684
臺北市,大同區,保安里,416,965,59.53115361,656,40.46884639,1621,46,1667,1,1993,83.64274962
臺北市,松山區,莊敬里,417,539,42.94820717,716,57.05179283,1255,16,1271,0,1540,82.53246753
臺北市,松山區,莊敬里,418,550,41.76157935,767,58.23842065,1317,26,1343,0,1615,83.15789474
臺北市,松山區,莊敬里,419,525,39.14988814,816,60.85011186,1341,35,1376,0,1676,82.10023866
臺北市,松山區,東榮里,420,607,40.79301075,881,59.20698925,1488,24,1512,0,1854,81.55339806
臺北市,松山區,東榮里,421,519,40.80188679,753,59.19811321,1272,29,1301,0,1605,81.05919003
臺北市,松山區,東榮里,422,708,45.76599871,839,54.23400129,1547,17,1564,0,1868,83.72591006
臺北市,松山區,東榮里,423,489,38.74801902,773,61.25198098,1262,19,1281,0,1592,80.46482412
臺北市,松山區,三民里,424,627,42.7402863,840,57.2597137,1467,21,1488,0,1816,81.93832599
臺北市,松山區,三民里,425,482,30.85787452,1080,69.14212548,1562,17,1579,0,2010,78.55721393
臺北市,松山區,三民里,426,637,42.10178453,876,57.89821547,1513,28,1541,0,1860,82.84946237
臺北市,松山區,新益里,427,628,46.10866373,734,53.89133627,1362,16,1378,0,1688,81.63507109
臺北市,松山區,新益里,428,770,45.21432766,933,54.78567234,1703,22,1725,0,2111,81.7148271
臺北市,松山區,富錦里,429,387,32.5210084,803,67.4789916,1190,18,1208,2,1512,79.89417989
臺北市,松山區,富錦里,430,580,40.38997214,856,59.61002786,1436,18,1454,0,1719,84.5840605
臺北市,松山區,富錦里,431,334,40.93137255,482,59.06862745,816,9,825,0,1027,80.33106134
臺北市,松山區,新東里,432,721,44.72704715,891,55.27295285,1612,30,1642,0,2010,81.69154229
臺北市,松山區,新東里,433,703,43.74611077,904,56.25388923,1607,31,1638,0,2024,80.92885375
臺北市,松山區,富泰里,434,577,38.54375418,920,61.45624582,1497,18,1515,0,1870,81.01604278
臺北市,松山區,富泰里,435,451,30.97527473,1005,69.02472527,1456,16,1472,0,1861,79.09725954
臺北市,松山區,介壽里,436,613,44.77720964,756,55.22279036,1369,28,1397,0,1741,80.24124067
臺北市,松山區,介壽里,437,693,46.29258517,804,53.70741483,1497,21,1518,0,1904,79.72689076
臺北市,松山區,精忠里,438,503,37.12177122,852,62.87822878,1355,12,1367,0,1739,78.60839563
臺北市,松山區,精忠里,439,566,37.85953177,929,62.14046823,1495,15,1510,0,1899,79.51553449
臺北市,松山區,東光里,440,696,44.50127877,868,55.49872123,1564,25,1589,0,2014,78.89771599
臺北市,松山區,東光里,441,606,40.10589014,905,59.89410986,1511,25,1536,0,1936,79.33884298
臺北市,松山區,東光里,442,606,35.39719626,1106,64.60280374,1712,23,1735,0,2156,80.47309833
臺北市,松山區,龍田里,443,406,35.52055993,737,64.47944007,1143,11,1154,0,1446,79.80636238
臺北市,松山區,龍田里,444,403,40.42126379,594,59.57873621,997,15,1012,1,1235,81.94331984
臺北市,松山區,龍田里,445,147,9.392971246,1418,90.60702875,1565,2,1567,0,1938,80.85655315
臺北市,松山區,龍田里,446,517,28.23593665,1314,71.76406335,1831,20,1851,0,2167,85.41762806
臺北市,松山區,東昌里,447,774,44.4572085,967,55.5427915,1741,27,1768,0,2161,81.81397501
臺北市,松山區,東勢里,448,640,44.59930314,795,55.40069686,1435,27,1462,0,1776,82.31981982
臺北市,松山區,東勢里,449,643,46.25899281,747,53.74100719,1390,26,1416,0,1740,81.37931034
臺北市,松山區,中華里,450,416,32.73013375,855,67.26986625,1271,21,1292,0,1556,83.03341902
臺北市,松山區,中華里,451,465,35.87962963,831,64.12037037,1296,13,1309,0,1592,82.22361809
臺北市,松山區,中華里,452,620,45.99406528,728,54.00593472,1348,15,1363,0,1716,79.42890443
臺北市,松山區,民有里,453,597,44.0915805,757,55.9084195,1354,18,1372,0,1701,80.65843621
臺北市,松山區,民有里,454,547,40.30950626,810,59.69049374,1357,20,1377,0,1779,77.40303541
臺北市,松山區,民有里,455,779,52.03740815,718,47.96259185,1497,22,1519,0,1864,81.49141631
臺北市,松山區,民有里,456,657,47.4368231,728,52.5631769,1385,21,1406,0,1774,79.25591883
臺北市,松山區,民福里,457,607,38.63781031,964,61.36218969,1571,31,1602,0,1913,83.74281234
臺北市,松山區,民福里,458,526,33.95739187,1023,66.04260813,1549,19,1568,0,1854,84.57389428
臺北市,松山區,民福里,459,447,34.22664625,859,65.77335375,1306,30,1336,0,1694,78.86658796
臺北市,松山區,慈祐里,460,918,54.38388626,770,45.61611374,1688,29,1717,0,2045,83.9608802
臺北市,松山區,慈祐里,461,606,55.49450549,486,44.50549451,1092,18,1110,0,2028,54.73372781
臺北市,松山區,慈祐里,462,669,54.70155356,554,45.29844644,1223,17,1240,0,1531,80.99281515
臺北市,松山區,安平里,463,679,46.03389831,796,53.96610169,1475,21,1496,0,1807,82.78915329
臺北市,松山區,安平里,464,749,53.69175627,646,46.30824373,1395,19,1414,0,1730,81.73410405
臺北市,松山區,安平里,465,718,49.51724138,732,50.48275862,1450,37,1487,1,1822,81.61361142
臺北市,松山區,安平里,466,690,53.36426914,603,46.63573086,1293,41,1334,1,1606,83.06351183
臺北市,松山區,鵬程里,467,254,19.30091185,1062,80.69908815,1316,20,1336,0,1628,82.06388206
臺北市,松山區,鵬程里,468,470,37.00787402,800,62.99212598,1270,30,1300,0,1564,83.1202046
臺北市,松山區,鵬程里,469,467,37.15194909,790,62.84805091,1257,23,1280,0,1611,79.45375543
臺北市,松山區,自強里,470,160,10.84745763,1315,89.15254237,1475,16,1491,0,1792,83.203125
臺北市,松山區,自強里,471,494,29.6875,1170,70.3125,1664,28,1692,0,2030,83.34975369
臺北市,松山區,自強里,472,311,21.05619499,1166,78.94380501,1477,23,1500,0,1805,83.10249307
臺北市,松山區,吉祥里,473,723,50.6302521,705,49.3697479,1428,33,1461,0,1764,82.82312925
臺北市,松山區,吉祥里,474,462,34.45190157,879,65.54809843,1341,13,1354,0,1640,82.56097561
臺北市,松山區,吉祥里,475,522,44.01349073,664,55.98650927,1186,16,1202,0,1518,79.1831357
臺北市,松山區,吉祥里,476,532,37.51763047,886,62.48236953,1418,24,1442,0,1746,82.58877434
臺北市,松山區,新聚里,477,747,47.73162939,818,52.26837061,1565,31,1596,0,1917,83.25508607
臺北市,松山區,新聚里,478,698,43.70695053,899,56.29304947,1597,31,1628,1,2012,80.91451292
臺北市,松山區,新聚里,479,712,44.47220487,889,55.52779513,1601,34,1635,0,2027,80.66107548
臺北市,松山區,復盛里,480,498,34.27391604,955,65.72608396,1453,25,1478,1,1768,83.59728507
臺北市,松山區,復盛里,481,579,41.62473041,812,58.37526959,1391,35,1426,0,1730,82.42774566
臺北市,松山區,復盛里,482,643,43.86084584,823,56.13915416,1466,34,1500,0,1819,82.4628917
臺北市,松山區,中正里,483,671,51.29969419,637,48.70030581,1308,25,1333,0,1622,82.18249075
臺北市,松山區,中正里,484,522,44.01349073,664,55.98650927,1186,22,1208,0,1529,79.0058862
臺北市,松山區,中正里,485,621,50.65252855,605,49.34747145,1226,16,1242,0,1551,80.07736944
臺北市,松山區,中正里,486,640,47.02424688,721,52.97575312,1361,18,1379,0,1738,79.34407365
臺北市,松山區,中崙里,487,565,46.61716172,647,53.38283828,1212,24,1236,0,1529,80.83714846
臺北市,松山區,中崙里,488,585,46.13564669,683,53.86435331,1268,23,1291,2,1545,83.55987055
臺北市,松山區,美仁里,489,528,49.29971989,543,50.70028011,1071,17,1088,0,1326,82.05128205
臺北市,松山區,美仁里,490,462,45.38310413,556,54.61689587,1018,13,1031,1,1258,81.9554849
臺北市,松山區,吉仁里,491,535,42.66347687,719,57.33652313,1254,27,1281,0,1581,81.02466793
臺北市,松山區,吉仁里,492,502,39.90461049,756,60.09538951,1258,21,1279,0,1557,82.14515093
臺北市,松山區,敦化里,493,588,42.27174694,803,57.72825306,1391,32,1423,0,1758,80.94425484
臺北市,松山區,敦化里,494,792,49.9369483,794,50.0630517,1586,21,1607,0,1938,82.92053664
臺北市,松山區,敦化里,495,736,48.13603663,793,51.86396337,1529,28,1557,0,1856,83.89008621
臺北市,松山區,復源里,496,436,40.82397004,632,59.17602996,1068,17,1085,0,1306,83.07810107
臺北市,松山區,復源里,497,356,37.91267306,583,62.08732694,939,19,958,0,1186,80.77571669
臺北市,松山區,復建里,498,445,37.9369139,728,62.0630861,1173,17,1190,0,1468,81.0626703
臺北市,松山區,復建里,499,524,41.22738002,747,58.77261998,1271,24,1295,0,1597,81.08954289
臺北市,松山區,復勢里,500,638,50.675139,621,49.324861,1259,27,1286,0,1547,83.12863607
臺北市,松山區,復勢里,501,634,43.69400414,817,56.30599586,1451,22,1473,0,1772,83.12641084
臺北市,松山區,復勢里,502,524,44.82463644,645,55.17536356,1169,23,1192,0,1477,80.70412999
臺北市,松山區,福成里,503,708,42.75362319,948,57.24637681,1656,25,1681,0,2109,79.70602181
臺北市,松山區,松基里,504,633,49.453125,647,50.546875,1280,26,1306,0,1604,81.42144638
臺北市,松山區,松基里,505,537,44.78732277,662,55.21267723,1199,15,1214,0,1509,80.45062956
臺北市,信義區,西村里,506,328,19.58208955,1347,80.41791045,1675,19,1694,0,2671,63.42193935
臺北市,信義區,西村里,507,364,21.88815394,1299,78.11184606,1663,29,1692,0,2060,82.13592233
臺北市,信義區,正和里,508,492,30.42671614,1125,69.57328386,1617,32,1649,0,2001,82.4087956
臺北市,信義區,正和里,509,510,32.5255102,1058,67.4744898,1568,19,1587,1,1986,79.90936556
臺北市,信義區,興隆里,510,294,31.54506438,638,68.45493562,932,21,953,0,1163,81.94325021
臺北市,信義區,興隆里,511,372,35.16068053,686,64.83931947,1058,12,1070,0,1394,76.75753228
臺北市,信義區,中興里,512,361,37.88037775,592,62.11962225,953,19,972,0,1258,77.26550079
臺北市,信義區,中興里,513,404,40.31936128,598,59.68063872,1002,10,1012,0,1328,76.20481928
臺北市,信義區,新仁里,514,387,29.45205479,927,70.54794521,1314,29,1343,0,1668,80.51558753
臺北市,信義區,新仁里,515,339,31.77132146,728,68.22867854,1067,19,1086,0,1399,77.62687634
臺北市,信義區,興雅里,516,403,31.09567901,893,68.90432099,1296,34,1330,0,1706,77.96014068
臺北市,信義區,興雅里,517,733,45.78388507,868,54.21611493,1601,26,1627,0,1988,81.84104628
臺北市,信義區,興雅里,518,414,44.85373781,509,55.14626219,923,9,932,0,1126,82.77087034
臺北市,信義區,敦厚里,519,612,41.15669132,875,58.84330868,1487,25,1512,0,1892,79.9154334
臺北市,信義區,敦厚里,520,649,40.84329767,940,59.15670233,1589,28,1617,0,2063,78.38099855
臺北市,信義區,廣居里,521,586,35.77533578,1052,64.22466422,1638,32,1670,0,2046,81.6226784
臺北市,信義區,廣居里,522,547,33.43520782,1089,66.56479218,1636,14,1650,0,1986,83.081571
臺北市,信義區,廣居里,523,579,41.29814551,823,58.70185449,1402,21,1423,0,1782,79.85409652
臺北市,信義區,安康里,524,691,41.75226586,964,58.24773414,1655,35,1690,0,2064,81.87984496
臺北市,信義區,安康里,525,614,38.08933002,998,61.91066998,1612,18,1630,0,2002,81.41858142
臺北市,信義區,安康里,526,630,39.62264151,960,60.37735849,1590,34,1624,0,2015,80.5955335
臺北市,信義區,六藝里,527,539,46.46551724,621,53.53448276,1160,16,1176,0,1390,84.60431655
臺北市,信義區,六藝里,528,564,46.53465347,648,53.46534653,1212,31,1243,0,1514,82.1003963
臺北市,信義區,雅祥里,529,826,48.5026424,877,51.4973576,1703,43,1746,0,2129,82.01033349
臺北市,信義區,雅祥里,530,696,44.67265725,862,55.32734275,1558,24,1582,0,1908,82.91404612
臺北市,信義區,五常里,531,533,43.68852459,687,56.31147541,1220,27,1247,0,1553,80.2962009
臺北市,信義區,五常里,532,535,43.04102977,708,56.95897023,1243,27,1270,0,1550,81.93548387
臺北市,信義區,五全里,533,898,52.76145711,804,47.23854289,1702,33,1735,0,2097,82.73724368
臺北市,信義區,五全里,534,913,48.64144912,964,51.35855088,1877,33,1910,0,2269,84.17805201
臺北市,信義區,永吉里,535,834,55.37848606,672,44.62151394,1506,34,1540,0,1917,80.33385498
臺北市,信義區,永吉里,536,905,60.17287234,599,39.82712766,1504,71,1575,0,1903,82.76405675
臺北市,信義區,長春里,537,678,51.40257771,641,48.59742229,1319,54,1373,0,1667,82.36352729
臺北市,信義區,長春里,538,715,44.43753884,894,55.56246116,1609,58,1667,0,2015,82.72952854
臺北市,信義區,四育里,539,600,48.58299595,635,51.41700405,1235,17,1252,0,1484,84.36657682
臺北市,信義區,四育里,540,718,53.86346587,615,46.13653413,1333,24,1357,0,1617,83.92084106
臺北市,信義區,四育里,541,594,46.55172414,682,53.44827586,1276,30,1306,0,1562,83.61075544
臺北市,信義區,四維里,542,493,38.09891808,801,61.90108192,1294,21,1315,0,1609,81.72778123
臺北市,信義區,四維里,543,513,39.76744186,777,60.23255814,1290,10,1300,0,1599,81.30081301
臺北市,信義區,四維里,544,443,39.48306595,679,60.51693405,1122,30,1152,0,1426,80.78541374
臺北市,信義區,永春里,545,503,42.34006734,685,57.65993266,1188,35,1223,0,1474,82.97150611
臺北市,信義區,永春里,546,551,44.90627547,676,55.09372453,1227,34,1261,0,1527,82.58022266
臺北市,信義區,永春里,547,623,52.7072758,559,47.2927242,1182,41,1223,0,1459,83.82453735
臺北市,信義區,富臺里,548,389,29.18229557,944,70.81770443,1333,17,1350,1,1605,84.11214953
臺北市,信義區,富臺里,549,281,24.03763901,888,75.96236099,1169,27,1196,0,1500,79.73333333
臺北市,信義區,國業里,550,586,37.30108211,985,62.69891789,1571,16,1587,1,1907,83.21971683
臺北市,信義區,國業里,551,611,39.80456026,924,60.19543974,1535,34,1569,0,1886,83.19194062
臺北市,信義區,國業里,552,630,38.93695921,988,61.06304079,1618,36,1654,0,2017,82.00297471
臺北市,信義區,松隆里,553,365,39.37432578,562,60.62567422,927,31,958,0,1182,81.04906937
臺北市,信義區,松隆里,554,350,41.12808461,501,58.87191539,851,22,873,0,1120,77.94642857
臺北市,信義區,松友里,555,512,37.53665689,852,62.46334311,1364,37,1401,1,1719,81.5008726
臺北市,信義區,松友里,556,545,37.56030324,906,62.43969676,1451,30,1481,0,1789,82.78367803
臺北市,信義區,松友里,557,545,37.61214631,904,62.38785369,1449,19,1468,0,1783,82.33314638
臺北市,信義區,松光里,558,799,43.9010989,1021,56.0989011,1820,33,1853,0,2266,81.77405119
臺北市,信義區,松光里,559,832,45.34059946,1003,54.65940054,1835,40,1875,0,2241,83.66800535
臺北市,信義區,中坡里,560,691,45.55042848,826,54.44957152,1517,17,1534,0,1843,83.23385784
臺北市,信義區,中坡里,561,673,41.2377451,959,58.7622549,1632,32,1664,0,1996,83.36673347
臺北市,信義區,中行里,562,640,49.92199688,642,50.07800312,1282,34,1316,0,1610,81.73913043
臺北市,信義區,中行里,563,617,44.48449892,770,55.51550108,1387,39,1426,0,1716,83.1002331
臺北市,信義區,中行里,564,578,45.29780564,698,54.70219436,1276,19,1295,4,1551,83.49451966
臺北市,信義區,中行里,565,594,42.39828694,807,57.60171306,1401,29,1430,0,1722,83.04297329
臺北市,信義區,大道里,566,663,45.62973159,790,54.37026841,1453,40,1493,0,1788,83.50111857
臺北市,信義區,大道里,567,712,46.41460235,822,53.58539765,1534,37,1571,0,1901,82.64071541
臺北市,信義區,大道里,568,619,45.21548576,750,54.78451424,1369,49,1418,0,1709,82.97249854
臺北市,信義區,大仁里,569,623,48.59594384,659,51.40405616,1282,37,1319,0,1543,85.48282566
臺北市,信義區,大仁里,570,397,36.86165274,680,63.13834726,1077,66,1143,0,1548,73.8372093
臺北市,信義區,大仁里,571,428,37.67605634,708,62.32394366,1136,53,1189,0,1496,79.47860963
臺北市,信義區,景新里,572,627,38.25503356,1012,61.74496644,1639,21,1660,0,1989,83.45902464
臺北市,信義區,景新里,573,447,27.37293325,1186,72.62706675,1633,24,1657,0,2056,80.59338521
臺北市,信義區,惠安里,574,588,35.74468085,1057,64.25531915,1645,37,1682,0,2039,82.49141736
臺北市,信義區,惠安里,575,483,33.91853933,941,66.08146067,1424,38,1462,0,1745,83.78223496
臺北市,信義區,惠安里,576,493,33.17631225,993,66.82368775,1486,32,1518,2,1792,84.70982143
臺北市,信義區,三張里,577,669,41.16923077,956,58.83076923,1625,27,1652,0,1998,82.68268268
臺北市,信義區,三張里,578,570,35.33787973,1043,64.66212027,1613,29,1642,0,2004,81.93612774
臺北市,信義區,三張里,579,386,26.11637348,1092,73.88362652,1478,27,1505,0,1812,83.05739514
臺北市,信義區,三張里,580,521,35.75840769,936,64.24159231,1457,39,1496,0,1859,80.47337278
臺北市,信義區,三犁里,581,462,34.375,882,65.625,1344,25,1369,0,1737,78.81404721
臺北市,信義區,三犁里,582,709,36.00812595,1260,63.99187405,1969,16,1985,0,2411,82.33098299
臺北市,信義區,六合里,583,508,27.78993435,1320,72.21006565,1828,29,1857,0,2217,83.76184032
臺北市,信義區,六合里,584,535,33.71140517,1052,66.28859483,1587,35,1622,0,1996,81.26252505
臺北市,信義區,六合里,585,317,32.61316872,655,67.38683128,972,11,983,0,1328,74.02108434
臺北市,信義區,泰和里,586,478,39.11620295,744,60.88379705,1222,30,1252,0,1597,78.39699436
臺北市,信義區,泰和里,587,469,31.99181446,997,68.00818554,1466,25,1491,0,1766,84.42808607
臺北市,信義區,泰和里,588,535,39.6884273,813,60.3115727,1348,44,1392,0,1709,81.45114102
臺北市,信義區,泰和里,589,501,39.73037272,760,60.26962728,1261,9,1270,0,1536,82.68229167
臺北市,信義區,景聯里,590,681,39.45538818,1045,60.54461182,1726,30,1756,0,2180,80.55045872
臺北市,信義區,景聯里,591,601,40.99590723,865,59.00409277,1466,24,1490,0,1787,83.37996642
臺北市,信義區,景勤里,592,590,40.02713704,884,59.97286296,1474,27,1501,1,1832,81.93231441
臺北市,信義區,景勤里,593,461,29.19569348,1118,70.80430652,1579,43,1622,0,1925,84.25974026
臺北市,信義區,雙和里,594,660,36.02620087,1172,63.97379913,1832,41,1873,0,2273,82.40211175
臺北市,信義區,雙和里,595,630,39.03345725,984,60.96654275,1614,29,1643,0,2001,82.10894553
臺北市,信義區,雙和里,596,465,32.54023793,964,67.45976207,1429,26,1455,0,1781,81.69567659
臺北市,信義區,嘉興里,597,540,44.96253122,661,55.03746878,1201,20,1221,0,1452,84.09090909
臺北市,信義區,嘉興里,598,426,40.72657744,620,59.27342256,1046,24,1070,0,1305,81.99233716
臺北市,信義區,黎順里,599,498,38.01526718,812,61.98473282,1310,26,1336,0,1685,79.28783383
臺北市,信義區,黎順里,600,521,33.33333333,1042,66.66666667,1563,20,1583,0,1883,84.06797663
臺北市,信義區,黎平里,601,562,36.5647365,975,63.4352635,1537,20,1557,0,1879,82.86322512
臺北市,信義區,黎平里,602,562,38.6519945,892,61.3480055,1454,27,1481,0,1766,83.86183465
臺北市,信義區,黎平里,603,659,39.50839329,1009,60.49160671,1668,39,1707,0,2098,81.36320305
臺北市,信義區,黎忠里,604,598,37.80025284,984,62.19974716,1582,35,1617,0,1957,82.62646909
臺北市,信義區,黎忠里,605,739,41.89342404,1025,58.10657596,1764,21,1785,0,2131,83.76349132
臺北市,信義區,黎安里,606,139,16.72683514,692,83.27316486,831,23,854,0,1011,84.47082097
臺北市,信義區,黎安里,607,273,27.80040733,709,72.19959267,982,42,1024,0,1274,80.37676609
臺北市,南港區,南港里,608,548,45.02875924,669,54.97124076,1217,20,1237,0,1490,83.02013423
臺北市,南港區,南港里,609,619,49.79887369,624,50.20112631,1243,26,1269,0,1549,81.92382182
臺北市,南港區,南港里,610,597,47.30586371,665,52.69413629,1262,29,1291,0,1764,73.18594104
臺北市,南港區,中南里,611,825,52.05047319,760,47.94952681,1585,47,1632,0,2016,80.95238095
臺北市,南港區,中南里,612,538,49.72273567,544,50.27726433,1082,40,1122,0,1345,83.42007435
臺北市,南港區,新富里,613,642,50.19546521,637,49.80453479,1279,34,1313,0,1560,84.16666667
臺北市,南港區,新富里,614,693,50.69495245,674,49.30504755,1367,34,1401,0,1693,82.75251034
臺北市,南港區,三重里,615,548,50.13723696,545,49.86276304,1093,28,1121,0,1391,80.58950395
臺北市,南港區,三重里,616,494,50.05065856,493,49.94934144,987,25,1012,0,1252,80.83067093
臺北市,南港區,東新里,617,523,51.37524558,495,48.62475442,1018,27,1045,0,1260,82.93650794
臺北市,南港區,東新里,618,553,44.38202247,693,55.61797753,1246,17,1263,1,1513,83.47653668
臺北市,南港區,東新里,619,572,39.97204752,859,60.02795248,1431,24,1455,0,1723,84.44573418
臺北市,南港區,東新里,620,443,44.56740443,551,55.43259557,994,17,1011,0,1221,82.8009828
臺北市,南港區,新光里,621,574,41,826,59,1400,27,1427,0,1702,83.84253819
臺北市,南港區,新光里,622,506,37.31563422,850,62.68436578,1356,29,1385,0,1702,81.37485311
臺北市,南港區,東明里,623,679,40.3686088,1003,59.6313912,1682,33,1715,0,2090,82.05741627
臺北市,南港區,東明里,624,528,38.15028902,856,61.84971098,1384,27,1411,0,1737,81.23200921
臺北市,南港區,西新里,625,715,53.5982009,619,46.4017991,1334,38,1372,0,1706,80.42203986
臺北市,南港區,西新里,626,918,59.14948454,634,40.85051546,1552,23,1575,1,1875,84
臺北市,南港區,玉成里,627,697,47.77244688,762,52.22755312,1459,31,1490,0,1808,82.41150442
臺北市,南港區,玉成里,628,810,51.42857143,765,48.57142857,1575,24,1599,0,1919,83.32464825
臺北市,南港區,合成里,629,586,46.99278268,661,53.00721732,1247,25,1272,0,1520,83.68421053
臺北市,南港區,合成里,630,477,41.33448873,677,58.66551127,1154,28,1182,0,1403,84.24803991
臺北市,南港區,合成里,631,407,44.52954048,507,55.47045952,914,28,942,0,1108,85.01805054
臺北市,南港區,合成里,632,414,46.99205448,467,53.00794552,881,13,894,0,1077,83.00835655
臺北市,南港區,成福里,633,478,41.85639229,664,58.14360771,1142,23,1165,0,1366,85.28550512
臺北市,南港區,成福里,634,435,32.15077605,918,67.84922395,1353,25,1378,0,1611,85.53693358
臺北市,南港區,成福里,635,515,44.93891798,631,55.06108202,1146,18,1164,0,1387,83.9221341
臺北市,南港區,成福里,636,550,37.90489318,901,62.09510682,1451,22,1473,0,1771,83.17334839
臺北市,南港區,萬福里,637,441,29.59731544,1049,70.40268456,1490,24,1514,0,1762,85.92508513
臺北市,南港區,萬福里,638,594,45.20547945,720,54.79452055,1314,23,1337,0,1617,82.68398268
臺北市,南港區,鴻福里,639,687,44.55252918,855,55.44747082,1542,28,1570,0,1882,83.4218916
臺北市,南港區,鴻福里,640,757,46.44171779,873,53.55828221,1630,38,1668,0,1954,85.36335722
臺北市,南港區,百福里,641,840,48.72389791,884,51.27610209,1724,20,1744,1,2112,82.57575758
臺北市,南港區,百福里,642,680,42.71356784,912,57.28643216,1592,38,1630,0,1925,84.67532468
臺北市,南港區,聯成里,643,430,36.16484441,759,63.83515559,1189,12,1201,1,1404,85.54131054
臺北市,南港區,聯成里,644,503,41.95162636,696,58.04837364,1199,19,1218,0,1436,84.8189415
臺北市,南港區,聯成里,645,542,44.38984439,679,55.61015561,1221,10,1231,0,1466,83.96998636
臺北市,南港區,舊莊里,646,502,48.54932302,532,51.45067698,1034,36,1070,0,1312,81.55487805
臺北市,南港區,舊莊里,647,488,46.87800192,553,53.12199808,1041,30,1071,0,1307,81.94338179
臺北市,南港區,舊莊里,648,545,47.43255004,604,52.56744996,1149,27,1176,0,1437,81.83716075
臺北市,南港區,舊莊里,649,477,44.04432133,606,55.95567867,1083,26,1109,0,1326,83.63499246
臺北市,南港區,舊莊里,650,580,50.43478261,570,49.56521739,1150,37,1187,0,1494,79.45113788
臺北市,南港區,中研里,651,512,45.71428571,608,54.28571429,1120,25,1145,0,1395,82.07885305
臺北市,南港區,中研里,652,487,37.57716049,809,62.42283951,1296,32,1328,0,1608,82.58706468
臺北市,南港區,中研里,653,526,41.54818325,740,58.45181675,1266,24,1290,0,1513,85.26107072
臺北市,南港區,中研里,654,429,39.14233577,667,60.85766423,1096,17,1113,0,1317,84.51025057
臺北市,南港區,中研里,655,499,41.82732607,694,58.17267393,1193,15,1208,0,1459,82.79643592
臺北市,南港區,九如里,656,507,43.55670103,657,56.44329897,1164,18,1182,0,1444,81.85595568
臺北市,南港區,九如里,657,575,45.63492063,685,54.36507937,1260,35,1295,0,1619,79.9876467
臺北市,南港區,九如里,658,277,22.64922322,946,77.35077678,1223,27,1250,0,1490,83.89261745
臺北市,南港區,仁福里,659,319,30.61420345,723,69.38579655,1042,22,1064,0,1283,82.93063133
臺北市,南港區,仁福里,660,469,36.35658915,821,63.64341085,1290,19,1309,0,1573,83.21678322
臺北市,南港區,仁福里,661,463,35.31655225,848,64.68344775,1311,18,1329,0,1596,83.27067669
臺北市,內湖區,西湖里,662,606,47.49216301,670,52.50783699,1276,24,1300,0,1579,82.33058898
臺北市,內湖區,西湖里,663,620,49.40239044,635,50.59760956,1255,18,1273,0,1544,82.44818653
臺北市,內湖區,西湖里,664,605,46.32465544,701,53.67534456,1306,20,1326,0,1579,83.97720076
臺北市,內湖區,西湖里,665,487,39.98357964,731,60.01642036,1218,11,1229,0,1476,83.26558266
臺北市,內湖區,西康里,666,569,45.19459889,690,54.80540111,1259,28,1287,0,1540,83.57142857
臺北市,內湖區,西康里,667,502,38.46743295,803,61.53256705,1305,20,1325,1,1564,84.71867008
臺北市,內湖區,西康里,668,477,42.06349206,657,57.93650794,1134,13,1147,0,1382,82.99565847
臺北市,內湖區,西康里,669,409,25.77189666,1178,74.22810334,1587,30,1617,0,1891,85.510312
臺北市,內湖區,西安里,670,569,40.58487874,833,59.41512126,1402,23,1425,0,1690,84.31952663
臺北市,內湖區,西安里,671,559,42.41274659,759,57.58725341,1318,23,1341,0,1603,83.65564566
臺北市,內湖區,西安里,672,508,37.82576322,835,62.17423678,1343,22,1365,0,1637,83.38423946
臺北市,內湖區,港墘里,673,560,43.88714734,716,56.11285266,1276,22,1298,0,1539,84.34048083
臺北市,內湖區,港墘里,674,536,43.29563813,702,56.70436187,1238,26,1264,1,1498,84.37917223
臺北市,內湖區,港墘里,675,531,46.61984197,608,53.38015803,1139,25,1164,1,1386,83.98268398
臺北市,內湖區,港都里,676,464,46.16915423,541,53.83084577,1005,11,1016,0,1203,84.45552785
臺北市,內湖區,港都里,677,549,44.5978879,682,55.4021121,1231,18,1249,0,1488,83.93817204
臺北市,內湖區,港都里,678,501,44.81216458,617,55.18783542,1118,15,1133,0,1339,84.61538462
臺北市,內湖區,港富里,682,569,49.09404659,590,50.90595341,1159,27,1186,0,1434,82.70571827
臺北市,內湖區,港富里,683,585,47.75510204,640,52.24489796,1225,25,1250,0,1464,85.38251366
臺北市,內湖區,港富里,684,595,46.26749611,691,53.73250389,1286,20,1306,1,1546,84.47606727
臺北市,內湖區,港富里,685,562,47.34625105,625,52.65374895,1187,21,1208,0,1424,84.83146067
臺北市,內湖區,港富里,686,430,40.26217228,638,59.73782772,1068,19,1087,0,1305,83.29501916
臺北市,內湖區,港華里,687,639,50.11764706,636,49.88235294,1275,23,1298,0,1514,85.7331572
臺北市,內湖區,港華里,688,501,39.82511924,757,60.17488076,1258,22,1280,0,1532,83.55091384
臺北市,內湖區,港華里,689,654,47.46008708,724,52.53991292,1378,30,1408,0,1638,85.95848596
臺北市,內湖區,港華里,690,506,39.40809969,778,60.59190031,1284,25,1309,0,1577,83.00570704
臺北市,內湖區,內湖里,691,469,37.49000799,782,62.50999201,1251,15,1266,0,1518,83.39920949
臺北市,內湖區,內湖里,692,478,40.61172472,699,59.38827528,1177,20,1197,0,1446,82.78008299
臺北市,內湖區,內湖里,693,422,36.28546862,741,63.71453138,1163,19,1182,0,1464,80.73770492
臺北市,內湖區,湖濱里,694,452,35.45098039,823,64.54901961,1275,22,1297,0,1607,80.70939639
臺北市,內湖區,湖濱里,695,373,32.23854797,784,67.76145203,1157,22,1179,0,1369,86.12125639
臺北市,內湖區,湖濱里,696,295,31.61843516,638,68.38156484,933,18,951,0,1163,81.77128117
臺北市,內湖區,湖濱里,697,606,43.62850972,783,56.37149028,1389,23,1412,1,1664,84.85576923
臺北市,內湖區,紫星里,698,598,47.19810576,669,52.80189424,1267,22,1289,0,1522,84.6911958
臺北市,內湖區,紫星里,699,584,40.66852368,852,59.33147632,1436,19,1455,0,1729,84.15268942
臺北市,內湖區,紫星里,700,587,43.67559524,757,56.32440476,1344,35,1379,0,1656,83.27294686
臺北市,內湖區,紫星里,701,546,40.77669903,793,59.22330097,1339,8,1347,0,1595,84.45141066
臺北市,內湖區,大湖里,702,409,39.06399236,638,60.93600764,1047,20,1067,0,1330,80.22556391
臺北市,內湖區,大湖里,703,378,37.57455268,628,62.42544732,1006,19,1025,0,1253,81.80367119
臺北市,內湖區,大湖里,704,400,34.99562555,743,65.00437445,1143,19,1162,0,1393,83.41708543
臺北市,內湖區,金龍里,708,446,35.85209003,798,64.14790997,1244,12,1256,0,1541,81.5055159
臺北市,內湖區,金龍里,709,542,42.50980392,733,57.49019608,1275,34,1309,0,1591,82.27529855
臺北市,內湖區,金龍里,710,564,46.80497925,641,53.19502075,1205,40,1245,0,1453,85.68479009
臺北市,內湖區,金瑞里,711,599,43.94717535,764,56.05282465,1363,19,1382,0,1647,83.91013965
臺北市,內湖區,金瑞里,712,522,36.58023826,905,63.41976174,1427,23,1450,0,1720,84.30232558
臺北市,內湖區,金瑞里,713,603,43.9184268,770,56.0815732,1373,31,1404,0,1633,85.97672994
臺北市,內湖區,碧山里,714,239,72.86585366,89,27.13414634,328,17,345,0,407,84.76658477
臺北市,內湖區,碧山里,715,545,36.47925033,949,63.52074967,1494,16,1510,0,1763,85.64946115
臺北市,內湖區,碧山里,716,467,35.00749625,867,64.99250375,1334,17,1351,0,1620,83.39506173
臺北市,內湖區,碧山里,717,512,42.03612479,706,57.96387521,1218,21,1239,0,1524,81.2992126
臺北市,內湖區,紫雲里,718,299,24.15185784,939,75.84814216,1238,31,1269,0,1475,86.03389831
臺北市,內湖區,紫雲里,719,536,44.15156507,678,55.84843493,1214,41,1255,1,1489,84.28475487
臺北市,內湖區,紫雲里,720,353,29.88992379,828,70.11007621,1181,35,1216,0,1450,83.86206897
臺北市,內湖區,清白里,721,475,34.05017921,920,65.94982079,1395,43,1438,0,1745,82.40687679
臺北市,內湖區,清白里,722,636,44.82029598,783,55.17970402,1419,21,1440,0,1711,84.16130918
臺北市,內湖區,清白里,723,432,30.85714286,968,69.14285714,1400,20,1420,0,1744,81.42201835
臺北市,內湖區,葫洲里,724,516,33.48475016,1025,66.51524984,1541,14,1555,0,1847,84.19057932
臺北市,內湖區,葫洲里,725,424,32.69082498,873,67.30917502,1297,12,1309,0,1535,85.27687296
臺北市,內湖區,葫洲里,726,568,37.61589404,942,62.38410596,1510,15,1525,0,1799,84.76931629
臺北市,內湖區,葫洲里,727,586,39.51449764,897,60.48550236,1483,17,1500,1,1820,82.41758242
臺北市,內湖區,紫陽里,738,474,39.59899749,723,60.40100251,1197,23,1220,0,1442,84.60471567
臺北市,內湖區,紫陽里,739,535,44.80737018,659,55.19262982,1194,6,1200,1,1418,84.62623413
臺北市,內湖區,紫陽里,740,448,38.88888889,704,61.11111111,1152,22,1174,0,1444,81.30193906
臺北市,內湖區,紫陽里,741,463,35.86367157,828,64.13632843,1291,17,1308,0,1557,84.00770713
臺北市,內湖區,瑞陽里,742,475,31.43613501,1036,68.56386499,1511,34,1545,0,1788,86.40939597
臺北市,內湖區,瑞陽里,743,325,23.94988946,1032,76.05011054,1357,7,1364,0,1639,83.22147651
臺北市,內湖區,瑞陽里,744,343,26.88087774,933,73.11912226,1276,18,1294,0,1487,87.02084734
臺北市,內湖區,瑞陽里,745,375,28.73563218,930,71.26436782,1305,15,1320,0,1488,88.70967742
臺北市,內湖區,瑞光里,746,216,22.01834862,765,77.98165138,981,22,1003,0,1196,83.86287625
臺北市,內湖區,瑞光里,747,430,40.03724395,644,59.96275605,1074,11,1085,0,1276,85.03134796
臺北市,內湖區,瑞光里,748,326,30.92979127,728,69.07020873,1054,21,1075,0,1253,85.79409417
臺北市,內湖區,五分里,749,654,46.28450106,759,53.71549894,1413,24,1437,0,1743,82.44406196
臺北市,內湖區,五分里,750,672,46.37681159,777,53.62318841,1449,33,1482,0,1783,83.11833988
臺北市,內湖區,五分里,751,711,52.12609971,653,47.87390029,1364,31,1395,0,1707,81.72231986
臺北市,內湖區,五分里,752,617,42.96657382,819,57.03342618,1436,22,1458,0,1744,83.60091743
臺北市,內湖區,東湖里,753,581,46.89265537,658,53.10734463,1239,9,1248,1,1485,84.04040404
臺北市,內湖區,東湖里,754,476,43.8305709,610,56.1694291,1086,24,1110,0,1341,82.77404922
臺北市,內湖區,東湖里,755,665,45.83046175,786,54.16953825,1451,23,1474,0,1759,83.79761228
臺北市,內湖區,東湖里,756,471,42.35611511,641,57.64388489,1112,18,1130,2,1390,81.29496403
臺北市,內湖區,樂康里,760,499,44.08127208,633,55.91872792,1132,33,1165,0,1425,81.75438596
臺北市,內湖區,樂康里,761,590,44.19475655,745,55.80524345,1335,25,1360,0,1615,84.21052632
臺北市,內湖區,樂康里,762,556,47.15860899,623,52.84139101,1179,27,1206,1,1462,82.48974008
臺北市,內湖區,樂康里,763,551,46.30252101,639,53.69747899,1190,22,1212,0,1475,82.16949153
臺北市,內湖區,內溝里,764,418,63.62252664,239,36.37747336,657,19,676,0,814,83.04668305
臺北市,內湖區,內溝里,765,370,39.40362087,569,60.59637913,939,13,952,0,1139,83.58208955
臺北市,內湖區,內溝里,766,398,36.18181818,702,63.81818182,1100,17,1117,0,1332,83.85885886
臺北市,內湖區,週美里,769,689,61.68307968,428,38.31692032,1117,23,1140,0,1349,84.50704225
臺北市,內湖區,週美里,770,661,56.4957265,509,43.5042735,1170,26,1196,0,1427,83.81219341
臺北市,內湖區,週美里,771,550,56.06523955,431,43.93476045,981,21,1002,0,1194,83.91959799
臺北市,內湖區,行善里,772,574,52.80588776,513,47.19411224,1087,29,1116,0,1328,84.03614458
臺北市,內湖區,行善里,773,490,58.19477435,352,41.80522565,842,35,877,0,1069,82.03928906
臺北市,內湖區,行善里,774,440,39.4265233,676,60.5734767,1116,20,1136,0,1383,82.14027477
臺北市,內湖區,行善里,775,531,44.13965087,672,55.86034913,1203,15,1218,0,1435,84.87804878
臺北市,內湖區,石潭里,776,255,37.6661743,422,62.3338257,677,25,702,0,867,80.96885813
臺北市,內湖區,石潭里,777,318,57.60869565,234,42.39130435,552,14,566,0,712,79.49438202
臺北市,內湖區,湖興里,778,520,41.76706827,725,58.23293173,1245,21,1266,0,1571,80.58561426
臺北市,內湖區,湖興里,779,440,40.1826484,655,59.8173516,1095,28,1123,0,2005,56.00997506
臺北市,內湖區,湖興里,780,679,49.81658107,684,50.18341893,1363,24,1387,0,1617,85.77612863
臺北市,內湖區,湖興里,781,599,48.18986323,644,51.81013677,1243,24,1267,0,1490,85.03355705
臺北市,內湖區,湖興里,782,424,36.48881239,738,63.51118761,1162,13,1175,0,1381,85.08327299
臺北市,內湖區,湖元里,783,482,42.69264836,647,57.30735164,1129,29,1158,0,1344,86.16071429
臺北市,內湖區,湖元里,784,432,42.31145935,589,57.68854065,1021,13,1034,0,1253,82.52194733
臺北市,內湖區,湖元里,785,524,43.0566968,693,56.9433032,1217,8,1225,0,1458,84.01920439
臺北市,內湖區,安湖里,757,632,42.55892256,853,57.44107744,1485,27,1512,0,1781,84.89612577
臺北市,內湖區,安湖里,758,609,44.09847936,772,55.90152064,1381,33,1414,0,1677,84.31723315
臺北市,內湖區,安湖里,759,600,39.76143141,909,60.23856859,1509,32,1541,0,1821,84.62383306
臺北市,內湖區,秀湖里,705,526,43.79683597,675,56.20316403,1201,25,1226,0,1539,79.66211826
臺北市,內湖區,秀湖里,706,477,38.97058824,747,61.02941176,1224,19,1243,0,1484,83.76010782
臺北市,內湖區,秀湖里,707,457,32.13783404,965,67.86216596,1422,25,1447,0,1707,84.76859988
臺北市,內湖區,安泰里,767,588,41.82076814,818,58.17923186,1406,24,1430,0,1698,84.21672556
臺北市,內湖區,安泰里,768,613,39.37058446,944,60.62941554,1557,27,1584,1,1915,82.7154047
臺北市,內湖區,金湖里,728,454,38.24768324,733,61.75231676,1187,19,1206,0,1411,85.47129695
臺北市,內湖區,金湖里,729,493,37.06766917,837,62.93233083,1330,17,1347,0,1642,82.03410475
臺北市,內湖區,金湖里,730,420,31.98781417,893,68.01218583,1313,15,1328,0,1579,84.1038632
臺北市,內湖區,康寧里,731,466,40.55700609,683,59.44299391,1149,20,1169,0,1418,82.44005642
臺北市,內湖區,康寧里,732,497,40.73770492,723,59.26229508,1220,22,1242,0,1501,82.74483678
臺北市,內湖區,康寧里,733,462,35.8974359,825,64.1025641,1287,10,1297,0,1526,84.99344692
臺北市,內湖區,康寧里,734,420,33.14917127,847,66.85082873,1267,25,1292,0,1594,81.05395232
臺北市,內湖區,明湖里,735,665,43.60655738,860,56.39344262,1525,33,1558,0,1802,86.45948946
臺北市,內湖區,明湖里,736,576,38.81401617,908,61.18598383,1484,28,1512,0,1792,84.375
臺北市,內湖區,蘆洲里,737,353,56.38977636,273,43.61022364,626,7,633,0,791,80.02528445
臺北市,內湖區,麗山里,679,590,48.20261438,634,51.79738562,1224,18,1242,0,1481,83.86225523
臺北市,內湖區,麗山里,680,536,50.85388994,518,49.14611006,1054,18,1072,0,1288,83.22981366
臺北市,內湖區,麗山里,681,586,48.46980976,623,51.53019024,1209,24,1233,0,1471,83.82053025
臺北市,大安區,德安里,786,375,28.86836028,924,71.13163972,1299,14,1313,0,1609,81.60348042
臺北市,大安區,德安里,787,449,38.44178082,719,61.55821918,1168,11,1179,0,1508,78.18302387
臺北市,大安區,德安里,788,422,37.11521548,715,62.88478452,1137,19,1156,0,1513,76.40449438
臺北市,大安區,仁慈里,789,640,43.12668464,844,56.87331536,1484,34,1518,0,1987,76.39657776
臺北市,大安區,仁慈里,790,591,39.16500994,918,60.83499006,1509,21,1530,0,1933,79.15157786
臺北市,大安區,和安里,791,441,34.48006255,838,65.51993745,1279,23,1302,0,1647,79.05282332
臺北市,大安區,和安里,792,433,38.42058563,694,61.57941437,1127,14,1141,0,1420,80.35211268
臺北市,大安區,和安里,793,548,33.6196319,1082,66.3803681,1630,17,1647,1,1993,82.63923733
臺北市,大安區,民炤里,794,545,43.7751004,700,56.2248996,1245,21,1266,0,1609,78.68241144
臺北市,大安區,民炤里,795,633,47.91824375,688,52.08175625,1321,16,1337,0,1699,78.69334903
臺北市,大安區,民炤里,796,434,35.54463554,787,64.45536446,1221,18,1239,0,1559,79.47402181
臺北市,大安區,民炤里,797,455,39.9122807,685,60.0877193,1140,21,1161,0,1512,76.78571429
臺北市,大安區,仁愛里,798,486,39.70588235,738,60.29411765,1224,22,1246,0,1636,76.16136919
臺北市,大安區,仁愛里,799,443,38.96218118,694,61.03781882,1137,11,1148,0,1552,73.96907216
臺北市,大安區,仁愛里,800,408,37.56906077,678,62.43093923,1086,9,1095,0,1490,73.48993289
臺北市,大安區,義村里,801,215,15.98513011,1130,84.01486989,1345,18,1363,0,1654,82.40628779
臺北市,大安區,義村里,802,281,19.14168937,1187,80.85831063,1468,20,1488,0,1852,80.34557235
臺北市,大安區,義村里,803,640,41.1046885,917,58.8953115,1557,27,1584,0,2006,78.96311067
臺北市,大安區,民輝里,804,631,42.37743452,858,57.62256548,1489,14,1503,0,1889,79.56590789
臺北市,大安區,民輝里,805,700,40.88785047,1012,59.11214953,1712,29,1741,1,2203,79.02859737
臺北市,大安區,民輝里,806,487,42.68185802,654,57.31814198,1141,24,1165,0,1449,80.40027605
臺北市,大安區,昌隆里,807,466,48.19027921,501,51.80972079,967,24,991,0,1240,79.91935484
臺北市,大安區,昌隆里,808,525,46.2962963,609,53.7037037,1134,22,1156,0,1489,77.63599731
臺北市,大安區,誠安里,809,644,46.13180516,752,53.86819484,1396,16,1412,0,1789,78.92677473
臺北市,大安區,誠安里,810,645,42.46214615,874,57.53785385,1519,22,1541,0,1946,79.18807811
臺北市,大安區,光武里,811,562,37.07124011,954,62.92875989,1516,20,1536,0,2060,74.5631068
臺北市,大安區,光武里,812,689,40.10477299,1029,59.89522701,1718,30,1748,0,2231,78.35051546
臺北市,大安區,光武里,813,702,40.50778996,1031,59.49221004,1733,23,1756,0,2247,78.14864263
臺北市,大安區,龍坡里,814,492,40.96586178,709,59.03413822,1201,17,1218,0,1492,81.63538874
臺北市,大安區,龍坡里,815,385,35.19195612,709,64.80804388,1094,13,1107,0,1354,81.7577548
臺北市,大安區,龍坡里,816,392,27.29805014,1044,72.70194986,1436,28,1464,0,1813,80.75013789
臺北市,大安區,龍泉里,817,624,40.89121887,902,59.10878113,1526,26,1552,0,1908,81.34171908
臺北市,大安區,龍泉里,818,534,38.9212828,838,61.0787172,1372,17,1389,0,1782,77.94612795
臺北市,大安區,古風里,819,494,40.42553191,728,59.57446809,1222,25,1247,0,1567,79.57881302
臺北市,大安區,古風里,820,572,40.45261669,842,59.54738331,1414,27,1441,0,1775,81.18309859
臺北市,大安區,古莊里,821,530,36.20218579,934,63.79781421,1464,23,1487,0,1864,79.77467811
臺北市,大安區,古莊里,822,539,42.24137931,737,57.75862069,1276,22,1298,0,1598,81.22653317
臺北市,大安區,古莊里,823,538,41.54440154,757,58.45559846,1295,19,1314,0,1642,80.02436054
臺北市,大安區,龍安里,824,498,37.13646532,843,62.86353468,1341,21,1362,1,2674,50.93492895
臺北市,大安區,龍安里,825,469,38.00648298,765,61.99351702,1234,16,1250,0,1512,82.67195767
臺北市,大安區,龍安里,826,462,38.72590109,731,61.27409891,1193,22,1215,0,1512,80.35714286
臺北市,大安區,錦安里,827,332,33.40040241,662,66.59959759,994,13,1007,0,1251,80.49560352
臺北市,大安區,錦安里,828,361,32.26094727,758,67.73905273,1119,16,1135,0,1385,81.94945848
臺北市,大安區,錦安里,829,463,41.08251996,664,58.91748004,1127,19,1146,0,1419,80.76109937
臺北市,大安區,福住里,830,477,37.3531715,800,62.6468285,1277,22,1299,0,1621,80.13571869
臺北市,大安區,福住里,831,442,38.00515907,721,61.99484093,1163,20,1183,0,1452,81.4738292
臺北市,大安區,福住里,832,379,36.76042677,652,63.23957323,1031,20,1051,0,1302,80.72196621
臺北市,大安區,永康里,833,407,37.20292505,687,62.79707495,1094,15,1109,0,1395,79.49820789
臺北市,大安區,永康里,834,372,37.38693467,623,62.61306533,995,17,1012,0,1236,81.87702265
臺北市,大安區,光明里,835,413,35.08920986,764,64.91079014,1177,17,1194,0,1444,82.68698061
臺北市,大安區,光明里,836,415,34.46843854,789,65.53156146,1204,21,1225,0,1505,81.39534884
臺北市,大安區,錦泰里,837,376,22.05278592,1329,77.94721408,1705,36,1741,0,2067,84.22835027
臺北市,大安區,錦泰里,838,559,36.39322917,977,63.60677083,1536,18,1554,0,1874,82.92422625
臺北市,大安區,錦華里,839,389,35.10830325,719,64.89169675,1108,15,1123,0,1359,82.63428992
臺北市,大安區,錦華里,840,437,42.18146718,599,57.81853282,1036,23,1059,0,1297,81.64996145
臺北市,大安區,錦華里,841,398,33.27759197,798,66.72240803,1196,17,1213,0,1472,82.4048913
臺北市,大安區,龍圖里,842,490,32.90799194,999,67.09200806,1489,19,1508,0,1954,77.17502559
臺北市,大安區,龍圖里,843,558,39.88563259,841,60.11436741,1399,19,1418,0,1754,80.84378563
臺北市,大安區,龍圖里,844,461,35.27161438,846,64.72838562,1307,18,1325,0,1688,78.49526066
臺北市,大安區,新龍里,845,399,32.02247191,847,67.97752809,1246,16,1262,0,1574,80.17789072
臺北市,大安區,新龍里,846,278,20.48636699,1079,79.51363301,1357,17,1374,0,1667,82.4235153
臺北市,大安區,新龍里,847,407,25.92356688,1163,74.07643312,1570,20,1590,0,1932,82.29813665
臺北市,大安區,龍陣里,848,447,39.0052356,699,60.9947644,1146,20,1166,0,1458,79.97256516
臺北市,大安區,龍陣里,849,456,36.98296837,777,63.01703163,1233,23,1256,0,1585,79.24290221
臺北市,大安區,龍雲里,850,393,38.00773694,641,61.99226306,1034,16,1050,0,1282,81.90327613
臺北市,大安區,龍雲里,851,487,41.73093402,680,58.26906598,1167,23,1190,0,1460,81.50684932
臺北市,大安區,龍雲里,852,405,37.88587465,664,62.11412535,1069,21,1090,0,1372,79.44606414
臺北市,大安區,龍生里,853,479,36.20559335,844,63.79440665,1323,13,1336,0,1599,83.55222014
臺北市,大安區,龍生里,854,461,32.60254597,953,67.39745403,1414,17,1431,0,1743,82.09982788
臺北市,大安區,龍生里,855,421,31.74962293,905,68.25037707,1326,20,1346,0,1661,81.03552077
臺北市,大安區,住安里,856,512,40.66719619,747,59.33280381,1259,27,1286,0,1566,82.12005109
臺北市,大安區,住安里,857,400,39.48667325,613,60.51332675,1013,20,1033,0,1298,79.58397535
臺北市,大安區,住安里,858,427,34.94271686,795,65.05728314,1222,27,1249,0,1562,79.96158771
臺北市,大安區,義安里,859,408,33.97169026,793,66.02830974,1201,18,1219,0,1575,77.3968254
臺北市,大安區,義安里,860,368,30.13923014,853,69.86076986,1221,16,1237,0,1526,81.06159895
臺北市,大安區,義安里,861,412,37.18411552,696,62.81588448,1108,13,1121,1,1417,79.11079746
臺北市,大安區,通化里,862,586,49.87234043,589,50.12765957,1175,28,1203,0,1464,82.17213115
臺北市,大安區,通化里,863,706,49.33612858,725,50.66387142,1431,35,1466,0,1780,82.35955056
臺北市,大安區,通化里,864,660,45.42326222,793,54.57673778,1453,28,1481,1,1809,81.8684356
臺北市,大安區,通安里,865,508,38.98695318,795,61.01304682,1303,28,1331,0,1663,80.03607937
臺北市,大安區,通安里,866,491,41.05351171,705,58.94648829,1196,35,1231,0,1546,79.62483829
臺北市,大安區,通安里,867,482,39.28280359,745,60.71719641,1227,27,1254,0,1539,81.48148148
臺北市,大安區,臨江里,868,608,42.96819788,807,57.03180212,1415,30,1445,0,1768,81.73076923
臺北市,大安區,臨江里,869,591,42.21428571,809,57.78571429,1400,37,1437,0,1775,80.95774648
臺北市,大安區,法治里,870,438,30.78004216,985,69.21995784,1423,29,1452,0,1791,81.0720268
臺北市,大安區,法治里,871,526,37.73314204,868,62.26685796,1394,33,1427,0,1760,81.07954545
臺北市,大安區,全安里,872,510,36.90303907,872,63.09696093,1382,29,1411,0,1768,79.80769231
臺北市,大安區,全安里,873,527,37.88641265,864,62.11358735,1391,18,1409,0,1757,80.19351167
臺北市,大安區,群賢里,874,509,36.56609195,883,63.43390805,1392,23,1415,0,1776,79.67342342
臺北市,大安區,群賢里,875,377,31.76074136,810,68.23925864,1187,20,1207,0,1488,81.1155914
臺北市,大安區,群賢里,876,422,31.39880952,922,68.60119048,1344,18,1362,0,1772,76.86230248
臺北市,大安區,群英里,877,141,13.1898971,928,86.8101029,1069,11,1080,0,1331,81.1419985
臺北市,大安區,群英里,878,210,16.52242329,1061,83.47757671,1271,13,1284,0,1595,80.5015674
臺北市,大安區,群英里,879,346,29.17369309,840,70.82630691,1186,17,1203,0,1412,85.19830028
臺北市,大安區,群英里,880,316,22.89855072,1064,77.10144928,1380,21,1401,0,1669,83.94248053
臺北市,大安區,虎嘯里,881,311,34.55555556,589,65.44444444,900,26,926,0,1122,82.5311943
臺北市,大安區,虎嘯里,882,382,32.10084034,808,67.89915966,1190,19,1209,0,1524,79.33070866
臺北市,大安區,臥龍里,883,419,30.6959707,946,69.3040293,1365,32,1397,0,1760,79.375
臺北市,大安區,龍淵里,884,445,32.98739807,904,67.01260193,1349,21,1370,0,1710,80.11695906
臺北市,大安區,龍淵里,885,521,35.2027027,959,64.7972973,1480,18,1498,0,1826,82.03723987
臺北市,大安區,龍淵里,886,481,35.08388038,890,64.91611962,1371,26,1397,0,1703,82.03170875
臺北市,大安區,龍淵里,887,569,40.87643678,823,59.12356322,1392,24,1416,0,1720,82.3255814
臺北市,大安區,龍門里,888,405,42.76663147,542,57.23336853,947,15,962,0,1208,79.63576159
臺北市,大安區,龍門里,889,580,36.27267042,1019,63.72732958,1599,34,1633,0,2085,78.32134293
臺北市,大安區,大學里,890,451,36.72638436,777,63.27361564,1228,19,1247,0,1595,78.18181818
臺北市,大安區,大學里,891,507,38.97002306,794,61.02997694,1301,31,1332,0,1658,80.33775633
臺北市,大安區,大學里,892,479,39.48887057,734,60.51112943,1213,26,1239,0,1632,75.91911765
臺北市,大安區,大學里,893,452,35.42319749,824,64.57680251,1276,33,1309,0,1643,79.67133293
臺北市,大安區,芳和里,894,455,34.89263804,849,65.10736196,1304,23,1327,0,1595,83.19749216
臺北市,大安區,芳和里,895,479,36.78955453,823,63.21044547,1302,37,1339,0,1618,82.75648949
臺北市,大安區,芳和里,896,543,35.81794195,973,64.18205805,1516,29,1545,0,1863,82.93075684
臺北市,大安區,黎元里,897,403,35.38191396,736,64.61808604,1139,39,1178,0,1416,83.1920904
臺北市,大安區,黎元里,898,590,40.83044983,855,59.16955017,1445,25,1470,0,1738,84.57997699
臺北市,大安區,黎元里,899,465,40.19014693,692,59.80985307,1157,26,1183,0,1427,82.90119131
臺北市,大安區,黎孝里,900,501,40.76484947,728,59.23515053,1229,28,1257,0,1507,83.41074983
臺北市,大安區,黎孝里,901,481,39.29738562,743,60.70261438,1224,26,1250,0,1482,84.34547908
臺北市,大安區,黎孝里,902,390,29.14798206,948,70.85201794,1338,12,1350,0,1582,85.33501896
臺北市,大安區,黎孝里,903,520,38.80597015,820,61.19402985,1340,26,1366,0,1657,82.43814122
臺北市,大安區,黎和里,904,469,34.71502591,882,65.28497409,1351,34,1385,0,1693,81.80744241
臺北市,大安區,黎和里,905,493,31.72458172,1061,68.27541828,1554,32,1586,0,1922,82.5182102
臺北市,大安區,建安里,906,686,38.62612613,1090,61.37387387,1776,35,1811,0,2313,78.29658452
臺北市,大安區,建安里,907,465,33.72008702,914,66.27991298,1379,19,1398,0,1861,75.12090274
臺北市,大安區,建倫里,908,501,38.92773893,786,61.07226107,1287,19,1306,0,1669,78.25044937
臺北市,大安區,建倫里,909,460,35.24904215,845,64.75095785,1305,15,1320,0,1672,78.94736842
臺北市,大安區,建倫里,910,479,39.16598528,744,60.83401472,1223,18,1241,0,1586,78.24716267
臺北市,大安區,敦安里,911,479,42.50221828,648,57.49778172,1127,22,1149,1,1441,79.73629424
臺北市,大安區,敦安里,912,552,41.75491679,770,58.24508321,1322,15,1337,0,1676,79.77326969
臺北市,大安區,敦安里,913,616,40.47306176,906,59.52693824,1522,22,1544,0,1918,80.50052138
臺北市,大安區,正聲里,914,513,34.24566088,985,65.75433912,1498,25,1523,0,1905,79.94750656
臺北市,大安區,正聲里,915,569,34.92940454,1060,65.07059546,1629,27,1656,0,2104,78.70722433
臺北市,大安區,敦煌里,916,556,41.09386548,797,58.90613452,1353,11,1364,0,1658,82.26779252
臺北市,大安區,敦煌里,917,506,41.74917492,706,58.25082508,1212,14,1226,0,1593,76.96170747
臺北市,大安區,敦煌里,918,513,41.80929095,714,58.19070905,1227,16,1243,0,1560,79.67948718
臺北市,大安區,華聲里,919,500,36.98224852,852,63.01775148,1352,18,1370,0,1725,79.42028986
臺北市,大安區,華聲里,920,541,38.2602546,873,61.7397454,1414,31,1445,2,1812,79.74613687
臺北市,大安區,車層里,921,552,40.79822616,801,59.20177384,1353,23,1376,0,1776,77.47747748
臺北市,大安區,車層里,922,611,42.63782275,822,57.36217725,1433,21,1454,0,1822,79.80241493
臺北市,大安區,車層里,923,563,41.12490869,806,58.87509131,1369,15,1384,0,1717,80.60570763
臺北市,大安區,光信里,924,492,38.28793774,793,61.71206226,1285,24,1309,0,1610,81.30434783
臺北市,大安區,光信里,925,517,40.29618083,766,59.70381917,1283,21,1304,0,1632,79.90196078
臺北市,大安區,光信里,926,478,38.30128205,770,61.69871795,1248,19,1267,0,1571,80.64926798
臺北市,大安區,光信里,927,473,41.27399651,673,58.72600349,1146,25,1171,0,1502,77.96271638
臺北市,大安區,學府里,928,179,29.39244663,430,70.60755337,609,18,627,0,792,79.16666667
臺北市,大安區,學府里,929,328,33.46938776,652,66.53061224,980,25,1005,0,1340,75
臺北市,大安區,學府里,930,256,28.95927602,628,71.04072398,884,23,907,0,1115,81.34529148
臺北市,中正區,水源里,931,544,45.94594595,640,54.05405405,1184,16,1200,0,1460,82.19178082
臺北市,中正區,水源里,932,405,44.45664105,506,55.54335895,911,19,930,0,1147,81.08108108
臺北市,中正區,富水里,933,154,15.47738693,841,84.52261307,995,9,1004,0,1327,75.65938206
臺北市,中正區,富水里,934,260,26.50356779,721,73.49643221,981,30,1011,0,1217,83.07313065
臺北市,中正區,文盛里,935,380,42.45810056,515,57.54189944,895,17,912,0,1126,80.9946714
臺北市,中正區,文盛里,936,377,41.70353982,527,58.29646018,904,14,918,0,1152,79.6875
臺北市,中正區,林興里,937,343,32.60456274,709,67.39543726,1052,25,1077,0,1312,82.08841463
臺北市,中正區,林興里,938,369,35.54913295,669,64.45086705,1038,21,1059,0,1309,80.90145149
臺北市,中正區,林興里,939,398,36.18181818,702,63.81818182,1100,20,1120,0,1396,80.22922636
臺北市,中正區,河堤里,940,370,36.23898139,651,63.76101861,1021,14,1035,0,1274,81.24018838
臺北市,中正區,河堤里,941,316,34.01506997,613,65.98493003,929,6,935,0,1143,81.80227472
臺北市,中正區,河堤里,942,395,36.6419295,683,63.3580705,1078,23,1101,0,1440,76.45833333
臺北市,中正區,頂東里,943,563,41.58050222,791,58.41949778,1354,17,1371,0,1661,82.54063817
臺北市,中正區,頂東里,944,555,43.25798909,728,56.74201091,1283,16,1299,0,1575,82.47619048
臺北市,中正區,頂東里,945,431,37.57628596,716,62.42371404,1147,26,1173,0,1464,80.12295082
臺北市,中正區,網溪里,946,470,36.8338558,806,63.1661442,1276,22,1298,0,1642,79.0499391
臺北市,中正區,網溪里,947,499,42.50425894,675,57.49574106,1174,24,1198,0,1486,80.61911171
臺北市,中正區,網溪里,948,435,39.61748634,663,60.38251366,1098,12,1110,0,1361,81.55767818
臺北市,中正區,板溪里,949,516,45.90747331,608,54.09252669,1124,27,1151,0,1443,79.76437976
臺北市,中正區,板溪里,950,413,37.47731397,689,62.52268603,1102,29,1131,0,1423,79.47997189
臺北市,中正區,螢圃里,951,523,37.27726301,880,62.72273699,1403,19,1422,0,1737,81.86528497
臺北市,中正區,螢圃里,952,534,40.60836502,781,59.39163498,1315,32,1347,0,1620,83.14814815
臺北市,中正區,螢圃里,953,396,44.84711212,487,55.15288788,883,11,894,0,1110,80.54054054
臺北市,中正區,螢雪里,954,386,40.71729958,562,59.28270042,948,13,961,0,1172,81.99658703
臺北市,中正區,螢雪里,955,427,39.90654206,643,60.09345794,1070,24,1094,0,1293,84.60943542
臺北市,中正區,螢雪里,956,392,41.74653887,547,58.25346113,939,31,970,0,1216,79.76973684
臺北市,中正區,永功里,957,703,48.68421053,741,51.31578947,1444,35,1479,0,1789,82.67188373
臺北市,中正區,永功里,958,682,47.99437016,739,52.00562984,1421,31,1452,0,1761,82.45315162
臺北市,中正區,永功里,959,522,42.99835255,692,57.00164745,1214,21,1235,0,1540,80.19480519
臺北市,中正區,永昌里,960,558,46.19205298,650,53.80794702,1208,20,1228,0,1503,81.70326015
臺北市,中正區,永昌里,961,532,43.8582028,681,56.1417972,1213,28,1241,0,1542,80.47989624
臺北市,中正區,永昌里,962,485,43.11111111,640,56.88888889,1125,26,1151,0,1414,81.40028289
臺北市,中正區,龍興里,963,620,45.48789435,743,54.51210565,1363,21,1384,0,1667,83.02339532
臺北市,中正區,龍興里,964,498,41.36212625,706,58.63787375,1204,16,1220,0,1470,82.99319728
臺北市,中正區,忠勤里,965,435,36.55462185,755,63.44537815,1190,40,1230,0,1555,79.09967846
臺北市,中正區,忠勤里,966,462,37.80687398,760,62.19312602,1222,18,1240,0,1504,82.44680851
臺北市,中正區,忠勤里,967,417,39.56356736,637,60.43643264,1054,32,1086,0,1364,79.61876833
臺北市,中正區,忠勤里,968,516,46.69683258,589,53.30316742,1105,33,1138,0,1388,81.98847262
臺北市,中正區,廈安里,969,500,41.94630872,692,58.05369128,1192,27,1219,0,1460,83.49315068
臺北市,中正區,廈安里,970,559,44.82758621,688,55.17241379,1247,27,1274,0,1596,79.8245614
臺北市,中正區,愛國里,971,466,46.64664665,533,53.35335335,999,17,1016,0,1262,80.50713154
臺北市,中正區,愛國里,972,401,40.75203252,583,59.24796748,984,18,1002,0,1236,81.06796117
臺北市,中正區,南門里,973,329,32.96593186,669,67.03406814,998,15,1013,0,1249,81.10488391
臺北市,中正區,南門里,974,231,28.30882353,585,71.69117647,816,13,829,0,1055,78.57819905
臺北市,中正區,龍光里,975,421,36.26184324,740,63.73815676,1161,23,1184,0,1469,80.59904697
臺北市,中正區,龍光里,976,429,37.27193745,722,62.72806255,1151,11,1162,0,1427,81.42957253
臺北市,中正區,南福里,977,588,42.12034384,808,57.87965616,1396,30,1426,0,1730,82.42774566
臺北市,中正區,南福里,978,518,42.52873563,700,57.47126437,1218,19,1237,0,1453,85.13420509
臺北市,中正區,南福里,979,459,39.33161954,708,60.66838046,1167,18,1185,0,1515,78.21782178
臺北市,中正區,南福里,980,463,37.33870968,777,62.66129032,1240,22,1262,1,1511,83.52084712
臺北市,中正區,龍福里,981,508,37.27072634,855,62.72927366,1363,19,1382,0,2069,66.79555341
臺北市,中正區,龍福里,982,472,36.16858238,833,63.83141762,1305,18,1323,0,1622,81.56596794
臺北市,中正區,龍福里,983,548,39.7966594,829,60.2033406,1377,30,1407,0,1684,83.55106888
臺北市,中正區,新營里,984,473,35.61746988,855,64.38253012,1328,22,1350,0,1562,86.42765685
臺北市,中正區,新營里,985,459,34.77272727,861,65.22727273,1320,24,1344,0,1616,83.16831683
臺北市,中正區,新營里,986,434,32.1958457,914,67.8041543,1348,24,1372,0,1636,83.86308068
臺北市,中正區,新營里,987,312,25.16129032,928,74.83870968,1240,24,1264,0,1518,83.26745718
臺北市,中正區,建國里,988,260,30.76923077,585,69.23076923,845,9,854,0,1150,74.26086957
臺北市,中正區,光復里,989,489,45.87242026,577,54.12757974,1066,24,1090,0,1356,80.38348083
臺北市,中正區,光復里,990,526,42.72948822,705,57.27051178,1231,23,1254,0,1650,76
臺北市,中正區,黎明里,991,284,37.71580345,469,62.28419655,753,14,767,0,1036,74.03474903
臺北市,中正區,黎明里,992,413,39.18406072,641,60.81593928,1054,25,1079,0,1422,75.8790436
臺北市,中正區,梅花里,993,475,41.41238012,672,58.58761988,1147,21,1168,0,1498,77.9706275
臺北市,中正區,梅花里,994,443,41.20930233,632,58.79069767,1075,22,1097,1,1384,79.26300578
臺北市,中正區,幸福里,995,541,33.98241206,1051,66.01758794,1592,37,1629,1,2047,79.57987298
臺北市,中正區,幸福里,996,626,47.85932722,682,52.14067278,1308,31,1339,0,1670,80.17964072
臺北市,中正區,幸市里,997,637,47.15025907,714,52.84974093,1351,22,1373,0,1729,79.41006362
臺北市,中正區,幸市里,998,592,44.17910448,748,55.82089552,1340,26,1366,0,1754,77.87913341
臺北市,中正區,東門里,999,338,36.65943601,584,63.34056399,922,20,942,0,1152,81.77083333
臺北市,中正區,東門里,1000,281,29.76694915,663,70.23305085,944,12,956,0,1171,81.63962425
臺北市,中正區,東門里,1001,283,28.49949648,710,71.50050352,993,22,1015,0,1292,78.56037152
臺北市,中正區,文北里,1002,395,35.17364203,728,64.82635797,1123,19,1142,0,1403,81.39700641
臺北市,中正區,文北里,1003,516,47.42647059,572,52.57352941,1088,16,1104,0,1395,79.13978495
臺北市,中正區,文北里,1004,441,43.1085044,582,56.8914956,1023,17,1040,0,1347,77.20861173
臺北市,中正區,文祥里,1005,495,41.94915254,685,58.05084746,1180,21,1201,0,1430,83.98601399
臺北市,中正區,文祥里,1006,383,38.41524574,614,61.58475426,997,16,1013,0,1222,82.89689034
臺北市,中正區,文祥里,1007,462,40.95744681,666,59.04255319,1128,27,1155,0,1415,81.6254417
臺北市,中正區,文祥里,1008,444,39.39662822,683,60.60337178,1127,27,1154,0,1378,83.74455733
臺北市,中正區,三愛里,1009,435,40.24051804,646,59.75948196,1081,25,1106,0,1392,79.45402299
臺北市,中正區,三愛里,1010,614,46.58573596,704,53.41426404,1318,19,1337,0,1634,81.82374541
臺北市,中正區,三愛里,1011,459,42.69767442,616,57.30232558,1075,14,1089,0,1356,80.30973451
臺北市,中正區,三愛里,1012,579,43.24122479,760,56.75877521,1339,27,1366,0,1695,80.5899705
臺北市,萬華區,福星里,1013,559,47.05387205,629,52.94612795,1188,25,1213,0,1488,81.5188172
臺北市,萬華區,福星里,1014,286,33.14020857,577,66.85979143,863,26,889,0,1123,79.16295637
臺北市,萬華區,福星里,1015,652,50.89773614,629,49.10226386,1281,22,1303,0,1657,78.63608932
臺北市,萬華區,萬壽里,1016,440,44.26559356,554,55.73440644,994,33,1027,0,1406,73.04409673
臺北市,萬華區,萬壽里,1017,508,47.3880597,564,52.6119403,1072,20,1092,0,1418,77.00987306
臺北市,萬華區,西門里,1018,463,39.17089679,719,60.82910321,1182,26,1208,0,1605,75.26479751
臺北市,萬華區,西門里,1019,407,40.17769003,606,59.82230997,1013,29,1042,0,1331,78.28700225
臺北市,萬華區,新起里,1020,603,53.64768683,521,46.35231317,1124,41,1165,0,1426,81.6970547
臺北市,萬華區,新起里,1021,568,45.69589702,675,54.30410298,1243,32,1275,0,1588,80.28967254
臺北市,萬華區,新起里,1022,524,46.49511979,603,53.50488021,1127,39,1166,0,1483,78.62440998
臺北市,萬華區,新起里,1023,380,34.42028986,724,65.57971014,1104,28,1132,0,1388,81.55619597
臺北市,萬華區,菜園里,1024,580,46.77419355,660,53.22580645,1240,34,1274,0,1595,79.87460815
臺北市,萬華區,菜園里,1025,703,54.03535742,598,45.96464258,1301,46,1347,0,1900,70.89473684
臺北市,萬華區,菜園里,1026,792,55.93220339,624,44.06779661,1416,26,1442,0,1774,81.28523112
臺北市,萬華區,青山里,1027,636,53.58045493,551,46.41954507,1187,24,1211,0,1523,79.51411687
臺北市,萬華區,青山里,1028,702,57.21271394,525,42.78728606,1227,32,1259,0,1581,79.63314358
臺北市,萬華區,青山里,1029,567,52.20994475,519,47.79005525,1086,36,1122,0,1424,78.79213483
臺北市,萬華區,富民里,1030,778,56.58181818,597,43.41818182,1375,18,1393,0,1675,83.1641791
臺北市,萬華區,富民里,1031,540,58.00214823,391,41.99785177,931,32,963,0,1199,80.31693078
臺北市,萬華區,富民里,1032,652,59.81651376,438,40.18348624,1090,31,1121,0,1359,82.48712288
臺北市,萬華區,福音里,1033,685,52.25019069,626,47.74980931,1311,31,1342,0,1591,84.34946574
臺北市,萬華區,福音里,1034,659,54.0607055,560,45.9392945,1219,26,1245,0,1516,82.12401055
臺北市,萬華區,仁德里,1035,737,47.79507134,805,52.20492866,1542,33,1575,0,1928,81.69087137
臺北市,萬華區,仁德里,1036,756,54.38848921,634,45.61151079,1390,30,1420,0,1702,83.43125734
臺北市,萬華區,富福里,1037,589,55.88235294,465,44.11764706,1054,15,1069,0,1285,83.19066148
臺北市,萬華區,富福里,1038,543,53.76237624,467,46.23762376,1010,16,1026,0,1217,84.30566968
臺北市,萬華區,富福里,1039,663,57.85340314,483,42.14659686,1146,19,1165,0,1364,85.41055718
臺北市,萬華區,頂碩里,1052,844,61.96769457,518,38.03230543,1362,29,1391,0,2021,68.82731321
臺北市,萬華區,頂碩里,1053,1012,63.0529595,593,36.9470405,1605,17,1622,0,1920,84.47916667
臺北市,萬華區,頂碩里,1054,678,56.40599002,524,43.59400998,1202,23,1225,0,1463,83.73205742
臺北市,萬華區,頂碩里,1055,685,53.7254902,590,46.2745098,1275,36,1311,0,1544,84.90932642
臺北市,萬華區,雙園里,1056,651,54.47698745,544,45.52301255,1195,25,1220,0,1540,79.22077922
臺北市,萬華區,雙園里,1057,619,56.01809955,486,43.98190045,1105,24,1129,0,1359,83.07579102
臺北市,萬華區,雙園里,1058,653,55.81196581,517,44.18803419,1170,34,1204,0,1494,80.58902276
臺北市,萬華區,新忠里,1059,330,27.25020644,881,72.74979356,1211,37,1248,0,1598,78.09762203
臺北市,萬華區,新忠里,1060,141,9.818941504,1295,90.1810585,1436,18,1454,0,1736,83.75576037
臺北市,萬華區,新和里,1061,132,10.16166282,1167,89.83833718,1299,18,1317,0,1522,86.53088042
臺北市,萬華區,新和里,1062,264,21.22186495,980,78.77813505,1244,27,1271,0,1502,84.62050599
臺北市,萬華區,新和里,1063,402,31.65354331,868,68.34645669,1270,24,1294,0,1503,86.09447771
臺北市,萬華區,新和里,1064,191,16.50821089,966,83.49178911,1157,35,1192,0,1495,79.73244147
臺北市,萬華區,新和里,1065,374,31.29707113,821,68.70292887,1195,22,1217,0,1409,86.37331441
臺北市,萬華區,糖部里,1040,1056,55.84346906,835,44.15653094,1891,40,1931,0,2366,81.61453931
臺北市,萬華區,糖部里,1041,864,49.09090909,896,50.90909091,1760,40,1800,0,2185,82.3798627
臺北市,萬華區,和平里,1066,847,63.68421053,483,36.31578947,1330,22,1352,0,1642,82.33861145
臺北市,萬華區,和平里,1067,750,59.57108817,509,40.42891183,1259,35,1294,0,1542,83.91699092
臺北市,萬華區,和平里,1068,579,54.51977401,483,45.48022599,1062,20,1082,0,1310,82.59541985
臺北市,萬華區,和平里,1069,720,57.32484076,536,42.67515924,1256,45,1301,0,1586,82.03026482
臺北市,萬華區,綠堤里,1042,626,56.04297225,491,43.95702775,1117,28,1145,0,1371,83.51568198
臺北市,萬華區,綠堤里,1043,417,43.03405573,552,56.96594427,969,31,1000,1,1281,78.06401249
臺北市,萬華區,綠堤里,1044,484,47.12755599,543,52.87244401,1027,39,1066,0,1320,80.75757576
臺北市,萬華區,華江里,1045,639,48.04511278,691,51.95488722,1330,37,1367,0,1627,84.0196681
臺北市,萬華區,華江里,1046,698,55.26524149,565,44.73475851,1263,22,1285,0,1588,80.91939547
臺北市,萬華區,華江里,1047,806,53.06122449,713,46.93877551,1519,29,1548,0,1854,83.49514563
臺北市,萬華區,華江里,1048,822,54.22163588,694,45.77836412,1516,39,1555,0,2003,77.63354968
臺北市,萬華區,柳鄉里,1049,897,58.43648208,638,41.56351792,1535,19,1554,0,1924,80.76923077
臺北市,萬華區,柳鄉里,1050,612,58.84615385,428,41.15384615,1040,20,1060,0,1291,82.10689388
臺北市,萬華區,柳鄉里,1051,608,57.14285714,456,42.85714286,1064,33,1097,0,1342,81.74366617
臺北市,萬華區,日善里,1070,659,52.09486166,606,47.90513834,1265,29,1294,0,1543,83.86260531
臺北市,萬華區,日善里,1071,770,54.37853107,646,45.62146893,1416,25,1441,0,1688,85.36729858
臺北市,萬華區,新安里,1072,491,40.81463009,712,59.18536991,1203,40,1243,0,1528,81.34816754
臺北市,萬華區,新安里,1073,485,41.77433247,676,58.22566753,1161,24,1185,0,1429,82.92512246
臺北市,萬華區,新安里,1074,323,34.14376321,623,65.85623679,946,21,967,0,1197,80.78529657
臺北市,萬華區,新安里,1075,247,23.54623451,802,76.45376549,1049,25,1074,0,1278,84.03755869
臺北市,萬華區,忠德里,1076,862,59.16266301,595,40.83733699,1457,42,1499,0,1806,83.00110742
臺北市,萬華區,忠德里,1077,900,55.72755418,715,44.27244582,1615,33,1648,0,1972,83.56997972
臺北市,萬華區,孝德里,1078,725,59.5727198,492,40.4272802,1217,23,1240,0,1488,83.33333333
臺北市,萬華區,孝德里,1079,599,57.15648855,449,42.84351145,1048,13,1061,0,1253,84.67677574
臺北市,萬華區,和德里,1080,773,59.18836141,533,40.81163859,1306,22,1328,0,1566,84.80204342
臺北市,萬華區,和德里,1081,633,56.36687444,490,43.63312556,1123,23,1146,0,1513,75.74355585
臺北市,萬華區,和德里,1082,610,52.76816609,546,47.23183391,1156,31,1187,0,1484,79.98652291
臺北市,萬華區,和德里,1083,683,59.28819444,469,40.71180556,1152,24,1176,0,1405,83.70106762
臺北市,萬華區,錦德里,1084,687,55.09222133,560,44.90777867,1247,28,1275,0,1523,83.71634931
臺北市,萬華區,錦德里,1085,627,49.72244251,634,50.27755749,1261,44,1305,0,1584,82.38636364
臺北市,萬華區,錦德里,1086,592,53.18957772,521,46.81042228,1113,27,1140,0,1343,84.88458675
臺北市,萬華區,全德里,1087,739,52.59786477,666,47.40213523,1405,32,1437,0,1725,83.30434783
臺北市,萬華區,全德里,1088,704,48.21917808,756,51.78082192,1460,24,1484,0,1809,82.03427308
臺北市,萬華區,保德里,1089,548,52.9468599,487,47.0531401,1035,16,1051,0,1241,84.68976632
臺北市,萬華區,保德里,1090,545,53.58898722,472,46.41101278,1017,26,1043,0,1241,84.0451249
臺北市,萬華區,銘德里,1091,605,52.65448216,544,47.34551784,1149,18,1167,0,1392,83.8362069
臺北市,萬華區,銘德里,1092,696,56.63140765,533,43.36859235,1229,31,1260,0,1469,85.77263445
臺北市,萬華區,銘德里,1093,468,49.84025559,471,50.15974441,939,11,950,0,1155,82.25108225
臺北市,萬華區,榮德里,1094,676,52.16049383,620,47.83950617,1296,33,1329,0,1559,85.24695318
臺北市,萬華區,榮德里,1095,738,52.52669039,667,47.47330961,1405,37,1442,0,1699,84.87345497
臺北市,萬華區,壽德里,1096,607,50.92281879,585,49.07718121,1192,29,1221,0,1462,83.51573187
臺北市,萬華區,壽德里,1097,549,48.41269841,585,51.58730159,1134,22,1156,1,1377,83.95061728
臺北市,萬華區,壽德里,1098,535,51.79090029,498,48.20909971,1033,17,1050,0,1210,86.7768595
臺北市,萬華區,興德里,1099,559,54.69667319,463,45.30332681,1022,22,1044,0,1250,83.52
臺北市,萬華區,興德里,1100,583,51.59292035,547,48.40707965,1130,32,1162,0,1404,82.76353276
臺北市,萬華區,興德里,1101,622,58.13084112,448,41.86915888,1070,28,1098,0,1350,81.33333333
臺北市,萬華區,華中里,1102,800,52.52790545,723,47.47209455,1523,35,1558,0,1863,83.62855609
臺北市,萬華區,華中里,1103,811,56.04699378,636,43.95300622,1447,42,1489,0,1760,84.60227273
臺北市,萬華區,華中里,1104,708,53.92231531,605,46.07768469,1313,27,1340,1,1600,83.75
臺北市,萬華區,日祥里,1105,623,46.28528975,723,53.71471025,1346,44,1390,0,1683,82.590612
臺北市,萬華區,日祥里,1106,496,36.95976155,846,63.04023845,1342,32,1374,0,1618,84.91965389
臺北市,萬華區,日祥里,1107,208,15.90214067,1100,84.09785933,1308,35,1343,0,1590,84.46540881
臺北市,萬華區,忠貞里,1108,198,18.18181818,891,81.81818182,1089,23,1112,0,1327,83.79804069
臺北市,萬華區,忠貞里,1109,283,21.42316427,1038,78.57683573,1321,18,1339,0,1541,86.89162881
臺北市,萬華區,忠貞里,1110,514,44.96937883,629,55.03062117,1143,31,1174,0,1439,81.58443363
臺北市,萬華區,凌霄里,1111,461,36.015625,819,63.984375,1280,15,1295,0,1583,81.80669615
臺北市,萬華區,凌霄里,1112,414,26.98826597,1120,73.01173403,1534,67,1601,0,1943,82.39835306
臺北市,萬華區,騰雲里,1113,341,29.83377078,802,70.16622922,1143,19,1162,0,1413,82.2363765
臺北市,萬華區,騰雲里,1114,370,36.70634921,638,63.29365079,1008,27,1035,0,1232,84.00974026
臺北市,文山區,景行里,1115,445,42.62452107,599,57.37547893,1044,19,1063,0,1324,80.28700906
臺北市,文山區,景行里,1116,683,49.67272727,692,50.32727273,1375,39,1414,0,1714,82.49708285
臺北市,文山區,景行里,1117,509,47.26090994,568,52.73909006,1077,14,1091,0,1308,83.40978593
臺北市,文山區,景東里,1118,451,31.40668524,985,68.59331476,1436,24,1460,0,1778,82.11473566
臺北市,文山區,景東里,1119,461,32.39634575,962,67.60365425,1423,22,1445,1,1744,82.85550459
臺北市,文山區,景東里,1120,443,31.55270655,961,68.44729345,1404,20,1424,0,1732,82.21709007
臺北市,文山區,景美里,1121,514,35.06139154,952,64.93860846,1466,32,1498,0,1826,82.03723987
臺北市,文山區,景美里,1122,595,42.19858156,815,57.80141844,1410,8,1418,0,1708,83.02107728
臺北市,文山區,景慶里,1123,396,31.32911392,868,68.67088608,1264,32,1296,0,1584,81.81818182
臺北市,文山區,景慶里,1124,505,36.86131387,865,63.13868613,1370,34,1404,0,1697,82.73423689
臺北市,文山區,景慶里,1125,580,40.30576789,859,59.69423211,1439,27,1466,0,1741,84.20448018
臺北市,文山區,景仁里,1126,502,35.50212164,912,64.49787836,1414,17,1431,0,1716,83.39160839
臺北市,文山區,景仁里,1127,519,34.21226104,998,65.78773896,1517,32,1549,0,1879,82.43746674
臺北市,文山區,景華里,1128,397,32.59441708,821,67.40558292,1218,18,1236,0,1502,82.29027963
臺北市,文山區,景華里,1129,430,34.45512821,818,65.54487179,1248,22,1270,0,1553,81.77720541
臺北市,文山區,景華里,1130,467,39.30976431,721,60.69023569,1188,16,1204,0,1430,84.1958042
臺北市,文山區,萬有里,1131,546,37.89035392,895,62.10964608,1441,26,1467,0,1729,84.84673222
臺北市,文山區,萬有里,1132,575,34.14489311,1109,65.85510689,1684,36,1720,1,2025,84.9382716
臺北市,文山區,萬祥里,1133,526,37.14689266,890,62.85310734,1416,15,1431,2,1713,83.53765324
臺北市,文山區,萬祥里,1134,569,36.87621517,974,63.12378483,1543,27,1570,0,1860,84.40860215
臺北市,文山區,萬隆里,1135,429,28.26086957,1089,71.73913043,1518,13,1531,0,1861,82.26759807
臺北市,文山區,萬隆里,1136,443,31.55270655,961,68.44729345,1404,25,1429,1,1771,80.68887634
臺北市,文山區,萬隆里,1137,584,34.5971564,1104,65.4028436,1688,20,1708,0,2017,84.68021815
臺北市,文山區,萬年里,1138,516,41.88311688,716,58.11688312,1232,22,1254,0,1537,81.58750813
臺北市,文山區,萬年里,1139,437,38.9483066,685,61.0516934,1122,23,1145,0,1372,83.4548105
臺北市,文山區,萬年里,1140,371,32.74492498,762,67.25507502,1133,25,1158,0,1424,81.32022472
臺北市,文山區,萬和里,1141,327,27.22731057,874,72.77268943,1201,24,1225,0,1469,83.39006127
臺北市,文山區,萬和里,1142,148,13.78026071,926,86.21973929,1074,33,1107,1,1314,84.24657534
臺北市,文山區,萬盛里,1143,494,33.51424695,980,66.48575305,1474,28,1502,0,1829,82.1213778
臺北市,文山區,萬盛里,1144,510,31.19266055,1125,68.80733945,1635,38,1673,0,2007,83.35824614
臺北市,文山區,興豐里,1145,587,39.66216216,893,60.33783784,1480,33,1513,0,1843,82.09441129
臺北市,文山區,興豐里,1146,436,35.076428,807,64.923572,1243,28,1271,0,1490,85.30201342
臺北市,文山區,興豐里,1147,450,30.86419753,1008,69.13580247,1458,37,1495,0,1821,82.09774849
臺北市,文山區,興豐里,1148,357,24.40191388,1106,75.59808612,1463,36,1499,0,1748,85.75514874
臺北市,文山區,興光里,1149,395,37.05440901,671,62.94559099,1066,22,1088,2,1338,81.31539611
臺北市,文山區,興光里,1150,311,30.88381331,696,69.11618669,1007,24,1031,0,1224,84.23202614
臺北市,文山區,興家里,1151,525,33.48214286,1043,66.51785714,1568,21,1589,0,1922,82.67429761
臺北市,文山區,興家里,1152,499,28.04946599,1280,71.95053401,1779,22,1801,0,2116,85.11342155
臺北市,文山區,興家里,1153,488,31.89542484,1042,68.10457516,1530,30,1560,0,1913,81.54730789
臺北市,文山區,興得里,1154,432,34.06940063,836,65.93059937,1268,23,1291,0,1553,83.12942692
臺北市,文山區,興得里,1155,468,31.98906357,995,68.01093643,1463,23,1486,0,1832,81.11353712
臺北市,文山區,興得里,1156,463,35.1556568,854,64.8443432,1317,26,1343,0,1645,81.64133739
臺北市,文山區,興業里,1157,372,28.16048448,949,71.83951552,1321,20,1341,0,1892,70.87737844
臺北市,文山區,興業里,1158,333,27.75,867,72.25,1200,17,1217,1,1471,82.73283481
臺北市,文山區,興業里,1159,266,23.60248447,861,76.39751553,1127,23,1150,0,1396,82.3782235
臺北市,文山區,興安里,1160,435,34.03755869,843,65.96244131,1278,24,1302,0,1569,82.98279159
臺北市,文山區,興安里,1161,398,29.15750916,967,70.84249084,1365,15,1380,0,1664,82.93269231
臺北市,文山區,興安里,1162,429,29.48453608,1026,70.51546392,1455,26,1481,0,1743,84.96844521
臺北市,文山區,興福里,1163,465,36.87549564,796,63.12450436,1261,16,1277,0,1472,86.75271739
臺北市,文山區,興福里,1164,468,37.46997598,781,62.53002402,1249,17,1266,0,1477,85.71428571
臺北市,文山區,興福里,1165,509,35.37178596,930,64.62821404,1439,23,1462,0,1716,85.1981352
臺北市,文山區,興旺里,1166,378,27.93791574,975,72.06208426,1353,28,1381,0,1681,82.15348007
臺北市,文山區,興旺里,1167,405,28.74378992,1004,71.25621008,1409,24,1433,0,1716,83.50815851
臺北市,文山區,興旺里,1168,538,30.14005602,1247,69.85994398,1785,38,1823,0,2210,82.48868778
臺北市,文山區,興泰里,1169,429,32.15892054,905,67.84107946,1334,29,1363,0,1660,82.10843373
臺北市,文山區,興泰里,1170,376,31.83742591,805,68.16257409,1181,29,1210,0,1443,83.85308385
臺北市,文山區,興昌里,1171,338,24.72567666,1029,75.27432334,1367,27,1394,0,1719,81.0936591
臺北市,文山區,興昌里,1172,451,32.84777859,922,67.15222141,1373,33,1406,0,1701,82.65726044
臺北市,文山區,興昌里,1173,357,27.46153846,943,72.53846154,1300,19,1319,0,1591,82.90383407
臺北市,文山區,試院里,1174,304,23.03030303,1016,76.96969697,1320,16,1336,0,1588,84.13098237
臺北市,文山區,試院里,1175,431,28.79091516,1066,71.20908484,1497,18,1515,0,1799,84.21345192
臺北市,文山區,試院里,1176,426,30.60344828,966,69.39655172,1392,17,1409,0,1672,84.27033493
臺北市,文山區,華興里,1177,543,32.63221154,1121,67.36778846,1664,31,1695,0,2039,83.1289848
臺北市,文山區,華興里,1178,568,33.43143025,1131,66.56856975,1699,20,1719,0,2076,82.80346821
臺北市,文山區,華興里,1179,521,33.48329049,1035,66.51670951,1556,33,1589,0,1872,84.88247863
臺北市,文山區,明義里,1180,462,32.8125,946,67.1875,1408,40,1448,0,1725,83.94202899
臺北市,文山區,明義里,1181,318,34.04710921,616,65.95289079,934,58,992,0,1326,74.81146305
臺北市,文山區,明義里,1182,206,32.64659271,425,67.35340729,631,43,674,0,934,72.1627409
臺北市,文山區,明興里,1183,524,32.26600985,1100,67.73399015,1624,34,1658,0,1973,84.03446528
臺北市,文山區,明興里,1184,475,30.44871795,1085,69.55128205,1560,38,1598,0,1937,82.49870934
臺北市,文山區,明興里,1185,394,26.85753238,1073,73.14246762,1467,20,1487,0,1761,84.44065872
臺北市,文山區,木柵里,1186,666,33.33333333,1332,66.66666667,1998,34,2032,0,2438,83.34700574
臺北市,文山區,木柵里,1187,542,30.0443459,1262,69.9556541,1804,36,1840,0,2164,85.02772643
臺北市,文山區,木柵里,1188,199,17.79964222,919,82.20035778,1118,15,1133,0,1299,87.22093918
臺北市,文山區,木新里,1189,475,40.66780822,693,59.33219178,1168,23,1191,0,1522,78.25229961
臺北市,文山區,木新里,1190,629,42.61517615,847,57.38482385,1476,35,1511,0,1837,82.25367447
臺北市,文山區,木新里,1191,529,34.68852459,996,65.31147541,1525,26,1551,0,1887,82.19395866
臺北市,文山區,木新里,1192,543,37.44827586,907,62.55172414,1450,21,1471,0,1799,81.76764869
臺北市,文山區,順興里,1193,665,39.3258427,1026,60.6741573,1691,38,1729,0,2081,83.08505526
臺北市,文山區,順興里,1194,559,37.82138024,919,62.17861976,1478,23,1501,0,1785,84.08963585
臺北市,文山區,順興里,1195,477,36.72055427,822,63.27944573,1299,24,1323,0,1596,82.89473684
臺北市,文山區,樟林里,1198,326,27.03150912,880,72.96849088,1206,15,1221,0,1484,82.27762803
臺北市,文山區,樟林里,1199,428,31.4937454,931,68.5062546,1359,27,1386,0,1681,82.45092207
臺北市,文山區,樟林里,1200,577,37.7865095,950,62.2134905,1527,33,1560,0,1838,84.87486398
臺北市,文山區,樟林里,1201,418,30.8259587,938,69.1740413,1356,19,1375,0,1627,84.51137062
臺北市,文山區,樟新里,1202,462,36.57957245,801,63.42042755,1263,19,1282,0,1512,84.78835979
臺北市,文山區,樟新里,1203,519,37.3650108,870,62.6349892,1389,36,1425,0,1698,83.92226148
臺北市,文山區,樟新里,1204,553,34.39054726,1055,65.60945274,1608,39,1647,0,1990,82.7638191
臺北市,文山區,樟新里,1205,644,38.08397398,1047,61.91602602,1691,33,1724,0,2067,83.40590227
臺北市,文山區,樟新里,1206,471,33.35694051,941,66.64305949,1412,29,1441,0,1712,84.17056075
臺北市,文山區,樟腳里,1207,608,37.23208818,1025,62.76791182,1633,33,1666,0,2004,83.13373253
臺北市,文山區,樟腳里,1208,497,36.11918605,879,63.88081395,1376,25,1401,0,1651,84.85766202
臺北市,文山區,樟腳里,1209,496,37.9204893,812,62.0795107,1308,29,1337,0,1612,82.94044665
臺北市,文山區,樟腳里,1210,595,37.58686039,988,62.41313961,1583,27,1610,0,1914,84.11703239
臺北市,文山區,萬芳里,1211,285,34.00954654,553,65.99045346,838,11,849,0,1044,81.32183908
臺北市,文山區,萬芳里,1212,483,29.72307692,1142,70.27692308,1625,33,1658,0,1970,84.16243655
臺北市,文山區,萬芳里,1213,680,30.60306031,1542,69.39693969,2222,44,2266,0,2717,83.40080972
臺北市,文山區,博嘉里,1217,560,38.83495146,882,61.16504854,1442,39,1481,0,1807,81.95904815
臺北市,文山區,博嘉里,1218,544,34.3651295,1039,65.6348705,1583,33,1616,0,1992,81.12449799
臺北市,文山區,萬興里,1219,688,38.60830527,1094,61.39169473,1782,32,1814,0,2213,81.97017623
臺北市,文山區,萬興里,1220,558,32.9009434,1138,67.0990566,1696,32,1728,1,2070,83.47826087
臺北市,文山區,萬興里,1221,725,42.77286136,970,57.22713864,1695,37,1732,0,2115,81.89125296
臺北市,文山區,萬興里,1222,511,30.14749263,1184,69.85250737,1695,15,1710,1,1992,85.84337349
臺北市,文山區,指南里,1223,524,39.25093633,811,60.74906367,1335,31,1366,0,1692,80.73286052
臺北市,文山區,指南里,1224,351,65.48507463,185,34.51492537,536,32,568,0,677,83.89955687
臺北市,文山區,老泉里,1225,357,62.19512195,217,37.80487805,574,17,591,0,711,83.12236287
臺北市,文山區,忠順里,1196,308,24.40570523,954,75.59429477,1262,33,1295,0,1531,84.58523841
臺北市,文山區,忠順里,1197,340,27.84602785,881,72.15397215,1221,23,1244,0,1470,84.62585034
臺北市,文山區,萬美里,1214,474,32.02702703,1006,67.97297297,1480,35,1515,0,1857,81.58319871
臺北市,文山區,萬美里,1215,351,30.52173913,799,69.47826087,1150,21,1171,0,1447,80.9260539
臺北市,文山區,萬美里,1216,561,35.39432177,1024,64.60567823,1585,29,1614,0,1980,81.51515152
高雄市,鹽埕區,藍橋里,1,692,66.53846154,348,33.46153846,1040,22,1062,0,1282,82.83931357
高雄市,鹽埕區,慈愛里,2,215,54.0201005,183,45.9798995,398,8,406,0,498,81.52610442
高雄市,鹽埕區,博愛里,3,394,67.58147513,189,32.41852487,583,17,600,0,736,81.52173913
高雄市,鹽埕區,壽星里,4,597,56.37393768,462,43.62606232,1059,27,1086,0,1341,80.98434004
高雄市,鹽埕區,中山里,5,564,58.68886576,397,41.31113424,961,14,975,0,1214,80.31301483
高雄市,鹽埕區,教仁里,6,1103,60.53787047,719,39.46212953,1822,21,1843,0,2245,82.0935412
高雄市,鹽埕區,新樂里,7,430,56.57894737,330,43.42105263,760,7,767,0,928,82.65086207
高雄市,鹽埕區,中原里,8,318,56.78571429,242,43.21428571,560,3,563,0,700,80.42857143
高雄市,鹽埕區,光明里,9,594,60,396,40,990,8,998,0,1248,79.96794872
高雄市,鹽埕區,育仁里,10,393,58.22222222,282,41.77777778,675,9,684,0,851,80.3760282
高雄市,鹽埕區,河濱里,11,847,57.26842461,632,42.73157539,1479,19,1498,0,1841,81.36882129
高雄市,鹽埕區,沙地里,12,568,65.13761468,304,34.86238532,872,12,884,0,1097,80.5834093
高雄市,鹽埕區,南端里,13,504,56.1247216,394,43.8752784,898,20,918,0,1128,81.38297872
高雄市,鹽埕區,港都里,14,539,58.84279476,377,41.15720524,916,22,938,0,1186,79.08937605
高雄市,鹽埕區,江西里,15,644,63.57354393,369,36.42645607,1013,10,1023,0,1238,82.63327948
高雄市,鹽埕區,新豐里,16,257,50.49115914,252,49.50884086,509,15,524,1,624,83.97435897
高雄市,鹽埕區,府北里,17,809,57.8270193,590,42.1729807,1399,25,1424,0,1807,78.80464859
高雄市,鹽埕區,陸橋里,18,568,56.29335976,441,43.70664024,1009,21,1030,0,1273,80.91123331
高雄市,鹽埕區,瀨南里,19,395,66.27516779,201,33.72483221,596,9,605,0,729,82.99039781
高雄市,鹽埕區,新化里,20,329,56.62650602,252,43.37349398,581,10,591,0,706,83.71104816
高雄市,鹽埕區,江南里,21,509,70.69444444,211,29.30555556,720,14,734,0,943,77.83669141
高雄市,鼓山區,鼓峰里,22,364,42.12962963,500,57.87037037,864,17,881,0,1080,81.57407407
高雄市,鼓山區,鼓峰里,23,347,41.40811456,491,58.59188544,838,10,848,0,1022,82.97455969
高雄市,鼓山區,雄峰里,24,190,23.86934673,606,76.13065327,796,15,811,1,993,81.67170191
高雄市,鼓山區,雄峰里,25,289,32.58173619,598,67.41826381,887,10,897,0,1100,81.54545455
高雄市,鼓山區,前峰里,26,769,55.84604212,608,44.15395788,1377,27,1404,1,1677,83.72093023
高雄市,鼓山區,前峰里,27,516,44.2159383,651,55.7840617,1167,20,1187,0,1401,84.72519629
高雄市,鼓山區,前峰里,28,274,26.37151107,765,73.62848893,1039,17,1056,0,1241,85.0926672
高雄市,鼓山區,光榮里,29,701,71.8974359,274,28.1025641,975,21,996,0,1192,83.55704698
高雄市,鼓山區,光榮里,30,714,65.26508227,380,34.73491773,1094,21,1115,0,1367,81.56547184
高雄市,鼓山區,光榮里,31,770,68.20194863,359,31.79805137,1129,12,1141,0,1353,84.33111604
高雄市,鼓山區,民族里,32,695,56.45816409,536,43.54183591,1231,17,1248,0,1488,83.87096774
高雄市,鼓山區,內惟里,33,706,70.88353414,290,29.11646586,996,21,1017,0,1206,84.32835821
高雄市,鼓山區,建國里,34,542,59.04139434,376,40.95860566,918,19,937,0,1093,85.7273559
高雄市,鼓山區,建國里,35,495,59.13978495,342,40.86021505,837,13,850,0,1016,83.66141732
高雄市,鼓山區,忠正里,36,679,59.04347826,471,40.95652174,1150,13,1163,0,1410,82.4822695
高雄市,鼓山區,忠正里,37,654,60.72423398,423,39.27576602,1077,10,1087,0,1345,80.81784387
高雄市,鼓山區,忠正里,38,543,51.71428571,507,48.28571429,1050,13,1063,0,1253,84.83639266
高雄市,鼓山區,自強里,39,37,5.189340813,676,94.81065919,713,13,726,0,851,85.31139835
高雄市,鼓山區,龍井里,40,696,57.90349418,506,42.09650582,1202,30,1232,1,1523,80.89297439
高雄市,鼓山區,正德里,41,1001,66.29139073,509,33.70860927,1510,21,1531,0,1856,82.48922414
高雄市,鼓山區,平和里,42,929,69.48391922,408,30.51608078,1337,26,1363,0,1639,83.1604637
高雄市,鼓山區,平和里,43,709,61.01549053,453,38.98450947,1162,23,1185,0,1392,85.12931034
高雄市,鼓山區,民強里,44,805,64.97175141,434,35.02824859,1239,32,1271,0,1472,86.3451087
高雄市,鼓山區,民強里,45,632,57.92850596,459,42.07149404,1091,28,1119,0,1372,81.55976676
高雄市,鼓山區,厚生里,46,1278,68.26923077,594,31.73076923,1872,35,1907,0,2279,83.67705134
高雄市,鼓山區,龍子里,47,786,57.58241758,579,42.41758242,1365,16,1381,0,1681,82.15348007
高雄市,鼓山區,龍子里,48,954,63.26259947,554,36.73740053,1508,25,1533,0,1844,83.13449024
高雄市,鼓山區,龍子里,49,598,44.8612153,735,55.1387847,1333,27,1360,0,1711,79.48568089
高雄市,鼓山區,龍水里,50,592,46.5408805,680,53.4591195,1272,12,1284,0,1579,81.31728942
高雄市,鼓山區,明誠里,51,831,53.68217054,717,46.31782946,1548,30,1578,0,1906,82.79118573
高雄市,鼓山區,明誠里,52,633,42.74139095,848,57.25860905,1481,31,1512,0,1798,84.09343715
高雄市,鼓山區,明誠里,53,607,38.36915297,975,61.63084703,1582,28,1610,0,1977,81.43651998
高雄市,鼓山區,明誠里,54,620,41.47157191,875,58.52842809,1495,19,1514,0,1850,81.83783784
高雄市,鼓山區,明誠里,55,483,43.78966455,620,56.21033545,1103,11,1114,0,1366,81.55197657
高雄市,鼓山區,明誠里,56,554,47.06881903,623,52.93118097,1177,14,1191,0,1445,82.42214533
高雄市,鼓山區,華豐里,57,585,39.05206943,913,60.94793057,1498,16,1514,0,1798,84.20467186
高雄市,鼓山區,華豐里,58,611,42.57839721,824,57.42160279,1435,19,1454,0,1757,82.7546955
高雄市,鼓山區,裕興里,59,463,39.33729822,714,60.66270178,1177,18,1195,0,1447,82.58465791
高雄市,鼓山區,裕興里,60,549,45.22240527,665,54.77759473,1214,25,1239,0,1489,83.21020819
高雄市,鼓山區,裕豐里,61,275,31.8287037,589,68.1712963,864,5,869,0,1033,84.12391094
高雄市,鼓山區,裕豐里,62,357,35,663,65,1020,14,1034,0,1265,81.73913043
高雄市,鼓山區,鼓岩里,63,782,65.99156118,403,34.00843882,1185,25,1210,0,1513,79.97356246
高雄市,鼓山區,樹德里,64,648,69.67741935,282,30.32258065,930,11,941,0,1149,81.897302
高雄市,鼓山區,寶樹里,65,538,63.89548694,304,36.10451306,842,3,845,0,1173,72.03751066
高雄市,鼓山區,興宗里,66,665,55.04966887,543,44.95033113,1208,17,1225,0,1503,81.50365935
高雄市,鼓山區,光化里,67,637,50.51546392,624,49.48453608,1261,9,1270,0,1562,81.30601793
高雄市,鼓山區,山下里,68,508,46.18181818,592,53.81818182,1100,26,1126,0,1408,79.97159091
高雄市,鼓山區,河邊里,69,747,59.23869944,514,40.76130056,1261,25,1286,0,1570,81.91082803
高雄市,鼓山區,綠川里,70,831,64.12037037,465,35.87962963,1296,40,1336,0,1615,82.7244582
高雄市,鼓山區,登山里,71,340,55.92105263,268,44.07894737,608,3,611,0,820,74.51219512
高雄市,鼓山區,峰南里,72,484,61.65605096,301,38.34394904,785,22,807,0,1037,77.82063645
高雄市,鼓山區,麗興里,73,556,62.12290503,339,37.87709497,895,29,924,0,1187,77.84330244
高雄市,鼓山區,新民里,74,606,68.16647919,283,31.83352081,889,20,909,0,1160,78.36206897
高雄市,鼓山區,延平里,75,497,67.71117166,237,32.28882834,734,9,743,0,923,80.49837486
高雄市,鼓山區,維生里,76,774,68.1938326,361,31.8061674,1135,15,1150,0,1463,78.60560492
高雄市,鼓山區,惠安里,77,757,67.77081468,360,32.22918532,1117,19,1136,0,1445,78.61591696
高雄市,鼓山區,壽山里,78,780,64.73029046,425,35.26970954,1205,34,1239,0,1586,78.12105927
高雄市,鼓山區,哨船頭里,79,522,56.12903226,408,43.87096774,930,16,946,0,1199,78.89908257
高雄市,鼓山區,桃源里,80,283,56.15079365,221,43.84920635,504,9,513,0,620,82.74193548
高雄市,旗津區,旗下里,81,622,65.26757608,331,34.73242392,953,34,987,0,1249,79.02321857
高雄市,旗津區,永安里,82,556,65.79881657,289,34.20118343,845,18,863,0,1102,78.31215971
高雄市,旗津區,振興里,83,864,65.40499621,457,34.59500379,1321,10,1331,0,1700,78.29411765
高雄市,旗津區,慈愛里,84,572,63.91061453,323,36.08938547,895,21,916,0,1126,81.34991119
高雄市,旗津區,慈愛里,85,480,65.93406593,248,34.06593407,728,11,739,0,978,75.56237219
高雄市,旗津區,復興里,86,691,61.91756272,425,38.08243728,1116,23,1139,0,1425,79.92982456
高雄市,旗津區,復興里,87,512,50.84409136,495,49.15590864,1007,30,1037,0,1347,76.98589458
高雄市,旗津區,中華里,88,709,68.83495146,321,31.16504854,1030,24,1054,0,1281,82.27946916
高雄市,旗津區,實踐里,89,313,31.11332008,693,68.88667992,1006,30,1036,0,1353,76.57058389
高雄市,旗津區,北汕里,90,637,65.4676259,336,34.5323741,973,19,992,0,1219,81.37817884
高雄市,旗津區,北汕里,91,591,61.69102296,367,38.30897704,958,14,972,0,1232,78.8961039
高雄市,旗津區,南汕里,92,958,72.03007519,372,27.96992481,1330,20,1350,0,1676,80.54892601
高雄市,旗津區,上竹里,93,536,79.0560472,142,20.9439528,678,10,688,0,869,79.17146145
高雄市,旗津區,上竹里,94,924,70.75038285,382,29.24961715,1306,32,1338,0,1699,78.75220718
高雄市,旗津區,中洲里,95,952,74.25897036,330,25.74102964,1282,25,1307,0,1623,80.52988293
高雄市,旗津區,安順里,96,567,75.29880478,186,24.70119522,753,18,771,0,955,80.73298429
高雄市,旗津區,中興里,97,661,74.94331066,221,25.05668934,882,17,899,0,1082,83.08687616
高雄市,旗津區,中興里,98,569,63.57541899,326,36.42458101,895,20,915,0,1113,82.21024259
高雄市,左營區,進學里,99,639,49.76635514,645,50.23364486,1284,22,1306,2,1889,69.13710958
高雄市,左營區,尾西里,100,671,68.19105691,313,31.80894309,984,20,1004,0,1198,83.80634391
高雄市,左營區,頂北里,101,311,63.599182,178,36.400818,489,10,499,0,602,82.89036545
高雄市,左營區,中北里,102,460,75.28641571,151,24.71358429,611,9,620,0,731,84.81532148
高雄市,左營區,中南里,103,367,80.48245614,89,19.51754386,456,12,468,0,569,82.24956063
高雄市,左營區,廟東里,104,593,77.11313394,176,22.88686606,769,16,785,0,923,85.04875406
高雄市,左營區,廟北里,105,665,76.87861272,200,23.12138728,865,20,885,0,1043,84.85139022
高雄市,左營區,尾南里,106,514,75.47723935,167,24.52276065,681,24,705,0,838,84.12887828
高雄市,左營區,尾北里,107,635,55.07372073,518,44.92627927,1153,32,1185,0,1417,83.62738179
高雄市,左營區,尾北里,108,840,65.42056075,444,34.57943925,1284,18,1302,0,1563,83.30134357
高雄市,左營區,屏山里,109,328,26.97368421,888,73.02631579,1216,29,1245,4,1496,83.22192513
高雄市,左營區,祥和里,110,36,7.5,444,92.5,480,13,493,0,598,82.44147157
高雄市,左營區,永清里,111,61,7.305389222,774,92.69461078,835,21,856,0,1043,82.07094919
高雄市,左營區,永清里,112,54,6.561360875,769,93.43863913,823,24,847,0,1058,80.05671078
高雄市,左營區,復興里,113,68,6.647116325,955,93.35288368,1023,22,1045,0,1265,82.60869565
高雄市,左營區,莒光里,114,440,31.13941967,973,68.86058033,1413,24,1437,0,1719,83.59511344
高雄市,左營區,光輝里,115,356,38.65363735,565,61.34636265,921,18,939,0,1124,83.54092527
高雄市,左營區,光輝里,116,475,42.90876242,632,57.09123758,1107,23,1130,0,1362,82.96622614
高雄市,左營區,合群里,117,43,3.866906475,1069,96.13309353,1112,14,1126,0,1357,82.97715549
高雄市,左營區,自治里,118,32,7.305936073,406,92.69406393,438,7,445,0,552,80.61594203
高雄市,左營區,自治里,119,23,4.554455446,482,95.44554455,505,16,521,0,641,81.27925117
高雄市,左營區,明建里,120,40,3.294892916,1174,96.70510708,1214,12,1226,0,1536,79.81770833
高雄市,左營區,自立里,121,4,9.302325581,39,90.69767442,43,0,43,0,71,60.56338028
高雄市,左營區,頂西里,122,721,72.9757085,267,27.0242915,988,20,1008,0,1171,86.08027327
高雄市,左營區,聖后里,123,599,76.69654289,182,23.30345711,781,13,794,0,950,83.57894737
高雄市,左營區,聖西里,124,226,72.43589744,86,27.56410256,312,10,322,0,382,84.29319372
高雄市,左營區,聖南里,125,321,67.72151899,153,32.27848101,474,7,481,0,587,81.94207836
高雄市,左營區,城南里,126,335,70.82452431,138,29.17547569,473,5,478,0,563,84.90230906
高雄市,左營區,路東里,127,446,68.19571865,208,31.80428135,654,9,663,0,791,83.81795196
高雄市,左營區,部北里,128,352,78.92376682,94,21.07623318,446,8,454,0,537,84.54376164
高雄市,左營區,部南里,129,385,61.50159744,241,38.49840256,626,16,642,0,766,83.81201044
高雄市,左營區,埤西里,130,537,58.43307943,382,41.56692057,919,12,931,0,1126,82.68206039
高雄市,左營區,埤北里,131,392,35.28352835,719,64.71647165,1111,32,1143,0,1428,80.04201681
高雄市,左營區,埤東里,132,511,52.35655738,465,47.64344262,976,19,995,0,1218,81.69129721
高雄市,左營區,海勝里,133,164,13.31168831,1068,86.68831169,1232,23,1255,0,1483,84.6257586
高雄市,左營區,海勝里,134,193,11.88423645,1431,88.11576355,1624,28,1652,0,1994,82.84854564
高雄市,左營區,海勝里,135,87,6.336489439,1286,93.66351056,1373,29,1402,0,1595,87.89968652
高雄市,左營區,自勉里,136,13,19.6969697,53,80.3030303,66,2,68,0,123,55.28455285
高雄市,左營區,崇實里,137,41,4.375667022,896,95.62433298,937,16,953,0,1138,83.74340949
高雄市,左營區,自助里,138,43,3.735881842,1108,96.26411816,1151,15,1166,0,1412,82.57790368
高雄市,左營區,自助里,139,112,14.79524439,645,85.20475561,757,27,784,0,964,81.32780083
高雄市,左營區,果貿里,140,69,9.187749667,682,90.81225033,751,14,765,0,907,84.34399118
高雄市,左營區,果貿里,141,76,8.951707892,773,91.04829211,849,18,867,0,1033,83.9303001
高雄市,左營區,果惠里,142,264,20.59282371,1018,79.40717629,1282,26,1308,0,1582,82.68015171
高雄市,左營區,果峰里,143,156,10.93969144,1270,89.06030856,1426,27,1453,0,1765,82.32294618
高雄市,左營區,新下里,144,529,44.12010008,670,55.87989992,1199,13,1212,0,1482,81.78137652
高雄市,左營區,新下里,145,703,43.39506173,917,56.60493827,1620,16,1636,0,1928,84.85477178
高雄市,左營區,新下里,146,698,53.44563553,608,46.55436447,1306,23,1329,0,1634,81.33414933
高雄市,左營區,新下里,147,633,46.10342316,740,53.89657684,1373,14,1387,0,1688,82.16824645
高雄市,左營區,新下里,148,609,42.14532872,836,57.85467128,1445,14,1459,0,1740,83.85057471
高雄市,左營區,新下里,149,693,61.70970614,430,38.29029386,1123,29,1152,0,1392,82.75862069
高雄市,左營區,新上里,150,598,56.79012346,455,43.20987654,1053,23,1076,0,1292,83.28173375
高雄市,左營區,新上里,151,822,69.25021061,365,30.74978939,1187,23,1210,0,1418,85.33145275
高雄市,左營區,新上里,152,746,63.16680779,435,36.83319221,1181,18,1199,0,1431,83.78756115
高雄市,左營區,新上里,153,809,52.77234181,724,47.22765819,1533,21,1554,0,1857,83.68336026
高雄市,左營區,新上里,154,770,48.67256637,812,51.32743363,1582,24,1606,0,1948,82.44353183
高雄市,左營區,新上里,155,683,44.29312581,859,55.70687419,1542,24,1566,0,1944,80.55555556
高雄市,左營區,新上里,156,743,46.93619709,840,53.06380291,1583,15,1598,0,1896,84.28270042
高雄市,左營區,新上里,157,601,46.7340591,685,53.2659409,1286,20,1306,0,1558,83.8254172
高雄市,左營區,新上里,158,732,47.13457824,821,52.86542176,1553,15,1568,0,1938,80.90815273
高雄市,左營區,新上里,159,851,53.52201258,739,46.47798742,1590,25,1615,0,1911,84.51072737
高雄市,左營區,新上里,160,728,52.48738284,659,47.51261716,1387,10,1397,0,1735,80.51873199
高雄市,左營區,新中里,161,1009,68.77982277,458,31.22017723,1467,24,1491,0,1764,84.52380952
高雄市,左營區,新中里,162,759,70.3429101,320,29.6570899,1079,22,1101,0,1289,85.41505043
高雄市,左營區,新中里,163,803,64.08619314,450,35.91380686,1253,19,1272,0,1530,83.1372549
高雄市,左營區,新光里,164,893,61.75656985,553,38.24343015,1446,21,1467,0,1726,84.99420626
高雄市,左營區,新光里,165,718,48.31763122,768,51.68236878,1486,26,1512,0,1891,79.95769434
高雄市,左營區,新光里,166,709,50.24805103,702,49.75194897,1411,23,1434,0,1716,83.56643357
高雄市,左營區,新光里,167,661,44.84396201,813,55.15603799,1474,14,1488,0,1755,84.78632479
高雄市,左營區,新光里,168,799,47.36218139,888,52.63781861,1687,16,1703,0,2026,84.05725568
高雄市,左營區,菜公里,169,775,45.99406528,910,54.00593472,1685,19,1704,0,2088,81.6091954
高雄市,左營區,菜公里,170,956,56.30153121,742,43.69846879,1698,27,1725,0,2098,82.22116301
高雄市,左營區,菜公里,171,847,51.61486898,794,48.38513102,1641,22,1663,0,1998,83.23323323
高雄市,左營區,菜公里,172,911,59.27130774,626,40.72869226,1537,22,1559,0,1853,84.13383702
高雄市,左營區,菜公里,173,812,50.27863777,803,49.72136223,1615,24,1639,0,2005,81.74563591
高雄市,左營區,菜公里,174,776,44.46991404,969,55.53008596,1745,17,1762,0,2159,81.61185734
高雄市,左營區,菜公里,175,861,48.86492622,901,51.13507378,1762,26,1788,0,2110,84.73933649
高雄市,左營區,菜公里,176,538,46.21993127,626,53.78006873,1164,17,1181,0,1439,82.07088256
高雄市,左營區,菜公里,177,640,45.68165596,761,54.31834404,1401,16,1417,0,1731,81.86019642
高雄市,左營區,福山里,178,481,42.3415493,655,57.6584507,1136,10,1146,0,1429,80.19594122
高雄市,左營區,福山里,179,548,44.55284553,682,55.44715447,1230,14,1244,0,1549,80.30987734
高雄市,左營區,福山里,180,771,55.07142857,629,44.92857143,1400,26,1426,0,1742,81.85993111
高雄市,左營區,福山里,181,610,43.82183908,782,56.17816092,1392,13,1405,0,1722,81.59117305
高雄市,左營區,福山里,182,737,53.17460317,649,46.82539683,1386,18,1404,0,1690,83.07692308
高雄市,左營區,福山里,183,659,46.11616515,770,53.88383485,1429,19,1448,0,1777,81.48564997
高雄市,左營區,福山里,184,569,44.69756481,704,55.30243519,1273,14,1287,0,1651,77.95275591
高雄市,左營區,福山里,185,572,43.96617986,729,56.03382014,1301,15,1316,0,1603,82.09606987
高雄市,左營區,福山里,186,514,49.23371648,530,50.76628352,1044,12,1056,0,1338,78.92376682
高雄市,左營區,福山里,187,837,52.70780856,751,47.29219144,1588,24,1612,0,1967,81.95221149
高雄市,左營區,福山里,188,465,42.38833181,632,57.61166819,1097,9,1106,0,1364,81.08504399
高雄市,左營區,福山里,189,397,36.12374886,702,63.87625114,1099,10,1109,0,1374,80.713246
高雄市,左營區,福山里,190,492,40.86378738,712,59.13621262,1204,12,1216,0,1464,83.06010929
高雄市,楠梓區,清豐里,191,923,68.26923077,429,31.73076923,1352,36,1388,0,1663,83.46361996
高雄市,楠梓區,清豐里,192,992,66.04527297,510,33.95472703,1502,28,1530,0,1860,82.25806452
高雄市,楠梓區,清豐里,193,945,58.55018587,669,41.44981413,1614,15,1629,0,1996,81.61322645
高雄市,楠梓區,清豐里,194,741,50.64935065,722,49.35064935,1463,17,1480,0,1801,82.17656857
高雄市,楠梓區,清豐里,195,769,53.58885017,666,46.41114983,1435,22,1457,0,1755,83.01994302
高雄市,楠梓區,東寧里,196,620,64.71816284,338,35.28183716,958,15,973,0,1181,82.38780694
高雄市,楠梓區,東寧里,197,392,43.55555556,508,56.44444444,900,12,912,0,1094,83.36380256
高雄市,楠梓區,五常里,198,756,69.54921803,331,30.45078197,1087,4,1091,0,1319,82.71417741
高雄市,楠梓區,五常里,199,698,58.36120401,498,41.63879599,1196,19,1215,0,1512,80.35714286
高雄市,楠梓區,五常里,200,699,59.94854202,467,40.05145798,1166,14,1180,0,1450,81.37931034
高雄市,楠梓區,享平里,201,760,69.40639269,335,30.59360731,1095,19,1114,0,1298,85.82434515
高雄市,楠梓區,享平里,202,601,51.45547945,567,48.54452055,1168,12,1180,0,1431,82.45981831
高雄市,楠梓區,中陽里,203,807,67.87216148,382,32.12783852,1189,18,1207,0,1447,83.41395992
高雄市,楠梓區,中陽里,204,694,67.90606654,328,32.09393346,1022,14,1036,0,1250,82.88
高雄市,楠梓區,惠楠里,205,571,65.1826484,305,34.8173516,876,14,890,0,1288,69.09937888
高雄市,楠梓區,惠楠里,206,481,47.29596853,536,52.70403147,1017,16,1033,0,1249,82.70616493
高雄市,楠梓區,惠民里,207,776,61.63621922,483,38.36378078,1259,32,1291,0,1582,81.60556258
高雄市,楠梓區,惠民里,208,784,57.18453683,587,42.81546317,1371,25,1396,0,1655,84.35045317
高雄市,楠梓區,惠豐里,209,520,54.62184874,432,45.37815126,952,17,969,0,1237,78.33468068
高雄市,楠梓區,惠豐里,210,636,47.92765637,691,52.07234363,1327,15,1342,0,1640,81.82926829
高雄市,楠梓區,錦屏里,211,1066,76.25178827,332,23.74821173,1398,19,1417,0,1659,85.41289934
高雄市,楠梓區,錦屏里,212,995,68.33791209,461,31.66208791,1456,11,1467,0,1749,83.87650086
高雄市,楠梓區,玉屏里,213,708,80.91428571,167,19.08571429,875,17,892,0,1065,83.75586854
高雄市,楠梓區,玉屏里,214,763,72.73593899,286,27.26406101,1049,15,1064,0,1238,85.9450727
高雄市,楠梓區,金田里,215,1061,76.66184971,323,23.33815029,1384,21,1405,0,1682,83.53151011
高雄市,楠梓區,金田里,216,943,73.3281493,343,26.6718507,1286,11,1297,0,1535,84.49511401
高雄市,楠梓區,稔田里,217,1053,77.76957164,301,22.23042836,1354,27,1381,0,1609,85.82970789
高雄市,楠梓區,瑞屏里,218,826,65.39984165,437,34.60015835,1263,11,1274,0,1565,81.4057508
高雄市,楠梓區,瑞屏里,219,712,54.98069498,583,45.01930502,1295,12,1307,1,1601,81.6364772
高雄市,楠梓區,翠屏里,220,489,38.77874703,772,61.22125297,1261,15,1276,0,1574,81.06734435
高雄市,楠梓區,翠屏里,221,451,33.3826795,900,66.6173205,1351,19,1370,0,1646,83.23207776
高雄市,楠梓區,翠屏里,222,523,42.4512987,709,57.5487013,1232,16,1248,0,1547,80.67226891
高雄市,楠梓區,翠屏里,223,504,41.86046512,700,58.13953488,1204,25,1229,0,1539,79.85705003
高雄市,楠梓區,翠屏里,224,406,36.54365437,705,63.45634563,1111,19,1130,0,1424,79.35393258
高雄市,楠梓區,翠屏里,225,532,41.40077821,753,58.59922179,1285,14,1299,0,1587,81.85255198
高雄市,楠梓區,翠屏里,226,663,45.72413793,787,54.27586207,1450,17,1467,0,1797,81.6360601
高雄市,楠梓區,宏南里,227,485,34.86700216,906,65.13299784,1391,13,1404,0,1706,82.29777257
高雄市,楠梓區,宏毅里,228,736,59.74025974,496,40.25974026,1232,11,1243,0,1470,84.55782313
高雄市,楠梓區,宏毅里,229,721,59.39044481,493,40.60955519,1214,11,1225,0,1426,85.90462833
高雄市,楠梓區,宏榮里,230,616,57.19591458,461,42.80408542,1077,20,1097,0,1263,86.85669042
高雄市,楠梓區,宏榮里,231,125,18.2748538,559,81.7251462,684,31,715,0,841,85.01783591
高雄市,楠梓區,廣昌里,232,719,61.76975945,445,38.23024055,1164,30,1194,0,1383,86.3340564
高雄市,楠梓區,廣昌里,233,549,40.27879677,814,59.72120323,1363,28,1391,0,1660,83.79518072
高雄市,楠梓區,久昌里,234,405,47.09302326,455,52.90697674,860,17,877,0,1074,81.65735568
高雄市,楠梓區,久昌里,235,443,46.82875264,503,53.17124736,946,17,963,0,1189,80.99243061
高雄市,楠梓區,大昌里,236,388,46.74698795,442,53.25301205,830,17,847,0,1011,83.77843719
高雄市,楠梓區,大昌里,237,272,32.61390887,562,67.38609113,834,18,852,0,1032,82.55813953
高雄市,楠梓區,福昌里,238,466,61.23521682,295,38.76478318,761,12,773,1,898,86.08017817
高雄市,楠梓區,福昌里,239,422,56.04249668,331,43.95750332,753,13,766,0,919,83.35146899
高雄市,楠梓區,盛昌里,240,841,49.29660023,865,50.70339977,1706,18,1724,0,2052,84.01559454
高雄市,楠梓區,盛昌里,241,707,42.9787234,938,57.0212766,1645,19,1664,0,1988,83.70221328
高雄市,楠梓區,泰昌里,242,682,52.90923196,607,47.09076804,1289,30,1319,0,1571,83.95926162
高雄市,楠梓區,興昌里,243,657,60.94619666,421,39.05380334,1078,19,1097,0,1301,84.31975404
高雄市,楠梓區,興昌里,244,725,50.84151473,701,49.15848527,1426,18,1444,0,1748,82.60869565
高雄市,楠梓區,建昌里,245,472,48.71001032,497,51.28998968,969,18,987,0,1196,82.52508361
高雄市,楠梓區,建昌里,246,474,48.7654321,498,51.2345679,972,16,988,0,1176,84.01360544
高雄市,楠梓區,宏昌里,247,394,41.78154825,549,58.21845175,943,8,951,0,1143,83.20209974
高雄市,楠梓區,宏昌里,248,453,45.07462687,552,54.92537313,1005,13,1018,0,1222,83.30605565
高雄市,楠梓區,和昌里,249,443,51.21387283,422,48.78612717,865,11,876,0,1039,84.31183831
高雄市,楠梓區,和昌里,250,408,44.15584416,516,55.84415584,924,19,943,0,1090,86.51376147
高雄市,楠梓區,慶昌里,251,527,38.49525201,842,61.50474799,1369,21,1390,0,1603,86.71241422
高雄市,楠梓區,慶昌里,252,689,57.27348296,514,42.72651704,1203,25,1228,0,1458,84.22496571
高雄市,楠梓區,隆昌里,253,628,45.70596798,746,54.29403202,1374,32,1406,0,1666,84.3937575
高雄市,楠梓區,隆昌里,254,611,46.71253823,697,53.28746177,1308,12,1320,0,1597,82.65497808
高雄市,楠梓區,秀昌里,255,404,51.01010101,388,48.98989899,792,24,816,0,1010,80.79207921
高雄市,楠梓區,秀昌里,256,372,44.49760766,464,55.50239234,836,22,858,0,1014,84.61538462
高雄市,楠梓區,裕昌里,257,763,64.44256757,421,35.55743243,1184,20,1204,0,1400,86
高雄市,楠梓區,裕昌里,258,608,53.85296723,521,46.14703277,1129,17,1146,0,1352,84.76331361
高雄市,楠梓區,國昌里,259,663,50.61068702,647,49.38931298,1310,22,1332,0,1556,85.60411311
高雄市,楠梓區,國昌里,260,666,51.66795966,623,48.33204034,1289,15,1304,0,1580,82.53164557
高雄市,楠梓區,加昌里,261,400,38.647343,635,61.352657,1035,16,1051,0,1317,79.80258162
高雄市,楠梓區,加昌里,262,518,42.80991736,692,57.19008264,1210,9,1219,0,1474,82.70013569
高雄市,楠梓區,加昌里,263,502,41.5907208,705,58.4092792,1207,15,1222,0,1447,84.45058742
高雄市,楠梓區,加昌里,264,464,34.65272591,875,65.34727409,1339,17,1356,0,1607,84.38083385
高雄市,楠梓區,仁昌里,265,558,40.0862069,834,59.9137931,1392,12,1404,0,1718,81.72293364
高雄市,楠梓區,仁昌里,266,572,40.76977904,831,59.23022096,1403,27,1430,0,1771,80.74534161
高雄市,楠梓區,藍田里,267,451,59.26412615,310,40.73587385,761,27,788,0,919,85.74537541
高雄市,楠梓區,中興里,268,526,72.45179063,200,27.54820937,726,7,733,0,859,85.33178114
高雄市,楠梓區,中和里,269,964,75.37138389,315,24.62861611,1279,21,1300,0,1520,85.52631579
高雄市,三民區,鼎金里,270,658,57.36704446,489,42.63295554,1147,35,1182,0,1495,79.06354515
高雄市,三民區,鼎金里,271,846,65.02690238,455,34.97309762,1301,26,1327,0,1613,82.26906386
高雄市,三民區,鼎盛里,272,625,56.45889792,482,43.54110208,1107,11,1118,0,1363,82.02494497
高雄市,三民區,鼎盛里,273,556,54.72440945,460,45.27559055,1016,24,1040,0,1264,82.27848101
高雄市,三民區,鼎盛里,274,708,57.42092457,525,42.57907543,1233,26,1259,0,1526,82.50327654
高雄市,三民區,鼎盛里,275,755,56.89525245,572,43.10474755,1327,10,1337,0,1640,81.52439024
高雄市,三民區,鼎強里,276,908,65.41786744,480,34.58213256,1388,15,1403,0,1656,84.72222222
高雄市,三民區,鼎強里,277,845,59.00837989,587,40.99162011,1432,30,1462,0,1796,81.40311804
高雄市,三民區,鼎力里,278,790,61.14551084,502,38.85448916,1292,21,1313,0,1604,81.85785536
高雄市,三民區,鼎力里,279,874,60.35911602,574,39.64088398,1448,23,1471,0,1800,81.72222222
高雄市,三民區,鼎西里,280,928,58.95806861,646,41.04193139,1574,28,1602,0,1968,81.40243902
高雄市,三民區,鼎西里,281,901,62.48266297,541,37.51733703,1442,26,1468,0,1764,83.21995465
高雄市,三民區,鼎西里,282,834,62.23880597,506,37.76119403,1340,41,1381,0,1699,81.28310771
高雄市,三民區,鼎中里,283,879,65.40178571,465,34.59821429,1344,17,1361,0,1565,86.96485623
高雄市,三民區,鼎中里,284,817,61.24437781,517,38.75562219,1334,23,1357,0,1556,87.21079692
高雄市,三民區,鼎泰里,285,849,60.38406828,557,39.61593172,1406,29,1435,0,1741,82.42389431
高雄市,三民區,鼎泰里,286,674,52.57410296,608,47.42589704,1282,22,1304,0,1612,80.89330025
高雄市,三民區,鼎泰里,287,962,64.95611074,519,35.04388926,1481,16,1497,0,1766,84.76783692
高雄市,三民區,鼎泰里,288,792,61.20556414,502,38.79443586,1294,22,1316,0,1638,80.34188034
高雄市,三民區,鼎泰里,289,717,43.77289377,921,56.22710623,1638,12,1650,0,1987,83.03975843
高雄市,三民區,鼎泰里,290,646,42.58404746,871,57.41595254,1517,14,1531,0,1837,83.3424061
高雄市,三民區,鼎泰里,291,603,41.84594032,838,58.15405968,1441,13,1454,0,1769,82.19332956
高雄市,三民區,鼎泰里,292,398,40.57084608,583,59.42915392,981,3,984,0,1177,83.60237893
高雄市,三民區,鼎泰里,293,467,40.67944251,681,59.32055749,1148,11,1159,0,1393,83.2017229
高雄市,三民區,鼎泰里,294,533,42.53790902,720,57.46209098,1253,23,1276,0,1497,85.23714095
高雄市,三民區,本館里,295,919,60.22280472,607,39.77719528,1526,32,1558,0,1916,81.31524008
高雄市,三民區,本館里,296,974,65.15050167,521,34.84949833,1495,28,1523,0,1828,83.31509847
高雄市,三民區,本館里,297,834,57.35900963,620,42.64099037,1454,26,1480,0,1790,82.68156425
高雄市,三民區,本館里,298,846,53.47661188,736,46.52338812,1582,21,1603,0,1920,83.48958333
高雄市,三民區,本和里,299,841,55.73227303,668,44.26772697,1509,20,1529,0,1850,82.64864865
高雄市,三民區,本和里,300,909,57.86123488,662,42.13876512,1571,17,1588,0,1919,82.75143304
高雄市,三民區,本和里,301,905,53.77302436,778,46.22697564,1683,23,1706,0,2089,81.66586884
高雄市,三民區,本文里,302,498,55.82959641,394,44.17040359,892,14,906,0,1098,82.5136612
高雄市,三民區,本文里,303,484,60.88050314,311,39.11949686,795,15,810,0,938,86.35394456
高雄市,三民區,本武里,304,825,66.31832797,419,33.68167203,1244,20,1264,0,1498,84.37917223
高雄市,三民區,本元里,305,652,53.79537954,560,46.20462046,1212,24,1236,0,1484,83.2884097
高雄市,三民區,本元里,306,699,60.62445794,454,39.37554206,1153,14,1167,0,1435,81.32404181
高雄市,三民區,本元里,307,643,54.17017692,544,45.82982308,1187,17,1204,0,1461,82.40930869
高雄市,三民區,本安里,308,527,53.50253807,458,46.49746193,985,13,998,0,1199,83.23603003
高雄市,三民區,本安里,309,561,51.80055402,522,48.19944598,1083,9,1092,0,1275,85.64705882
高雄市,三民區,本安里,310,581,53.64727608,502,46.35272392,1083,23,1106,0,1302,84.94623656
高雄市,三民區,本上里,311,602,51.71821306,562,48.28178694,1164,19,1183,0,1375,86.03636364
高雄市,三民區,本上里,312,511,47.84644195,557,52.15355805,1068,13,1081,0,1293,83.60402166
高雄市,三民區,本上里,313,564,47.95918367,612,52.04081633,1176,15,1191,0,1429,83.3449965
高雄市,三民區,本揚里,314,743,54.79351032,613,45.20648968,1356,16,1372,0,1620,84.69135802
高雄市,三民區,本揚里,315,688,51.30499627,653,48.69500373,1341,17,1358,0,1617,83.98268398
高雄市,三民區,本揚里,316,806,56.96113074,609,43.03886926,1415,14,1429,0,1692,84.45626478
高雄市,三民區,本揚里,317,641,51.86084142,595,48.13915858,1236,19,1255,0,1556,80.65552699
高雄市,三民區,寶獅里,318,798,55.33980583,644,44.66019417,1442,23,1465,0,1797,81.52476349
高雄市,三民區,寶獅里,319,771,57.53731343,569,42.46268657,1340,19,1359,0,1659,81.91681736
高雄市,三民區,寶德里,320,590,53.20108206,519,46.79891794,1109,7,1116,0,1339,83.34578043
高雄市,三民區,寶德里,321,751,59.69793323,507,40.30206677,1258,13,1271,1,1587,80.08821676
高雄市,三民區,寶德里,322,808,63.67218282,461,36.32781718,1269,13,1282,0,1558,82.28498074
高雄市,三民區,寶泰里,323,716,57.78853914,523,42.21146086,1239,15,1254,0,1527,82.12180747
高雄市,三民區,寶泰里,324,660,53.14009662,582,46.85990338,1242,20,1262,0,1580,79.87341772
高雄市,三民區,寶興里,325,677,60.99099099,433,39.00900901,1110,12,1122,0,1332,84.23423423
高雄市,三民區,寶興里,326,665,63.39370829,384,36.60629171,1049,24,1073,0,1299,82.60200154
高雄市,三民區,寶興里,327,560,53.7428023,482,46.2571977,1042,15,1057,0,1258,84.02225755
高雄市,三民區,寶興里,328,602,58.05207329,435,41.94792671,1037,17,1054,0,1320,79.84848485
高雄市,三民區,寶中里,329,614,58.08893094,443,41.91106906,1057,19,1076,0,1291,83.34624322
高雄市,三民區,寶中里,330,738,64.6234676,404,35.3765324,1142,12,1154,0,1375,83.92727273
高雄市,三民區,寶華里,331,518,46.4573991,597,53.5426009,1115,5,1120,0,1347,83.14773571
高雄市,三民區,寶華里,332,621,52.89608177,553,47.10391823,1174,14,1188,0,1434,82.84518828
高雄市,三民區,寶國里,333,759,57.89473684,552,42.10526316,1311,23,1334,0,1662,80.26474128
高雄市,三民區,寶國里,334,705,58.16831683,507,41.83168317,1212,20,1232,0,1504,81.91489362
高雄市,三民區,寶國里,335,835,58.8028169,585,41.1971831,1420,20,1440,0,1708,84.30913349
高雄市,三民區,寶國里,336,620,48.89589905,648,51.10410095,1268,17,1285,0,1478,86.94181326
高雄市,三民區,寶民里,337,587,56.06494747,460,43.93505253,1047,21,1068,0,1298,82.28043143
高雄市,三民區,寶民里,338,569,53.27715356,499,46.72284644,1068,17,1085,0,1317,82.38420653
高雄市,三民區,寶慶里,339,503,52.28690229,459,47.71309771,962,20,982,0,1212,81.02310231
高雄市,三民區,寶慶里,340,545,57.67195767,400,42.32804233,945,16,961,0,1227,78.32110839
高雄市,三民區,寶業里,341,662,55.4438861,532,44.5561139,1194,17,1211,0,1449,83.57487923
高雄市,三民區,寶業里,342,602,54.52898551,502,45.47101449,1104,18,1122,0,1374,81.65938865
高雄市,三民區,寶業里,343,615,56.01092896,483,43.98907104,1098,16,1114,0,1365,81.61172161
高雄市,三民區,寶盛里,344,566,54.37079731,475,45.62920269,1041,13,1054,0,1288,81.83229814
高雄市,三民區,寶盛里,345,569,56.67330677,435,43.32669323,1004,17,1021,0,1230,83.00813008
高雄市,三民區,寶盛里,346,601,50.20885547,596,49.79114453,1197,7,1204,0,1455,82.74914089
高雄市,三民區,寶安里,347,920,57.5,680,42.5,1600,23,1623,0,1969,82.42762824
高雄市,三民區,寶安里,348,859,52.09217708,790,47.90782292,1649,16,1665,0,2060,80.82524272
高雄市,三民區,寶安里,349,766,51.54777927,720,48.45222073,1486,22,1508,0,1921,78.50078084
高雄市,三民區,寶龍里,350,707,64.4484959,390,35.5515041,1097,29,1126,0,1382,81.47612156
高雄市,三民區,寶龍里,351,599,60.20100503,396,39.79899497,995,16,1011,0,1202,84.10981697
高雄市,三民區,寶龍里,352,538,48.82032668,564,51.17967332,1102,21,1123,0,1363,82.39178283
高雄市,三民區,寶珠里,353,693,54.48113208,579,45.51886792,1272,15,1287,0,1906,67.52360965
高雄市,三民區,寶珠里,354,739,60.72308956,478,39.27691044,1217,19,1236,0,1511,81.80013236
高雄市,三民區,寶珠里,355,714,59.30232558,490,40.69767442,1204,16,1220,0,1476,82.65582656
高雄市,三民區,寶玉里,356,786,55.86353945,621,44.13646055,1407,26,1433,0,1745,82.12034384
高雄市,三民區,寶玉里,357,782,53.81968341,671,46.18031659,1453,23,1476,0,1757,84.00682982
高雄市,三民區,寶玉里,358,677,50.37202381,667,49.62797619,1344,15,1359,0,1688,80.50947867
高雄市,三民區,寶玉里,359,741,53.50180505,644,46.49819495,1385,29,1414,0,1738,81.35788262
高雄市,三民區,灣子里,360,741,56.5648855,569,43.4351145,1310,17,1327,0,1660,79.93975904
高雄市,三民區,灣子里,361,699,63.54545455,401,36.45454545,1100,19,1119,0,1408,79.47443182
高雄市,三民區,灣愛里,362,770,68.50533808,354,31.49466192,1124,28,1152,0,1452,79.33884298
高雄市,三民區,灣愛里,363,688,61.75942549,426,38.24057451,1114,26,1140,0,1452,78.51239669
高雄市,三民區,灣中里,364,722,64.81149013,392,35.18850987,1114,19,1133,0,1422,79.67651195
高雄市,三民區,灣中里,365,597,61.60990712,372,38.39009288,969,14,983,0,1224,80.31045752
高雄市,三民區,灣中里,366,683,60.17621145,452,39.82378855,1135,19,1154,0,1399,82.48749107
高雄市,三民區,灣華里,367,634,57.22021661,474,42.77978339,1108,10,1118,0,1372,81.48688047
高雄市,三民區,灣華里,368,655,63.71595331,373,36.28404669,1028,30,1058,0,1263,83.76880443
高雄市,三民區,灣勝里,369,515,64.13449564,288,35.86550436,803,18,821,0,981,83.69011213
高雄市,三民區,灣勝里,370,570,67.13780919,279,32.86219081,849,8,857,0,1045,82.00956938
高雄市,三民區,灣利里,371,859,62.06647399,525,37.93352601,1384,22,1406,0,1703,82.5601879
高雄市,三民區,灣利里,372,878,69.79332273,380,30.20667727,1258,23,1281,0,1537,83.34417697
高雄市,三民區,灣復里,373,765,65.83476764,397,34.16523236,1162,22,1184,0,1438,82.33657858
高雄市,三民區,灣復里,374,648,55.86206897,512,44.13793103,1160,17,1177,0,1513,77.7924653
高雄市,三民區,正興里,375,812,51.06918239,778,48.93081761,1590,15,1605,0,1986,80.81570997
高雄市,三民區,正興里,376,898,60.8401084,578,39.1598916,1476,16,1492,0,1829,81.57463095
高雄市,三民區,正興里,377,754,54.05017921,641,45.94982079,1395,13,1408,0,1713,82.19497957
高雄市,三民區,正興里,378,529,41.00775194,761,58.99224806,1290,10,1300,0,1580,82.27848101
高雄市,三民區,正興里,379,664,49.36802974,681,50.63197026,1345,18,1363,0,1668,81.7146283
高雄市,三民區,正順里,380,754,60.90468498,484,39.09531502,1238,27,1265,0,1570,80.57324841
高雄市,三民區,正順里,381,851,60.61253561,553,39.38746439,1404,16,1420,0,1719,82.60616638
高雄市,三民區,灣興里,382,831,65.5362776,437,34.4637224,1268,21,1289,0,1559,82.6812059
高雄市,三民區,灣成里,383,994,61.43386897,624,38.56613103,1618,25,1643,0,2007,81.86347783
高雄市,三民區,安康里,384,745,65.35087719,395,34.64912281,1140,15,1155,0,1474,78.35820896
高雄市,三民區,安康里,385,748,63.49745331,430,36.50254669,1178,19,1197,0,1504,79.58776596
高雄市,三民區,安寧里,386,511,66.10608021,262,33.89391979,773,11,784,0,995,78.79396985
高雄市,三民區,安寧里,387,519,62.83292978,307,37.16707022,826,23,849,0,1049,80.93422307
高雄市,三民區,安吉里,388,560,54.05405405,476,45.94594595,1036,10,1046,0,1356,77.13864307
高雄市,三民區,安吉里,389,608,58.23754789,436,41.76245211,1044,22,1066,0,1314,81.12633181
高雄市,三民區,安吉里,390,743,58.13771518,535,41.86228482,1278,15,1293,0,1569,82.40917782
高雄市,三民區,安發里,391,591,53.05206463,523,46.94793537,1114,19,1133,0,1372,82.58017493
高雄市,三民區,安發里,392,607,54.58633094,505,45.41366906,1112,22,1134,0,1366,83.01610542
高雄市,三民區,安發里,393,595,53.125,525,46.875,1120,19,1139,0,1408,80.89488636
高雄市,三民區,安東里,394,788,61.90102121,485,38.09897879,1273,17,1290,0,1559,82.74534958
高雄市,三民區,安東里,395,781,60.49573974,510,39.50426026,1291,21,1312,0,1608,81.5920398
高雄市,三民區,安和里,396,718,66.72862454,358,33.27137546,1076,19,1095,0,1312,83.46036585
高雄市,三民區,安和里,397,755,66.57848325,379,33.42151675,1134,21,1155,0,1378,83.81712627
高雄市,三民區,達德里,398,790,64.1754671,441,35.8245329,1231,21,1252,0,1472,85.05434783
高雄市,三民區,達明里,399,894,63.26963907,519,36.73036093,1413,12,1425,0,1696,84.02122642
高雄市,三民區,達仁里,400,700,58.67560771,493,41.32439229,1193,13,1206,0,1467,82.20858896
高雄市,三民區,達勇里,401,506,59.52941176,344,40.47058824,850,16,866,0,1073,80.7082945
高雄市,三民區,同德里,402,728,61.48648649,456,38.51351351,1184,14,1198,0,1433,83.6008374
高雄市,三民區,同德里,403,652,60.70763501,422,39.29236499,1074,15,1089,0,1322,82.37518911
高雄市,三民區,德智里,404,598,60.89613035,384,39.10386965,982,13,995,0,1193,83.40318525
高雄市,三民區,德智里,405,645,62.86549708,381,37.13450292,1026,12,1038,0,1255,82.70916335
高雄市,三民區,德仁里,406,427,56.25823452,332,43.74176548,759,9,768,0,949,80.92729189
高雄市,三民區,德仁里,407,444,56.27376426,345,43.72623574,789,15,804,0,1005,80
高雄市,三民區,安生里,408,904,64.84935438,490,35.15064562,1394,34,1428,0,1686,84.6975089
高雄市,三民區,德東里,409,460,63.36088154,266,36.63911846,726,12,738,0,876,84.24657534
高雄市,三民區,德行里,410,589,65.66332219,308,34.33667781,897,10,907,0,1106,82.00723327
高雄市,三民區,精華里,411,770,58.59969559,544,41.40030441,1314,31,1345,0,1618,83.12731768
高雄市,三民區,民享里,412,558,66.34958383,283,33.65041617,841,18,859,0,1016,84.54724409
高雄市,三民區,民享里,413,571,66.6277713,286,33.3722287,857,9,866,0,1047,82.71251194
高雄市,三民區,安宜里,414,876,66.01356443,451,33.98643557,1327,24,1351,0,1606,84.12204234
高雄市,三民區,安宜里,415,849,64.0754717,476,35.9245283,1325,29,1354,0,1606,84.30884184
高雄市,三民區,安泰里,416,616,61.35458167,388,38.64541833,1004,23,1027,0,1206,85.15754561
高雄市,三民區,安泰里,417,649,64.44885799,358,35.55114201,1007,14,1021,0,1263,80.83927158
高雄市,三民區,安泰里,418,707,59.31208054,485,40.68791946,1192,13,1205,0,1516,79.48548813
高雄市,三民區,安邦里,419,541,62.83391405,320,37.16608595,861,10,871,0,1435,60.69686411
高雄市,三民區,安邦里,420,688,64.35921422,381,35.64078578,1069,16,1085,0,1299,83.52578907
高雄市,三民區,安邦里,421,580,58.82352941,406,41.17647059,986,21,1007,0,1198,84.05676127
高雄市,三民區,十全里,422,831,63.92307692,469,36.07692308,1300,13,1313,0,1582,82.99620733
高雄市,三民區,十美里,423,473,64.44141689,261,35.55858311,734,8,742,0,903,82.17054264
高雄市,三民區,十美里,424,462,63.02864939,271,36.97135061,733,13,746,0,908,82.15859031
高雄市,三民區,德北里,425,455,60.34482759,299,39.65517241,754,12,766,0,952,80.46218487
高雄市,三民區,德北里,426,571,65.33180778,303,34.66819222,874,17,891,0,1106,80.56057866
高雄市,三民區,立誠里,427,480,63.49206349,276,36.50793651,756,14,770,0,942,81.74097665
高雄市,三民區,立業里,428,602,64.94066882,325,35.05933118,927,10,937,0,1118,83.81037567
高雄市,三民區,港東里,429,716,64.33063792,397,35.66936208,1113,16,1129,0,1433,78.78576413
高雄市,三民區,港新里,430,659,56.85936152,500,43.14063848,1159,12,1171,0,1451,80.70296347
高雄市,三民區,港西里,431,408,61.26126126,258,38.73873874,666,13,679,0,837,81.12305854
高雄市,三民區,港北里,432,188,53.10734463,166,46.89265537,354,4,358,0,437,81.9221968
高雄市,三民區,博愛里,433,514,58.47554039,365,41.52445961,879,18,897,0,1166,76.9296741
高雄市,三民區,博惠里,434,590,53.44202899,514,46.55797101,1104,19,1123,0,1327,84.62697815
高雄市,三民區,博惠里,435,686,62.53418414,411,37.46581586,1097,16,1113,0,1385,80.36101083
高雄市,三民區,博惠里,436,554,52.56166983,500,47.43833017,1054,13,1067,0,1309,81.51260504
高雄市,三民區,長明里,437,515,55.37634409,415,44.62365591,930,14,944,0,1154,81.80242634
高雄市,三民區,建東里,438,486,59.34065934,333,40.65934066,819,9,828,0,1131,73.20954907
高雄市,三民區,興德里,439,805,60.25449102,531,39.74550898,1336,18,1354,0,1685,80.35608309
高雄市,三民區,鳳南里,440,658,69.26315789,292,30.73684211,950,8,958,0,1132,84.62897527
高雄市,三民區,鳳北里,441,557,69.36488169,246,30.63511831,803,8,811,0,960,84.47916667
高雄市,三民區,鳳北里,442,474,63.03191489,278,36.96808511,752,14,766,0,945,81.05820106
高雄市,三民區,德西里,443,622,62.82828283,368,37.17171717,990,14,1004,0,1237,81.16410671
高雄市,三民區,九如里,444,52,14.68926554,302,85.31073446,354,13,367,0,454,80.83700441
高雄市,三民區,豐裕里,445,647,55.06382979,528,44.93617021,1175,22,1197,0,1433,83.53105373
高雄市,三民區,豐裕里,446,657,66.22983871,335,33.77016129,992,17,1009,0,1256,80.3343949
高雄市,三民區,川東里,447,482,62.92428198,284,37.07571802,766,13,779,0,952,81.82773109
高雄市,三民區,川東里,448,509,68.04812834,239,31.95187166,748,10,758,0,955,79.37172775
高雄市,三民區,裕民里,449,365,62.28668942,221,37.71331058,586,22,608,0,733,82.946794
高雄市,三民區,力行里,450,575,58.97435897,400,41.02564103,975,11,986,0,1166,84.5626072
高雄市,三民區,千歲里,451,565,57.77096115,413,42.22903885,978,19,997,0,1193,83.57082984
高雄市,三民區,立德里,452,607,55.43378995,488,44.56621005,1095,16,1111,0,1351,82.2353812
高雄市,三民區,千北里,453,664,64.03085824,373,35.96914176,1037,24,1061,0,1287,82.43978244
高雄市,三民區,千秋里,454,623,63.63636364,356,36.36363636,979,17,996,0,1237,80.51738076
高雄市,三民區,千秋里,455,561,58.4375,399,41.5625,960,13,973,0,1180,82.45762712
高雄市,新興區,浩然里,456,414,47.5315729,457,52.4684271,871,14,885,0,1089,81.26721763
高雄市,新興區,浩然里,457,373,50.95628415,359,49.04371585,732,11,743,0,888,83.67117117
高雄市,新興區,振成里,458,522,54.43169969,437,45.56830031,959,10,969,0,1257,77.08830549
高雄市,新興區,德生里,459,624,50.44462409,613,49.55537591,1237,15,1252,0,1549,80.82633957
高雄市,新興區,德生里,460,368,51.54061625,346,48.45938375,714,16,730,0,899,81.20133482
高雄市,新興區,振華里,461,495,48.52941176,525,51.47058824,1020,18,1038,0,1302,79.7235023
高雄市,新興區,正氣里,462,742,55.37313433,598,44.62686567,1340,18,1358,0,1626,83.51783518
高雄市,新興區,德政里,463,282,48.28767123,302,51.71232877,584,10,594,0,742,80.05390836
高雄市,新興區,仁聲里,464,355,57.4433657,263,42.5566343,618,7,625,0,827,75.57436518
高雄市,新興區,德望里,465,421,53.35868188,368,46.64131812,789,8,797,0,1005,79.30348259
高雄市,新興區,德望里,466,417,50.79171742,404,49.20828258,821,14,835,0,1051,79.44814462
高雄市,新興區,華聲里,467,468,56.38554217,362,43.61445783,830,11,841,0,1066,78.89305816
高雄市,新興區,蕉園里,468,387,60.18662519,256,39.81337481,643,10,653,0,792,82.44949495
高雄市,新興區,永寧里,469,652,57.19298246,488,42.80701754,1140,29,1169,0,1452,80.50964187
高雄市,新興區,玉衡里,470,486,57.78834721,355,42.21165279,841,20,861,0,1090,78.99082569
高雄市,新興區,順昌里,471,620,66.02768903,319,33.97231097,939,19,958,0,1167,82.09083119
高雄市,新興區,順昌里,472,423,55.078125,345,44.921875,768,12,780,0,943,82.71474019
高雄市,新興區,文昌里,473,618,51.9764508,571,48.0235492,1189,10,1199,0,1465,81.84300341
高雄市,新興區,文昌里,474,498,52.42105263,452,47.57894737,950,14,964,0,1144,84.26573427
高雄市,新興區,光耀里,475,538,55.75129534,427,44.24870466,965,9,974,1,1210,80.49586777
高雄市,新興區,光耀里,476,487,50,487,50,974,17,991,0,1206,82.17247098
高雄市,新興區,興昌里,477,391,54.45682451,327,45.54317549,718,6,724,0,859,84.28405122
高雄市,新興區,興昌里,478,411,51.69811321,384,48.30188679,795,14,809,0,951,85.06834911
高雄市,新興區,開平里,479,658,54.24567189,555,45.75432811,1213,11,1224,0,1490,82.14765101
高雄市,新興區,開平里,480,707,55.53809898,566,44.46190102,1273,14,1287,0,1530,84.11764706
高雄市,新興區,成功里,481,471,49.16492693,487,50.83507307,958,9,967,0,1185,81.60337553
高雄市,新興區,新江里,482,579,65.49773756,305,34.50226244,884,15,899,0,1156,77.76816609
高雄市,新興區,黎明里,483,426,59.16666667,294,40.83333333,720,26,746,0,946,78.85835095
高雄市,新興區,愛平里,484,445,60.54421769,290,39.45578231,735,10,745,0,905,82.32044199
高雄市,新興區,南港里,485,570,64.47963801,314,35.52036199,884,17,901,0,1104,81.61231884
高雄市,新興區,南港里,486,548,57.44234801,406,42.55765199,954,15,969,0,1182,81.97969543
高雄市,新興區,中東里,487,434,49.37428896,445,50.62571104,879,17,896,0,1229,72.90480065
高雄市,新興區,中東里,488,555,48.59894921,587,51.40105079,1142,16,1158,0,1464,79.09836066
高雄市,新興區,明莊里,489,409,61.04477612,261,38.95522388,670,10,680,0,853,79.71864009
高雄市,新興區,大明里,490,579,63.00326442,340,36.99673558,919,24,943,0,1207,78.12758906
高雄市,新興區,秋山里,491,469,64.33470508,260,35.66529492,729,10,739,0,993,74.42094663
高雄市,新興區,長驛里,492,414,58.72340426,291,41.27659574,705,10,715,0,917,77.97164667
高雄市,新興區,建興里,493,475,63.75838926,270,36.24161074,745,9,754,0,932,80.90128755
高雄市,新興區,建華里,494,476,63.38215712,275,36.61784288,751,20,771,0,978,78.83435583
高雄市,新興區,漢民里,495,471,65.41666667,249,34.58333333,720,14,734,0,873,84.07789233
高雄市,新興區,榮治里,496,346,54.14710485,293,45.85289515,639,7,646,0,802,80.54862843
高雄市,新興區,東坡里,497,701,64.13540714,392,35.86459286,1093,23,1116,0,1360,82.05882353
高雄市,前金區,三川里,498,470,69.73293769,204,30.26706231,674,12,686,0,817,83.96572827
高雄市,前金區,草江里,499,472,51.52838428,444,48.47161572,916,15,931,0,1155,80.60606061
高雄市,前金區,長城里,500,763,66.23263889,389,33.76736111,1152,25,1177,0,1457,80.78242965
高雄市,前金區,北金里,501,460,63.01369863,270,36.98630137,730,12,742,0,911,81.44895719
高雄市,前金區,東金里,502,413,58.91583452,288,41.08416548,701,9,710,0,920,77.17391304
高雄市,前金區,新生里,503,752,51.71939477,702,48.28060523,1454,21,1475,0,1753,84.14147176
高雄市,前金區,新生里,504,628,54.27830596,529,45.72169404,1157,14,1171,0,1455,80.48109966
高雄市,前金區,後金里,505,421,55.24934383,341,44.75065617,762,12,774,0,976,79.30327869
高雄市,前金區,長興里,506,472,52.85554311,421,47.14445689,893,14,907,0,1172,77.3890785
高雄市,前金區,青山里,507,595,52.65486726,535,47.34513274,1130,15,1145,0,1425,80.35087719
高雄市,前金區,民生里,508,333,57.11835334,250,42.88164666,583,8,591,0,757,78.07133421
高雄市,前金區,復元里,509,403,49.20634921,416,50.79365079,819,12,831,0,1047,79.36962751
高雄市,前金區,林投里,510,497,53.32618026,435,46.67381974,932,13,945,0,1249,75.66052842
高雄市,前金區,國民里,511,501,58.25581395,359,41.74418605,860,13,873,0,1094,79.79890311
高雄市,前金區,社東里,512,374,52.60196906,337,47.39803094,711,9,720,0,881,81.72531215
高雄市,前金區,社東里,513,384,53.55648536,333,46.44351464,717,9,726,0,877,82.78221209
高雄市,前金區,社西里,514,519,54.74683544,429,45.25316456,948,18,966,0,1172,82.42320819
高雄市,前金區,博孝里,515,418,56.71641791,319,43.28358209,737,14,751,0,964,77.90456432
高雄市,前金區,長生里,516,618,51.2013256,589,48.7986744,1207,16,1223,0,1559,78.4477229
高雄市,前金區,榮復里,517,615,61.07249255,392,38.92750745,1007,20,1027,0,1288,79.73602484
高雄市,前金區,文西里,518,485,55.68312285,386,44.31687715,871,16,887,0,1101,80.56312443
高雄市,前金區,文東里,519,636,57.76566757,465,42.23433243,1101,18,1119,0,1384,80.85260116
高雄市,苓雅區,博仁里,520,216,42.85714286,288,57.14285714,504,5,509,0,642,79.2834891
高雄市,苓雅區,苓洲里,521,574,52.32452142,523,47.67547858,1097,25,1122,0,1387,80.89401586
高雄市,苓雅區,苓昇里,522,585,52,540,48,1125,24,1149,0,1440,79.79166667
高雄市,苓雅區,苓中里,523,819,59.69387755,553,40.30612245,1372,25,1397,0,1670,83.65269461
高雄市,苓雅區,苓雅里,524,620,52.90102389,552,47.09897611,1172,24,1196,0,1472,81.25
高雄市,苓雅區,苓東里,525,710,60.16949153,470,39.83050847,1180,25,1205,0,1511,79.74851092
高雄市,苓雅區,城北里,526,692,58.05369128,500,41.94630872,1192,20,1212,0,1538,78.80364109
高雄市,苓雅區,城西里,527,345,61.71735242,214,38.28264758,559,10,569,0,695,81.8705036
高雄市,苓雅區,城東里,528,826,60.11644833,548,39.88355167,1374,20,1394,0,1722,80.95238095
高雄市,苓雅區,意誠里,529,493,49.94934144,494,50.05065856,987,5,992,0,1299,76.36643572
高雄市,苓雅區,意誠里,530,464,45.66929134,552,54.33070866,1016,18,1034,0,1401,73.80442541
高雄市,苓雅區,鼓中里,531,609,63.76963351,346,36.23036649,955,15,970,0,1186,81.78752108
高雄市,苓雅區,田西里,532,689,58.68824532,485,41.31175468,1174,24,1198,0,1466,81.71896317
高雄市,苓雅區,人和里,533,470,58.38509317,335,41.61490683,805,9,814,0,988,82.38866397
高雄市,苓雅區,人和里,534,404,55.64738292,322,44.35261708,726,2,728,0,943,77.20042418
高雄市,苓雅區,仁政里,535,776,54.80225989,640,45.19774011,1416,21,1437,0,1802,79.74472808
高雄市,苓雅區,廣澤里,536,1006,61.98398028,617,38.01601972,1623,29,1652,1,1968,83.94308943
高雄市,苓雅區,美田里,537,553,55.02487562,452,44.97512438,1005,16,1021,0,1274,80.14128728
高雄市,苓雅區,華堂里,538,676,61.84812443,417,38.15187557,1093,15,1108,0,1392,79.59770115
高雄市,苓雅區,華堂里,539,633,50.11876485,630,49.88123515,1263,29,1292,0,1660,77.8313253
高雄市,苓雅區,日中里,540,508,54.85961123,418,45.14038877,926,10,936,0,1164,80.41237113
高雄市,苓雅區,日中里,541,494,54.40528634,414,45.59471366,908,18,926,0,1142,81.08581436
高雄市,苓雅區,普照里,542,610,58.15061964,439,41.84938036,1049,16,1065,0,1300,81.92307692
高雄市,苓雅區,普照里,543,600,55.09641873,489,44.90358127,1089,25,1114,0,1362,81.79148311
高雄市,苓雅區,和煦里,544,511,62.08991495,312,37.91008505,823,6,829,0,1037,79.94214079
高雄市,苓雅區,和煦里,545,493,52.78372591,441,47.21627409,934,10,944,0,1135,83.17180617
高雄市,苓雅區,晴朗里,546,537,54.57317073,447,45.42682927,984,12,996,0,1633,60.99203919
高雄市,苓雅區,普天里,547,573,48.68309261,604,51.31690739,1177,14,1191,0,1469,81.07556161
高雄市,苓雅區,普天里,548,629,55.56537102,503,44.43462898,1132,10,1142,0,1403,81.39700641
高雄市,苓雅區,林富里,549,724,50,724,50,1448,14,1462,0,1806,80.95238095
高雄市,苓雅區,林圍里,550,383,46.99386503,432,53.00613497,815,13,828,1,1024,80.859375
高雄市,苓雅區,林圍里,551,422,47.84580499,460,52.15419501,882,20,902,0,1089,82.82828283
高雄市,苓雅區,林安里,552,639,49.80514419,644,50.19485581,1283,20,1303,0,1580,82.46835443
高雄市,苓雅區,光華里,553,400,62.20839813,243,37.79160187,643,14,657,0,784,83.80102041
高雄市,苓雅區,林興里,554,795,65.00408831,428,34.99591169,1223,15,1238,0,1474,83.98914518
高雄市,苓雅區,林華里,555,757,61.29554656,478,38.70445344,1235,18,1253,0,1485,84.37710438
高雄市,苓雅區,林華里,556,682,55.49227014,547,44.50772986,1229,26,1255,0,1534,81.81225554
高雄市,苓雅區,林西里,557,785,54.13793103,665,45.86206897,1450,21,1471,0,1824,80.64692982
高雄市,苓雅區,林中里,558,875,56.16174583,683,43.83825417,1558,24,1582,0,1935,81.75710594
高雄市,苓雅區,林中里,559,566,52.84780579,505,47.15219421,1071,19,1090,0,1338,81.46487294
高雄市,苓雅區,林泉里,560,658,44.22043011,830,55.77956989,1488,10,1498,0,1851,80.92922744
高雄市,苓雅區,林南里,561,519,42.43663123,704,57.56336877,1223,18,1241,0,1530,81.11111111
高雄市,苓雅區,林南里,562,507,48.23977165,544,51.76022835,1051,16,1067,0,1339,79.68633308
高雄市,苓雅區,中正里,563,448,44.66600199,555,55.33399801,1003,9,1012,0,1252,80.83067093
高雄市,苓雅區,中正里,564,561,54.46601942,469,45.53398058,1030,9,1039,0,1288,80.66770186
高雄市,苓雅區,尚義里,565,577,52.21719457,528,47.78280543,1105,17,1122,0,1432,78.35195531
高雄市,苓雅區,同慶里,566,598,46.07087827,700,53.92912173,1298,19,1317,0,1578,83.46007605
高雄市,苓雅區,凱旋里,567,666,41.54709919,937,58.45290081,1603,41,1644,0,1943,84.61142563
高雄市,苓雅區,安祥里,568,399,48.54014599,423,51.45985401,822,17,839,0,1070,78.41121495
高雄市,苓雅區,安祥里,569,514,48.99904671,535,51.00095329,1049,17,1066,0,1302,81.87403994
高雄市,苓雅區,奏捷里,570,670,49.81412639,675,50.18587361,1345,25,1370,0,1653,82.87961283
高雄市,苓雅區,福壽里,571,846,66.98337292,417,33.01662708,1263,24,1287,0,1553,82.87186091
高雄市,苓雅區,福南里,572,653,65.43086172,345,34.56913828,998,21,1019,0,1198,85.05843072
高雄市,苓雅區,福南里,573,672,71.71824973,265,28.28175027,937,22,959,0,1178,81.40916808
高雄市,苓雅區,五權里,574,388,56.55976676,298,43.44023324,686,10,696,0,873,79.72508591
高雄市,苓雅區,五權里,575,455,52.35903337,414,47.64096663,869,11,880,0,1094,80.43875686
高雄市,苓雅區,民主里,576,508,48.4270734,541,51.5729266,1049,21,1070,0,1281,83.52849336
高雄市,苓雅區,民主里,577,496,53.85450597,425,46.14549403,921,16,937,0,1163,80.56749785
高雄市,苓雅區,民主里,578,646,56.56742557,496,43.43257443,1142,24,1166,0,1417,82.28652082
高雄市,苓雅區,林德里,579,360,47.61904762,396,52.38095238,756,15,771,0,927,83.17152104
高雄市,苓雅區,林德里,580,349,55.66188198,278,44.33811802,627,13,640,0,804,79.60199005
高雄市,苓雅區,林貴里,581,591,54.5202952,493,45.4797048,1084,23,1107,0,1335,82.92134831
高雄市,苓雅區,林榮里,582,784,49.03064415,815,50.96935585,1599,16,1615,0,1959,82.44002042
高雄市,苓雅區,林榮里,583,818,50.83903045,791,49.16096955,1609,25,1634,0,2010,81.29353234
高雄市,苓雅區,英明里,584,455,56.24227441,354,43.75772559,809,14,823,0,1003,82.05383848
高雄市,苓雅區,英明里,585,591,67.46575342,285,32.53424658,876,21,897,0,1065,84.22535211
高雄市,苓雅區,林靖里,586,507,37.69516729,838,62.30483271,1345,20,1365,0,1659,82.27848101
高雄市,苓雅區,朝陽里,587,725,57.67700875,532,42.32299125,1257,22,1279,0,1512,84.58994709
高雄市,苓雅區,福隆里,588,665,57.08154506,500,42.91845494,1165,19,1184,0,1470,80.54421769
高雄市,苓雅區,福隆里,589,589,54.99533147,482,45.00466853,1071,20,1091,0,1296,84.18209877
高雄市,苓雅區,福祥里,590,612,57.46478873,453,42.53521127,1065,20,1085,0,1314,82.57229833
高雄市,苓雅區,福海里,591,418,49.06103286,434,50.93896714,852,9,861,0,1046,82.31357553
高雄市,苓雅區,福康里,592,511,66.36363636,259,33.63636364,770,16,786,0,933,84.24437299
高雄市,苓雅區,福康里,593,551,63.33333333,319,36.66666667,870,15,885,0,1043,84.85139022
高雄市,苓雅區,福人里,594,470,55.62130178,375,44.37869822,845,19,864,0,1061,81.43261074
高雄市,苓雅區,福人里,595,552,60.26200873,364,39.73799127,916,24,940,0,1158,81.17443869
高雄市,苓雅區,福地里,596,694,61.0915493,442,38.9084507,1136,31,1167,3,1420,82.18309859
高雄市,苓雅區,福地里,597,612,49.91843393,614,50.08156607,1226,10,1236,0,1514,81.63804491
高雄市,苓雅區,福居里,598,652,59.81651376,438,40.18348624,1090,27,1117,0,1346,82.98662704
高雄市,苓雅區,福居里,599,759,61.2590799,480,38.7409201,1239,18,1257,0,1526,82.37221494
高雄市,苓雅區,福東里,600,410,55.85831063,324,44.14168937,734,10,744,0,906,82.1192053
高雄市,苓雅區,福東里,601,712,52.66272189,640,47.33727811,1352,17,1369,0,1679,81.53662895
高雄市,苓雅區,福西里,602,596,62.08333333,364,37.91666667,960,20,980,0,1168,83.90410959
高雄市,苓雅區,福西里,603,427,55.0257732,349,44.9742268,776,19,795,0,978,81.28834356
高雄市,苓雅區,永康里,604,455,48.55923159,482,51.44076841,937,20,957,0,1127,84.91570541
高雄市,苓雅區,永康里,605,512,52.24489796,468,47.75510204,980,25,1005,0,1211,82.98926507
高雄市,苓雅區,正文里,606,818,57.93201133,594,42.06798867,1412,26,1438,0,1782,80.69584736
高雄市,苓雅區,正言里,607,731,55.75896262,580,44.24103738,1311,21,1332,0,1626,81.91881919
高雄市,苓雅區,正言里,608,499,55.94170404,393,44.05829596,892,14,906,0,1143,79.26509186
高雄市,苓雅區,正大里,609,495,45.79093432,586,54.20906568,1081,16,1097,0,1381,79.43519189
高雄市,苓雅區,正大里,610,619,52.99657534,549,47.00342466,1168,14,1182,0,1447,81.68624741
高雄市,苓雅區,正大里,611,683,51.16104869,652,48.83895131,1335,29,1364,0,1762,77.41203178
高雄市,苓雅區,五福里,612,499,48.16602317,537,51.83397683,1036,14,1050,0,1284,81.77570093
高雄市,苓雅區,五福里,613,567,54,483,46,1050,13,1063,0,1311,81.08314264
高雄市,苓雅區,五福里,614,588,55.73459716,467,44.26540284,1055,17,1072,0,1333,80.42010503
高雄市,苓雅區,正心里,615,796,53.74746793,685,46.25253207,1481,27,1508,0,1854,81.33764833
高雄市,苓雅區,正心里,616,706,50.28490028,698,49.71509972,1404,28,1432,0,1775,80.67605634
高雄市,苓雅區,正道里,617,543,52.97560976,482,47.02439024,1025,9,1034,0,1274,81.16169545
高雄市,苓雅區,正道里,618,627,52.46861925,568,47.53138075,1195,10,1205,1,1464,82.30874317
高雄市,苓雅區,正道里,619,616,54.08252853,523,45.91747147,1139,24,1163,0,1410,82.4822695
高雄市,苓雅區,正義里,620,561,55.59960357,448,44.40039643,1009,14,1023,0,1222,83.71522095
高雄市,苓雅區,正義里,621,568,59.10509886,393,40.89490114,961,8,969,0,1169,82.89136014
高雄市,苓雅區,正仁里,622,524,51.171875,500,48.828125,1024,23,1047,0,1231,85.0528026
高雄市,苓雅區,正仁里,623,477,48.13319879,514,51.86680121,991,11,1002,0,1200,83.5
高雄市,苓雅區,文昌里,624,610,59.6285435,413,40.3714565,1023,15,1038,0,1251,82.9736211
高雄市,苓雅區,文昌里,625,593,56.85522531,450,43.14477469,1043,13,1056,0,1277,82.69381363
高雄市,苓雅區,文昌里,626,667,59.92812219,446,40.07187781,1113,21,1134,0,1392,81.46551724
高雄市,苓雅區,建軍里,627,1033,61.63484487,643,38.36515513,1676,36,1712,0,2082,82.22862632
高雄市,苓雅區,衛武里,628,489,56.1423651,382,43.8576349,871,15,886,0,1098,80.69216758
高雄市,苓雅區,衛武里,629,411,47.4595843,455,52.5404157,866,14,880,0,1068,82.39700375
高雄市,前鎮區,草衙里,630,740,66.48697215,373,33.51302785,1113,24,1137,0,1381,82.33164374
高雄市,前鎮區,草衙里,631,908,63.40782123,524,36.59217877,1432,25,1457,0,1788,81.48769575
高雄市,前鎮區,草衙里,632,903,63.45748419,520,36.54251581,1423,24,1447,0,1846,78.38569881
高雄市,前鎮區,草衙里,633,922,66.28324946,469,33.71675054,1391,32,1423,0,1845,77.12737127
高雄市,前鎮區,草衙里,634,832,62.08955224,508,37.91044776,1340,27,1367,0,1740,78.56321839
高雄市,前鎮區,明孝里,635,897,71.53110048,357,28.46889952,1254,33,1287,1,1592,80.84170854
高雄市,前鎮區,明孝里,636,452,64.29587482,251,35.70412518,703,19,722,0,900,80.22222222
高雄市,前鎮區,明正里,637,857,65.17110266,458,34.82889734,1315,29,1344,2,1654,81.25755744
高雄市,前鎮區,明正里,638,856,65.89684373,443,34.10315627,1299,24,1323,0,1616,81.86881188
高雄市,前鎮區,明義里,639,465,54.96453901,381,45.03546099,846,13,859,0,1016,84.54724409
高雄市,前鎮區,明義里,640,457,68.72180451,208,31.27819549,665,10,675,0,799,84.48060075
高雄市,前鎮區,仁愛里,641,832,71.72413793,328,28.27586207,1160,30,1190,0,1503,79.17498337
高雄市,前鎮區,德昌里,642,874,54.96855346,716,45.03144654,1590,33,1623,0,2038,79.63689892
高雄市,前鎮區,平等里,643,986,69.19298246,439,30.80701754,1425,37,1462,0,2172,67.31123389
高雄市,前鎮區,平昌里,644,451,75.04159734,150,24.95840266,601,8,609,0,734,82.97002725
高雄市,前鎮區,明禮里,645,1063,73.05841924,392,26.94158076,1455,15,1470,0,1782,82.49158249
高雄市,前鎮區,信義里,646,931,74.48,319,25.52,1250,28,1278,0,1589,80.4279421
高雄市,前鎮區,信德里,647,628,75.84541063,200,24.15458937,828,32,860,0,1099,78.25295723
高雄市,前鎮區,信德里,648,653,57.89007092,475,42.10992908,1128,16,1144,0,1428,80.11204482
高雄市,前鎮區,明道里,649,769,75.17106549,254,24.82893451,1023,25,1048,0,1288,81.36645963
高雄市,前鎮區,興化里,650,492,78.72,133,21.28,625,23,648,2,794,81.61209068
高雄市,前鎮區,興仁里,651,589,78.42876165,162,21.57123835,751,9,760,0,932,81.54506438
高雄市,前鎮區,前鎮里,652,844,68.61788618,386,31.38211382,1230,30,1260,0,1540,81.81818182
高雄市,前鎮區,鎮東里,653,1138,70.99189021,465,29.00810979,1603,43,1646,0,1969,83.59573388
高雄市,前鎮區,鎮榮里,654,719,69.06820365,322,30.93179635,1041,26,1067,0,1270,84.01574803
高雄市,前鎮區,鎮榮里,655,544,64.1509434,304,35.8490566,848,24,872,0,1071,81.41923436
高雄市,前鎮區,鎮昌里,656,669,67.71255061,319,32.28744939,988,14,1002,0,1218,82.26600985
高雄市,前鎮區,鎮昌里,657,469,66.4305949,237,33.5694051,706,14,720,0,864,83.33333333
高雄市,前鎮區,鎮海里,658,549,60.26344676,362,39.73655324,911,24,935,0,1128,82.89007092
高雄市,前鎮區,鎮海里,659,700,65.78947368,364,34.21052632,1064,30,1094,0,1302,84.02457757
高雄市,前鎮區,鎮海里,660,720,59.75103734,485,40.24896266,1205,17,1222,0,1492,81.90348525
高雄市,前鎮區,鎮陽里,661,612,65.80645161,318,34.19354839,930,27,957,0,1149,83.28981723
高雄市,前鎮區,興邦里,662,438,49.88610478,440,50.11389522,878,24,902,0,1093,82.52516011
高雄市,前鎮區,興邦里,663,428,54.31472081,360,45.68527919,788,17,805,0,985,81.72588832
高雄市,前鎮區,鎮中里,664,449,67.21556886,219,32.78443114,668,17,685,0,855,80.11695906
高雄市,前鎮區,鎮北里,665,584,69.03073286,262,30.96926714,846,19,865,0,1038,83.33333333
高雄市,前鎮區,忠純里,666,376,20.4570185,1462,79.5429815,1838,38,1876,0,2242,83.67528992
高雄市,前鎮區,忠純里,667,211,15.86466165,1119,84.13533835,1330,23,1353,0,1618,83.62175525
高雄市,前鎮區,忠誠里,668,90,10.58823529,760,89.41176471,850,23,873,0,1032,84.59302326
高雄市,前鎮區,忠誠里,669,89,9.447983015,853,90.55201699,942,21,963,0,1083,88.91966759
高雄市,前鎮區,西山里,670,766,56.57311669,588,43.42688331,1354,25,1379,0,1686,81.79122183
高雄市,前鎮區,西山里,671,603,45.64723694,718,54.35276306,1321,17,1338,0,1640,81.58536585
高雄市,前鎮區,民權里,672,468,48.85177453,490,51.14822547,958,19,977,0,1192,81.96308725
高雄市,前鎮區,民權里,673,617,51.71835708,576,48.28164292,1193,10,1203,0,1391,86.48454349
高雄市,前鎮區,民權里,674,395,38.0539499,643,61.9460501,1038,9,1047,0,1280,81.796875
高雄市,前鎮區,建隆里,675,374,53.27635328,328,46.72364672,702,18,720,0,903,79.73421927
高雄市,前鎮區,振興里,676,882,57.83606557,643,42.16393443,1525,27,1552,0,1920,80.83333333
高雄市,前鎮區,良和里,677,483,57.84431138,352,42.15568862,835,13,848,0,1049,80.83889418
高雄市,前鎮區,良和里,678,472,38.24959481,762,61.75040519,1234,13,1247,0,1540,80.97402597
高雄市,前鎮區,西甲里,679,998,61.87228766,615,38.12771234,1613,37,1650,0,1986,83.081571
高雄市,前鎮區,盛興里,680,500,47.70992366,548,52.29007634,1048,14,1062,0,1326,80.09049774
高雄市,前鎮區,盛興里,681,466,50.21551724,462,49.78448276,928,18,946,0,1217,77.73212818
高雄市,前鎮區,盛豐里,682,703,57.95548228,510,42.04451772,1213,20,1233,0,1534,80.37809648
高雄市,前鎮區,盛豐里,683,533,50.90735435,514,49.09264565,1047,17,1064,0,1345,79.10780669
高雄市,前鎮區,興中里,684,666,54.45625511,557,45.54374489,1223,25,1248,0,1531,81.51534944
高雄市,前鎮區,興中里,685,639,52.63591433,575,47.36408567,1214,27,1241,0,1609,77.12865134
高雄市,前鎮區,興東里,686,696,58.24267782,499,41.75732218,1195,14,1209,0,1459,82.86497601
高雄市,前鎮區,興東里,687,695,54.85398579,572,45.14601421,1267,20,1287,0,1524,84.4488189
高雄市,前鎮區,興東里,688,607,48.13639968,654,51.86360032,1261,9,1270,0,1571,80.84022915
高雄市,前鎮區,忠孝里,689,457,48.25765576,490,51.74234424,947,24,971,0,1166,83.2761578
高雄市,前鎮區,忠孝里,690,494,49.74823766,499,50.25176234,993,19,1012,0,1190,85.04201681
高雄市,前鎮區,復國里,691,721,64.95495495,389,35.04504505,1110,16,1126,0,1346,83.65527489
高雄市,前鎮區,復國里,692,684,55.65500407,545,44.34499593,1229,12,1241,0,1505,82.45847176
高雄市,前鎮區,竹內里,693,640,62.31742941,387,37.68257059,1027,25,1052,1,1264,83.2278481
高雄市,前鎮區,竹內里,694,726,66.12021858,372,33.87978142,1098,29,1127,0,1370,82.26277372
高雄市,前鎮區,竹東里,695,458,54.52380952,382,45.47619048,840,10,850,0,1072,79.29104478
高雄市,前鎮區,竹東里,696,441,52.94117647,392,47.05882353,833,18,851,0,1038,81.98458574
高雄市,前鎮區,竹南里,697,704,64.40988106,389,35.59011894,1093,28,1121,0,1349,83.09859155
高雄市,前鎮區,竹南里,698,607,57.15630885,455,42.84369115,1062,18,1080,0,1314,82.19178082
高雄市,前鎮區,竹北里,699,458,51.46067416,432,48.53932584,890,6,896,0,1115,80.35874439
高雄市,前鎮區,竹北里,700,404,55.49450549,324,44.50549451,728,18,746,0,911,81.88803513
高雄市,前鎮區,竹西里,701,601,62.27979275,364,37.72020725,965,10,975,0,1171,83.26216909
高雄市,前鎮區,竹西里,702,499,47.6599809,548,52.3400191,1047,11,1058,1,1240,85.32258065
高雄市,前鎮區,竹西里,703,632,55.87975243,499,44.12024757,1131,17,1148,0,1349,85.10007413
高雄市,前鎮區,竹中里,704,551,49.24039321,568,50.75960679,1119,14,1133,0,1394,81.276901
高雄市,前鎮區,竹中里,705,677,59.17832168,467,40.82167832,1144,19,1163,0,1355,85.8302583
高雄市,前鎮區,瑞竹里,706,710,69.47162427,312,30.52837573,1022,37,1059,0,1286,82.34836703
高雄市,前鎮區,瑞南里,707,741,60,494,40,1235,33,1268,0,1517,83.58602505
高雄市,前鎮區,瑞南里,708,759,63.94271272,428,36.05728728,1187,19,1206,0,1462,82.48974008
高雄市,前鎮區,瑞南里,709,819,62.23404255,497,37.76595745,1316,28,1344,0,1606,83.68617684
高雄市,前鎮區,瑞豐里,710,672,64.36781609,372,35.63218391,1044,34,1078,0,1287,83.76068376
高雄市,前鎮區,瑞豐里,711,505,58.1797235,363,41.8202765,868,20,888,0,1077,82.45125348
高雄市,前鎮區,瑞祥里,712,836,60.18718503,553,39.81281497,1389,23,1412,0,1689,83.59976317
高雄市,前鎮區,瑞祥里,713,754,54.08895265,640,45.91104735,1394,23,1417,1,1658,85.46441496
高雄市,前鎮區,瑞祥里,714,637,54.58440446,530,45.41559554,1167,16,1183,0,1405,84.19928826
高雄市,前鎮區,瑞東里,715,616,63.83419689,349,36.16580311,965,16,981,0,1191,82.36775819
高雄市,前鎮區,瑞東里,716,663,63.08277831,388,36.91722169,1051,20,1071,0,1264,84.73101266
高雄市,前鎮區,瑞和里,717,510,66.57963446,256,33.42036554,766,17,783,0,942,83.12101911
高雄市,前鎮區,瑞和里,718,600,70.25761124,254,29.74238876,854,15,869,0,1065,81.59624413
高雄市,前鎮區,瑞平里,719,624,68.95027624,281,31.04972376,905,20,925,0,1110,83.33333333
高雄市,前鎮區,瑞平里,720,650,63.85068762,368,36.14931238,1018,18,1036,0,1207,85.83264292
高雄市,前鎮區,瑞平里,721,596,55.59701493,476,44.40298507,1072,11,1083,0,1309,82.73491215
高雄市,前鎮區,瑞隆里,722,667,64.19634264,372,35.80365736,1039,21,1060,0,1258,84.26073132
高雄市,前鎮區,瑞隆里,723,485,57.66944114,356,42.33055886,841,13,854,0,1054,81.02466793
高雄市,前鎮區,瑞隆里,724,624,63.2218845,363,36.7781155,987,17,1004,0,1245,80.64257028
高雄市,前鎮區,瑞北里,725,817,68.31103679,379,31.68896321,1196,24,1220,0,1470,82.99319728
高雄市,前鎮區,瑞北里,726,691,59.00939368,480,40.99060632,1171,18,1189,0,1453,81.83069511
高雄市,前鎮區,瑞西里,727,824,70.36720751,347,29.63279249,1171,28,1199,0,1417,84.61538462
高雄市,前鎮區,瑞西里,728,327,32.12180747,691,67.87819253,1018,21,1039,0,1220,85.16393443
高雄市,前鎮區,瑞崗里,729,657,64.03508772,369,35.96491228,1026,21,1047,0,1207,86.74399337
高雄市,前鎮區,瑞崗里,730,716,65.86936523,371,34.13063477,1087,13,1100,0,1316,83.58662614
高雄市,前鎮區,瑞興里,731,726,64.59074733,398,35.40925267,1124,20,1144,0,1384,82.65895954
高雄市,前鎮區,瑞興里,732,668,66.13861386,342,33.86138614,1010,7,1017,0,1255,81.03585657
高雄市,前鎮區,瑞誠里,733,682,61.60794941,425,38.39205059,1107,17,1124,0,1368,82.16374269
高雄市,前鎮區,瑞誠里,734,517,59.90730012,346,40.09269988,863,8,871,0,1077,80.8727948
高雄市,前鎮區,瑞文里,735,595,67.23163842,290,32.76836158,885,16,901,0,1095,82.28310502
高雄市,前鎮區,瑞文里,736,734,66.18575293,375,33.81424707,1109,15,1124,0,1317,85.34548216
高雄市,前鎮區,瑞華里,737,661,56.06446141,518,43.93553859,1179,6,1185,0,1411,83.98299079
高雄市,前鎮區,瑞華里,738,839,65.9591195,433,34.0408805,1272,15,1287,0,1533,83.95303327
高雄市,前鎮區,瑞華里,739,600,52.81690141,536,47.18309859,1136,10,1146,0,1359,84.32671082
高雄市,前鎮區,瑞昌里,740,781,70.23381295,331,29.76618705,1112,26,1138,0,1386,82.10678211
高雄市,前鎮區,瑞昌里,741,710,63.44950849,409,36.55049151,1119,32,1151,0,1405,81.92170819
高雄市,小港區,小港里,742,865,62.86337209,511,37.13662791,1376,30,1406,0,1751,80.29697316
高雄市,小港區,港口里,743,664,47.29344729,740,52.70655271,1404,14,1418,0,1682,84.30439952
高雄市,小港區,港口里,744,659,51.72684458,615,48.27315542,1274,14,1288,0,1594,80.80301129
高雄市,小港區,港正里,745,383,38.88324873,602,61.11675127,985,19,1004,0,1245,80.64257028
高雄市,小港區,港正里,746,560,53.58851675,485,46.41148325,1045,16,1061,0,1262,84.07290016
高雄市,小港區,港墘里,747,773,58.60500379,546,41.39499621,1319,19,1338,1,1581,84.62998102
高雄市,小港區,港明里,748,737,60.70840198,477,39.29159802,1214,20,1234,0,1508,81.83023873
高雄市,小港區,港明里,749,705,58.65224626,497,41.34775374,1202,26,1228,0,1493,82.25050234
高雄市,小港區,港后里,750,940,59.53134896,639,40.46865104,1579,24,1603,0,1984,80.79637097
高雄市,小港區,港南里,751,716,64.21524664,399,35.78475336,1115,15,1130,0,1579,71.56428119
高雄市,小港區,港興里,752,1092,65.11627907,585,34.88372093,1677,37,1714,0,2042,83.93731636
高雄市,小港區,鳳宮里,753,929,61.40118969,584,38.59881031,1513,17,1530,0,1888,81.03813559
高雄市,小港區,店鎮里,754,679,64.54372624,373,35.45627376,1052,23,1075,0,1379,77.95503988
高雄市,小港區,店鎮里,755,777,61.32596685,490,38.67403315,1267,11,1278,0,1543,82.82566429
高雄市,小港區,店鎮里,756,690,55.46623794,554,44.53376206,1244,20,1264,0,1573,80.35600763
高雄市,小港區,大苓里,757,512,59.95316159,342,40.04683841,854,23,877,0,1053,83.28584995
高雄市,小港區,大苓里,758,573,59.74973931,386,40.25026069,959,16,975,0,1165,83.69098712
高雄市,小港區,二苓里,759,712,60.13513514,472,39.86486486,1184,39,1223,0,1469,83.25391423
高雄市,小港區,二苓里,760,817,63.72854914,465,36.27145086,1282,17,1299,0,1590,81.69811321
高雄市,小港區,三苓里,761,560,57.61316872,412,42.38683128,972,11,983,0,1263,77.83056215
高雄市,小港區,三苓里,762,586,58.48303393,416,41.51696607,1002,13,1015,0,1191,85.2225021
高雄市,小港區,正苓里,763,735,56.10687023,575,43.89312977,1310,20,1330,0,1706,77.96014068
高雄市,小港區,正苓里,764,696,53.86996904,596,46.13003096,1292,27,1319,0,1645,80.18237082
高雄市,小港區,順苓里,765,874,56.86402082,663,43.13597918,1537,18,1555,0,1912,81.32845188
高雄市,小港區,順苓里,766,723,53.79464286,621,46.20535714,1344,12,1356,0,1649,82.23165555
高雄市,小港區,六苓里,767,721,56.59340659,553,43.40659341,1274,18,1292,0,1528,84.55497382
高雄市,小港區,宏亮里,768,512,57.33482643,381,42.66517357,893,11,904,0,1106,81.73598553
高雄市,小港區,宏亮里,769,618,55.57553957,494,44.42446043,1112,17,1129,0,1417,79.6753705
高雄市,小港區,山東里,770,346,37.52711497,576,62.47288503,922,12,934,0,1169,79.89734816
高雄市,小港區,山東里,771,514,50.69033531,500,49.30966469,1014,10,1024,0,1258,81.3990461
高雄市,小港區,青島里,772,428,30.65902579,968,69.34097421,1396,33,1429,0,1750,81.65714286
高雄市,小港區,濟南里,773,617,48.92942109,644,51.07057891,1261,17,1278,0,1566,81.6091954
高雄市,小港區,濟南里,774,448,37.24023275,755,62.75976725,1203,39,1242,0,1523,81.54957321
高雄市,小港區,泰山里,775,533,58.96017699,371,41.03982301,904,17,921,0,1111,82.89828983
高雄市,小港區,泰山里,776,474,57.24637681,354,42.75362319,828,9,837,0,1016,82.38188976
高雄市,小港區,山明里,777,1026,62.82914881,607,37.17085119,1633,25,1658,0,2054,80.72054528
高雄市,小港區,山明里,778,880,65.52494415,463,34.47505585,1343,24,1367,0,1642,83.25213155
高雄市,小港區,山明里,779,820,55.78231293,650,44.21768707,1470,25,1495,0,1842,81.16178067
高雄市,小港區,高松里,780,666,58.6784141,469,41.3215859,1135,28,1163,0,1470,79.11564626
高雄市,小港區,高松里,781,860,65.20090978,459,34.79909022,1319,35,1354,0,1651,82.01090248
高雄市,小港區,松金里,782,481,60.73232323,311,39.26767677,792,8,800,0,949,84.29926238
高雄市,小港區,松金里,783,503,56.96489241,380,43.03510759,883,4,887,0,1129,78.56510186
高雄市,小港區,松山里,784,939,62.26790451,569,37.73209549,1508,42,1550,0,1919,80.77123502
高雄市,小港區,大坪里,785,732,71.90569745,286,28.09430255,1018,32,1050,0,1255,83.66533865
高雄市,小港區,坪頂里,786,772,75.17039922,255,24.82960078,1027,30,1057,0,1297,81.49575944
高雄市,小港區,孔宅里,787,630,73.42657343,228,26.57342657,858,29,887,0,1077,82.35840297
高雄市,小港區,孔宅里,788,432,48.59392576,457,51.40607424,889,13,902,0,1166,77.35849057
高雄市,小港區,孔宅里,789,392,52.61744966,353,47.38255034,745,13,758,0,931,81.41783029
高雄市,小港區,廈莊里,790,963,64.58752515,528,35.41247485,1491,31,1522,0,1846,82.44853738
高雄市,小港區,合作里,791,578,63.30777656,335,36.69222344,913,21,934,0,1125,83.02222222
高雄市,小港區,合作里,792,585,67.1641791,286,32.8358209,871,9,880,0,1089,80.80808081
高雄市,小港區,桂林里,793,840,71.30730051,338,28.69269949,1178,31,1209,0,1482,81.57894737
高雄市,小港區,桂林里,794,816,62.67281106,486,37.32718894,1302,41,1343,0,1582,84.89254109
高雄市,小港區,桂林里,795,709,56.67466027,542,43.32533973,1251,14,1265,0,1548,81.71834625
高雄市,小港區,桂林里,796,672,57.53424658,496,42.46575342,1168,14,1182,0,1455,81.2371134
高雄市,小港區,中厝里,797,616,62.7930683,365,37.2069317,981,20,1001,0,1226,81.64763458
高雄市,小港區,中厝里,798,834,65.10538642,447,34.89461358,1281,11,1292,0,1609,80.29832194
高雄市,小港區,鳳鳴里,799,531,56.13107822,415,43.86892178,946,19,965,0,1153,83.69470945
高雄市,小港區,鳳鳴里,800,573,64.16573348,320,35.83426652,893,27,920,0,1096,83.94160584
高雄市,小港區,龍鳳里,801,542,66.50306748,273,33.49693252,815,29,844,0,1014,83.234714
高雄市,小港區,龍鳳里,802,550,62.14689266,335,37.85310734,885,16,901,0,1074,83.89199255
高雄市,小港區,鳳森里,803,831,66.69341894,415,33.30658106,1246,31,1277,0,1492,85.58981233
高雄市,小港區,鳳林里,804,553,70.98844673,226,29.01155327,779,17,796,0,1016,78.34645669
高雄市,小港區,鳳林里,805,587,70.97944377,240,29.02055623,827,17,844,0,1027,82.18111003
高雄市,小港區,鳳興里,806,931,72.90524667,346,27.09475333,1277,26,1303,0,1584,82.26010101
高雄市,小港區,鳳源里,807,613,71.03128621,250,28.96871379,863,9,872,0,1054,82.73244782
高雄市,小港區,鳳源里,808,675,69.58762887,295,30.41237113,970,24,994,0,1264,78.63924051
高雄市,小港區,海澄里,809,743,68.47926267,342,31.52073733,1085,23,1108,0,1455,76.15120275
高雄市,小港區,海澄里,810,685,66.50485437,345,33.49514563,1030,27,1057,0,1346,78.52897474
高雄市,小港區,海澄里,811,823,66.74776967,410,33.25223033,1233,27,1260,0,1676,75.17899761
高雄市,小港區,海昌里,812,553,68.0196802,260,31.9803198,813,21,834,0,1136,73.41549296
高雄市,小港區,海昌里,813,579,67.64018692,277,32.35981308,856,25,881,0,1153,76.40936687
高雄市,小港區,海豐里,814,689,69.45564516,303,30.54435484,992,24,1016,0,1320,76.96969697
高雄市,小港區,海豐里,815,577,73.50318471,208,26.49681529,785,26,811,0,1043,77.75647172
高雄市,小港區,海原里,816,661,68.56846473,303,31.43153527,964,13,977,0,1308,74.6941896
高雄市,小港區,海原里,817,659,64.481409,363,35.518591,1022,35,1057,0,1434,73.70990237
高雄市,小港區,海城里,818,686,67.51968504,330,32.48031496,1016,23,1039,0,1396,74.4269341
高雄市,小港區,海城里,819,672,68.78198567,305,31.21801433,977,25,1002,0,1400,71.57142857